GEOID10,Tot_2016_pres,Dem_2016_pres,Rep_2016_pres,Tot_2008_pres,Dem_2008_pres,Rep_2008_pres
060375991001,0.0,0.0,0.0,0,0,0
060375991002,151.8,96.3,42.0,154,103,51
060375990001,200.8,106.1,80.1,296,158,138
060375990003,209.4,110.4,83.9,144,85,59
060375990002,254.8,132.1,104.6,242,133,109
060375990004,488.2,253.1,200.4,470,258,212
060590626042,4144.9,2307.9,1618.1,3868,1899,1969
060590626043,837.7,477.0,315.3,827,522,305
060590626041,377.9,221.5,133.5,442,277,165
060590626054,659.2,402.9,205.2,670,471,199
060590626051,358.2,236.5,98.2,298,208,90
060590626052,389.7,233.0,125.9,409,280,129
060590626321,569.9,338.2,196.7,528,363,165
060590626202,1056.6,610.1,387.4,934,610,324
060590626194,591.4,383.6,176.6,567,408,159
060590626193,628.2,421.6,171.8,648,447,201
060590626053,441.2,297.3,116.7,357,241,116
060590626323,583.8,355.4,192.6,597,375,222
060590423131,424.4,176.9,221.4,484,184,300
060590423101,542.7,234.7,279.4,533,271,262
060590423133,732.3,336.5,344.3,501,285,216
060590422012,366.2,151.8,192.0,399,164,235
060590422011,578.1,242.3,308.8,461,231,230
060590423231,595.7,267.4,302.7,797,403,394
060599901000,0.0,0.0,0.0,0,0,0
060590423242,400.7,168.8,213.1,310,179,131
060590423241,490.6,206.5,261.1,787,290,497
060590423232,672.2,283.1,357.5,782,359,423
060590423233,601.1,235.6,339.0,592,271,321
060590423132,482.4,210.0,246.9,409,231,178
060590423234,748.0,262.9,448.8,718,307,411
060590423052,707.1,295.9,375.7,735,292,443
060590423381,1554.2,688.5,759.4,1548,725,823
060590423382,974.8,427.5,492.6,938,428,510
060590423391,540.9,224.8,283.9,524,267,257
060590423393,565.1,241.9,290.8,382,189,193
060590423392,683.6,318.3,333.7,766,386,380
060590423051,879.6,530.7,308.3,732,482,250
060590423053,573.6,248.2,293.1,645,338,307
060590626324,615.2,368.7,228.0,904,549,355
060590423251,1231.2,568.5,603.3,1057,491,566
060590626203,666.7,409.8,221.4,548,347,201
060590626201,724.6,462.8,225.4,841,548,293
060590626204,950.6,595.4,311.6,907,608,299
060590626322,431.1,274.1,139.6,489,313,176
060590626192,460.1,292.6,149.0,514,320,194
060590626191,649.9,413.3,210.4,743,459,284
060590423243,1122.2,509.9,570.2,809,367,442
060590423244,842.8,412.7,391.5,855,462,393
060590423252,618.5,302.9,285.7,782,391,391
060590423173,973.8,400.2,522.0,1041,407,634
060590423323,1375.1,623.5,673.3,1236,548,688
060590423321,663.9,299.2,329.4,717,315,402
060590423322,1032.0,410.3,565.4,1225,501,724
060590423172,503.0,185.0,284.0,499,222,277
060590423171,470.0,207.0,232.0,502,211,291
060590423311,1572.4,722.0,776.0,1378,622,756
060590423261,393.5,205.9,170.2,619,331,288
060590423262,1596.0,825.0,690.0,1617,853,764
060590626331,1589.3,753.9,744.0,1015,535,480
060590626394,787.6,386.9,347.9,813,425,388
060590626393,571.2,306.6,238.0,857,456,401
060590423293,871.0,411.0,420.0,735,349,386
060590423192,429.5,193.9,208.9,360,186,174
060590423191,1416.5,595.1,733.1,1161,467,694
060590423344,657.0,356.0,278.0,604,328,276
060590421031,974.3,440.2,456.7,863,459,404
060590421035,801.1,299.9,456.4,706,285,421
060590421033,941.6,391.1,488.8,961,463,498
060590421032,451.4,197.7,221.1,589,285,304
060590421141,854.1,333.6,466.8,689,380,309
060590421034,632.5,235.5,353.2,815,275,540
060590421143,582.6,252.2,302.2,658,267,391
060590421142,500.9,216.9,259.9,525,230,295
060590421094,463.1,183.8,250.9,645,271,374
060590421133,748.6,282.9,425.7,618,278,340
060590423135,615.7,288.6,297.3,459,258,201
060590423134,676.8,312.4,316.6,649,318,331
060590423112,643.0,243.0,369.0,643,279,364
060590423114,1179.9,515.3,580.3,1310,602,708
060590423106,472.8,206.3,242.7,502,225,277
060590423102,472.1,187.1,259.8,470,230,240
060590422013,696.3,330.5,325.3,658,364,294
060590423103,691.9,274.2,380.7,659,311,348
060590423105,946.1,426.4,458.0,239,105,134
060590422035,537.6,233.8,268.9,484,214,270
060590422061,714.0,286.6,386.3,668,289,379
060590422015,584.7,236.8,313.0,648,290,358
060590422062,1201.7,483.7,648.5,1164,518,646
060590422014,615.4,250.1,326.8,562,288,274
060590421061,409.2,165.6,219.7,462,186,276
060590422054,650.6,297.8,309.3,645,345,300
060590422052,1224.3,499.2,647.1,1304,573,731
060590422053,685.7,259.8,388.3,1486,554,932
060590422034,513.3,179.3,305.2,509,193,316
060590422031,1114.0,427.6,638.2,292,88,204
060590423372,791.0,277.0,477.0,855,330,525
060590423313,474.9,245.9,202.7,695,321,374
060590423312,394.7,216.1,156.2,225,134,91
060590423104,638.3,329.2,271.0,1074,557,517
060590423111,781.5,315.9,421.1,702,295,407
060590423113,502.7,216.9,256.8,676,268,408
060590423371,472.0,196.2,245.8,583,253,330
060590423373,506.9,213.7,261.4,677,330,347
060590423152,536.0,230.4,270.6,636,275,361
060590423155,634.1,328.7,272.7,424,219,205
060590423153,675.5,349.4,291.3,579,282,297
060590423303,852.7,401.6,401.9,919,484,435
060590423301,957.0,447.3,462.3,1004,452,552
060590423302,389.2,186.2,181.8,381,238,143
060590423292,827.0,383.0,415.0,816,377,439
060590423361,1828.4,884.5,842.2,1584,758,826
060590423352,1717.5,830.4,809.7,1640,757,883
060590423351,737.6,354.6,345.8,627,341,286
060590423291,590.0,272.0,278.0,599,281,318
060590423362,680.2,325.6,313.3,740,355,385
060590423121,588.9,396.7,159.1,768,445,323
060590423123,544.0,364.5,148.7,119,99,20
060590320221,685.1,408.2,231.6,907,536,371
060590423124,340.1,247.9,75.3,171,129,42
060590423154,994.5,435.7,499.9,931,433,498
060590423151,529.6,236.2,259.5,483,233,250
060590423122,803.9,337.2,425.6,685,289,396
060590422032,652.5,243.2,383.1,520,189,331
060590422033,682.0,250.3,404.0,669,272,397
060590320233,1447.1,560.5,817.0,1411,525,886
060590320611,2237.3,726.5,1409.2,1999,556,1443
060590320223,784.9,388.1,353.5,589,320,269
060590320222,413.7,235.4,154.0,589,339,250
060590423331,955.7,390.8,522.3,1095,401,694
060590320582,1935.1,852.7,973.9,5872,2619,3253
060590320591,349.9,140.3,195.1,142,74,68
060590320581,1376.2,505.5,799.6,359,146,213
060590320592,821.0,357.0,429.0,187,90,97
060590320595,752.0,338.0,370.0,371,192,179
060590320594,658.6,272.4,334.8,83,33,50
060590421072,859.7,432.0,378.3,649,417,232
060590421071,610.4,282.6,295.7,343,194,149
060590421084,698.4,352.0,306.1,718,414,304
060590421062,339.2,157.1,164.4,550,239,311
060590421081,266.9,141.6,109.0,456,235,221
060590421083,469.9,217.5,207.6,415,225,190
060590421122,893.7,309.7,529.0,814,316,498
060590421112,756.7,280.4,437.1,869,319,550
060590421111,630.0,224.3,369.4,662,257,405
060590421123,1107.6,408.2,634.1,1037,417,620
060590421121,1700.8,566.4,1046.0,1651,584,1067
060590421085,410.8,212.3,162.8,256,163,93
060590421082,293.1,132.1,132.1,237,132,105
060590421131,665.0,259.8,368.3,778,320,458
060590421134,494.6,197.4,266.5,519,241,278
060590421132,767.9,293.4,431.2,702,281,421
060590421114,1610.1,606.3,912.2,1678,633,1045
060590421113,418.6,156.1,241.2,507,206,301
060590422051,955.0,366.0,537.9,850,345,505
060590422036,1083.0,404.0,627.8,944,393,551
060590421092,651.6,248.3,367.8,884,352,532
060590421093,585.8,223.2,330.6,282,133,149
060590421091,700.6,280.7,375.7,565,290,275
060590320232,1432.5,533.2,812.2,1326,499,827
060590320231,3780.5,1416.8,2150.8,3284,1276,2008
060590320612,62.9,24.6,35.0,15,7,8
060590320564,1939.1,802.7,1026.4,292,126,166
060590320411,541.6,182.4,322.1,608,198,410
060590320431,1329.3,468.9,761.0,1411,480,931
060590320565,799.0,351.0,388.0,594,261,333
060730099011,300.7,144.4,139.0,9,5,4
060730071002,1402.5,731.3,585.1,1615,767,848
060730071001,796.2,391.2,358.5,1290,579,711
060730072001,708.9,393.0,260.0,850,432,418
060730072002,2049.6,1222.2,701.6,2053,1094,959
060730073022,442.5,266.4,145.0,470,289,181
060730073023,426.6,250.8,145.1,420,252,168
060730073011,560.3,387.0,122.7,618,459,159
060730073014,466.5,322.5,102.6,471,362,109
060730073012,916.6,620.5,212.3,1050,824,226
060730073013,858.0,600.7,187.8,927,738,189
060730075021,635.9,447.4,139.0,619,454,165
060730075023,573.0,402.6,115.4,611,507,104
060730075022,496.4,343.8,102.6,613,511,102
060730075013,451.8,321.0,88.0,548,431,117
060730075014,474.3,322.6,100.1,483,390,93
060730075015,287.7,195.7,60.7,314,260,54
060730076004,302.1,163.8,111.0,392,232,160
060730076005,383.9,208.2,141.0,392,232,160
060730062001,99.5,48.4,46.2,149,64,85
060730063001,489.5,287.4,161.5,219,115,104
060730214001,1878.9,1014.7,735.8,1346,741,605
060730099021,1.4,0.7,0.6,0,0,0
060730058001,1772.7,1229.3,395.3,1218,909,309
060730113001,39.0,12.0,24.0,37,17,20
060730216001,457.2,196.1,229.0,263,101,162
060730108001,681.6,322.0,330.4,669,364,305
060730218001,565.7,265.0,271.4,620,267,353
060730218002,573.6,257.2,275.8,661,221,440
060730108002,659.4,291.6,316.4,675,299,376
060730111002,635.2,298.3,296.8,660,288,372
060730111003,371.6,174.9,174.2,398,171,227
060730070022,514.9,266.3,214.5,542,262,280
060730070023,374.4,189.3,160.3,426,194,232
060730070021,924.4,518.2,342.3,929,541,388
060730071003,624.2,330.5,258.6,411,228,183
060730214003,643.7,376.8,224.5,553,315,238
060730214002,716.5,428.0,243.3,622,365,257
060730073021,472.9,310.8,131.9,503,327,176
060730074006,519.2,338.0,152.5,523,332,191
060730074003,764.6,507.9,208.3,749,507,242
060730074005,600.2,406.4,148.6,611,418,193
060590759023,488.7,301.9,151.5,406,271,135
060590760001,370.8,231.5,112.7,435,275,160
060590759013,810.2,480.4,256.7,659,401,258
060590759025,342.9,181.9,136.5,329,192,137
060590759012,371.5,207.5,133.4,442,239,203
060590759011,233.0,122.5,92.5,567,353,214
060590762041,389.3,187.2,175.1,451,201,250
060590762043,306.2,204.1,79.6,179,103,76
060590762042,308.5,205.7,80.2,254,154,100
060590759021,551.1,272.3,240.0,479,253,226
060590758052,696.3,303.3,352.1,725,328,397
060590762054,218.3,114.1,87.6,299,152,147
060590762051,796.1,416.1,319.5,322,186,136
060590762062,308.8,135.2,155.0,354,141,213
060590762052,444.8,232.4,180.6,727,308,419
060590758063,301.4,198.5,79.9,193,117,76
060590758065,287.6,170.3,97.4,289,145,144
060590758061,626.4,279.9,314.2,658,275,383
060590762063,481.6,198.2,256.6,474,186,288
060590762053,783.5,359.6,364.4,539,279,260
060590762064,534.5,245.4,248.6,661,251,410
060590758121,580.3,312.3,227.6,231,135,96
060590762061,408.0,213.1,166.3,509,250,259
060590758112,156.8,109.0,37.3,41,28,13
060590626431,639.7,260.2,356.6,618,230,388
060590626433,741.2,330.4,377.4,696,259,437
060590626432,868.0,429.5,398.9,683,295,388
060590626436,435.1,185.3,219.4,550,224,326
060590626435,473.1,219.1,228.1,562,248,314
060590626493,452.9,257.8,184.3,566,338,228
060590626492,661.0,429.0,197.0,525,335,190
060590626213,2321.8,1325.3,877.9,1212,606,606
060590626143,2425.5,2097.3,169.8,2378,1991,387
060590626142,986.5,848.0,45.1,667,559,108
060590626141,2533.0,2209.9,183.5,2297,1972,325
060590626273,317.9,230.0,68.9,308,221,87
060590626272,312.4,226.0,67.7,263,196,67
060590626291,1033.9,603.4,365.2,1050,548,502
060590626292,400.7,235.0,141.8,369,229,140
060590626312,398.7,233.8,141.1,451,225,226
060590626044,782.6,402.0,338.0,1013,500,513
060590626311,593.7,333.6,227.3,653,338,315
060590626314,419.5,223.8,177.4,489,252,237
060590626313,410.3,231.0,160.1,521,294,227
060590626282,784.7,456.1,285.8,581,299,282
060590626262,461.7,335.0,99.0,290,233,57
060590626271,457.0,330.7,99.1,619,340,279
060590626126,614.1,384.6,197.9,867,531,336
060590626121,795.2,517.5,229.8,915,558,357
060590626125,444.8,279.4,135.0,665,435,230
060590525231,336.7,213.2,105.7,321,207,114
060590525234,219.2,138.8,68.8,200,126,74
060590525222,371.1,235.0,116.5,481,295,186
060590525221,443.7,285.2,136.3,458,277,181
060590525232,418.0,256.8,139.7,455,271,184
060590525233,689.0,423.2,230.3,750,405,345
060590525193,312.5,176.7,114.1,340,178,162
060590525192,451.5,255.3,164.9,531,294,237
060590626281,289.4,172.4,98.3,502,287,215
060590626123,472.3,292.7,155.3,161,111,50
060590626124,246.6,152.8,81.1,390,253,137
060590525194,586.1,363.2,200.2,416,262,154
060590525203,440.5,265.4,153.8,492,263,229
060590626122,917.0,521.0,350.0,616,343,273
060590525142,581.7,364.8,190.7,672,389,283
060590525144,620.4,347.5,235.6,753,371,382
060590525143,485.9,276.3,179.7,650,341,309
060590525191,529.3,301.5,195.2,462,276,186
060590525201,597.2,352.2,211.8,776,410,366
060590525223,559.4,373.7,161.8,457,290,167
060590525211,601.0,388.5,167.0,685,440,245
060590525212,284.0,187.7,73.3,300,216,84
060590525202,587.6,324.8,224.7,565,322,243
060590525114,514.4,306.1,176.6,640,334,306
060590525115,401.8,239.1,138.0,332,192,140
060590525111,537.1,307.0,197.5,650,353,297
060590525116,413.8,214.7,174.6,478,222,256
060590626045,288.4,148.1,124.5,240,119,121
060590626451,667.6,292.8,340.3,766,357,409
060590626301,884.0,455.0,395.0,1080,496,584
060590525141,480.0,278.8,175.8,371,224,147
060590525172,1703.6,1033.3,547.8,2805,1670,1135
060590525173,715.4,436.7,235.2,458,269,189
060590525133,372.4,237.6,106.5,316,190,126
060590525135,415.6,236.1,156.1,484,264,220
060590525134,487.1,287.7,170.9,564,314,250
060590525132,312.6,196.5,93.6,393,245,148
060590525136,552.1,333.6,184.2,551,321,230
060590525131,512.5,305.9,176.4,420,240,180
060590525171,952.0,586.0,297.0,222,128,94
060590525061,643.8,296.3,306.7,563,244,319
060590525062,629.2,295.7,307.3,827,391,436
060590626332,1409.0,705.0,618.0,1358,640,718
060590626381,595.0,326.6,215.1,357,218,139
060590626382,836.7,444.9,336.8,1199,656,543
060590626341,426.0,228.0,177.0,396,215,181
060590626342,1176.5,564.8,528.8,1191,599,592
060590626483,1139.8,621.5,484.0,991,515,476
060590626491,1049.0,531.5,485.1,1010,533,477
060590626351,480.1,242.7,204.8,484,270,214
060590626482,685.7,355.4,309.3,604,310,294
060590626353,605.0,323.0,241.0,593,321,272
060590626352,1006.8,509.9,432.4,995,499,496
060590626411,975.8,585.0,346.4,376,227,149
060590638051,669.1,300.5,320.0,599,298,301
060590626212,782.4,403.6,324.1,695,352,343
060590626392,1018.0,503.1,455.4,844,431,413
060590626391,566.0,291.9,242.6,663,353,310
060590626402,573.5,306.5,228.6,717,401,316
060590423204,728.6,369.8,294.7,623,362,261
060590626401,1113.4,593.2,450.5,811,461,350
060590626383,1167.8,612.7,489.9,639,341,298
060590626371,699.7,388.6,267.2,521,294,227
060590626372,498.9,277.7,190.3,692,393,299
060590626373,535.9,294.4,210.6,487,290,197
060590626363,468.0,258.0,177.0,610,359,251
060590423343,781.6,370.3,365.3,784,374,410
060590423341,558.2,278.1,248.3,659,362,297
060590423342,478.5,267.3,184.2,373,213,160
060590626362,726.9,406.7,260.3,467,274,193
060590626344,375.9,197.6,149.7,453,258,195
060590626361,314.6,168.8,124.2,331,179,152
060590423201,806.5,458.0,306.5,721,411,310
060590423202,247.7,142.0,93.5,276,157,119
060590423203,568.2,304.5,227.7,461,257,204
060590626343,550.6,285.6,220.4,624,347,277
060590626412,709.9,358.5,321.1,474,263,211
060590626413,546.0,311.0,215.0,717,390,327
060590626225,844.8,410.4,406.4,1011,519,492
060590626481,428.3,208.1,206.1,509,262,247
060590626222,486.6,236.4,234.1,294,161,133
060590626221,412.5,200.4,198.4,438,224,214
060590626223,548.8,266.7,264.0,606,309,297
060590626462,563.1,296.8,249.0,484,256,228
060590626473,574.3,281.7,266.6,660,342,318
060710004032,601.6,296.1,273.0,605,287,318
060710005011,1145.5,641.2,452.1,1121,590,531
060710004031,360.9,199.5,140.0,407,227,180
060374028042,433.1,355.2,57.6,377,283,94
060374028012,181.4,149.9,25.1,160,135,25
060374028011,275.4,227.7,38.1,144,121,23
060374028041,250.1,201.7,33.2,96,78,18
060374027023,220.6,173.0,33.0,148,111,37
060374026003,438.6,301.5,101.3,376,269,107
060374088002,325.0,265.2,42.5,268,211,57
060374088001,243.6,183.8,40.6,137,105,32
060374027021,337.6,267.0,52.0,149,123,26
060374027022,230.5,178.1,37.4,125,102,23
060374027024,427.1,321.6,73.4,251,199,52
060374027051,301.2,226.8,51.8,369,251,118
060374027052,715.0,536.0,138.0,629,465,164
060374027032,802.0,617.0,142.0,783,604,179
060374027061,340.7,269.5,52.5,440,330,110
060374027063,301.1,226.7,53.9,360,294,66
060374027031,600.5,452.5,113.8,401,301,100
060710003033,309.4,236.7,58.0,227,155,72
060710003034,469.2,332.8,115.1,380,250,130
060710003032,280.2,214.6,51.7,309,188,121
060710003031,306.8,234.7,57.3,223,134,89
060710002073,271.9,208.3,50.1,247,165,82
060710003014,479.5,367.3,88.3,237,189,48
060710003011,371.0,271.2,79.7,356,257,99
060374027062,315.4,237.8,63.4,264,189,75
060710002033,419.5,299.4,96.2,389,269,120
060710002071,512.2,362.6,122.0,489,333,156
060710002031,654.6,460.3,160.6,636,433,203
060590423332,1238.6,548.4,636.1,1297,569,728
060590423272,483.6,205.4,243.9,462,253,209
060590423273,1220.4,533.6,602.1,1313,563,750
060590423282,564.2,215.6,321.8,622,212,410
060590423271,1000.5,389.5,556.7,970,433,537
060590423281,812.3,310.9,457.5,865,299,566
060590423072,571.6,282.9,259.4,758,323,435
060590626254,155.0,121.0,24.0,172,127,45
060590423075,464.0,229.7,210.6,365,161,204
060590423074,370.4,183.4,168.1,294,151,143
060590423071,994.1,417.5,507.8,1047,473,574
060590320141,789.0,472.0,257.0,992,536,456
060590320153,568.0,252.0,279.0,631,316,315
060590320151,994.4,457.5,480.9,891,397,494
060590423073,644.9,296.5,319.2,639,258,381
060590320154,702.6,294.6,372.9,795,298,497
060590320152,613.0,274.9,295.2,641,282,359
060590320121,739.8,301.7,395.2,838,353,485
060590320282,743.1,392.9,291.4,595,330,265
060590320031,896.1,386.2,450.9,936,398,538
060590320023,1016.8,438.8,520.0,925,441,484
060590320022,945.1,393.1,487.2,1083,471,612
060590320131,862.1,456.2,356.6,908,468,440
060590320132,724.3,284.2,402.9,658,265,393
060590320393,556.1,275.8,246.0,447,243,204
060590320394,560.9,278.2,248.0,593,304,289
060590320133,863.0,438.0,377.0,756,397,359
060590320402,651.4,281.3,331.5,744,326,418
060590320401,918.6,396.7,467.5,902,425,477
060590320593,540.0,240.0,277.0,113,52,61
060590320571,1142.2,513.7,560.9,296,153,143
060590320573,331.8,142.3,166.1,58,28,30
060590320572,1748.0,726.0,936.0,1516,614,902
060590320392,1376.5,591.1,710.6,1299,592,707
060590320391,571.5,256.9,286.4,659,278,381
060590320123,361.9,162.4,175.1,275,134,141
060590320122,774.6,347.3,374.8,902,390,512
060590320033,969.7,401.7,510.7,863,356,507
060590320383,1433.7,722.7,631.0,1309,621,688
060590320032,895.2,345.1,489.8,894,354,540
060590320203,408.7,169.3,214.7,456,205,251
060590320201,752.6,296.4,410.2,1170,512,658
060590320024,720.0,305.6,381.5,725,311,414
060590320021,480.4,181.0,264.8,502,211,291
060590320362,1338.0,539.0,722.0,1330,543,787
060590320321,662.5,266.5,359.0,799,287,512
060590320281,671.8,272.7,347.0,598,293,305
060590320381,2181.3,1005.4,1052.3,1593,671,922
060590320382,541.8,296.9,212.7,761,344,417
060590320371,1495.8,586.4,857.1,1568,630,938
060590320361,679.5,281.5,356.9,597,263,334
060590320352,507.8,188.2,298.9,490,201,289
060590320202,1217.4,501.8,648.1,1274,552,722
060590320373,929.4,362.2,537.0,1038,361,677
060590524112,728.8,378.5,303.6,515,243,272
060590524162,894.1,416.2,416.2,741,363,378
060590524151,1148.0,580.0,517.0,1095,514,581
060590524083,1022.2,410.7,536.6,1145,467,678
060590524082,1066.8,524.3,483.4,1029,489,540
060590524152,1111.0,452.0,577.0,1250,481,769
060590320271,1153.1,627.7,439.9,812,438,374
060590320142,1267.4,619.5,564.7,866,367,499
060590524111,785.6,377.7,362.1,630,304,326
060590320272,1184.0,555.5,551.6,1171,513,658
060590320293,587.9,287.3,261.9,660,316,344
060590524242,776.1,369.9,356.0,762,333,429
060590524243,383.0,186.0,172.3,527,201,326
060590524241,761.8,368.2,345.3,569,339,230
060590524161,314.0,153.5,139.9,313,161,152
060590524163,645.0,272.7,331.6,601,245,356
060590524262,4363.7,2688.1,1446.2,1152,611,541
060590524254,639.5,333.0,265.6,1045,580,465
060590524253,534.5,287.9,211.8,532,292,240
060590524221,935.4,397.7,478.1,895,402,493
060590524223,575.5,204.7,335.6,667,216,451
060590524251,706.4,331.6,322.0,595,343,252
060590524252,308.7,140.1,144.3,397,191,206
060590524222,1621.9,861.8,668.7,448,225,223
060590524232,791.6,449.1,290.1,377,217,160
060590524272,1120.3,485.8,563.2,1100,550,550
060590320302,1245.0,546.0,612.0,1266,546,720
060590320322,1082.1,465.4,554.1,818,369,449
060590320292,878.4,374.3,448.1,832,341,491
060590320291,576.6,268.7,269.9,523,250,273
060590524233,748.5,312.0,391.6,529,224,305
060590524231,688.8,287.1,360.4,833,325,508
060590320301,754.0,393.0,312.0,678,341,337
060590320312,882.1,384.3,441.1,1154,496,658
060590320351,895.2,331.8,527.1,938,346,592
060590320311,869.3,395.8,415.8,730,360,370
060590320331,700.6,351.5,315.0,500,275,225
060590320332,390.7,180.1,190.4,469,196,273
060590524271,1453.8,627.8,729.1,1134,496,638
060590524281,580.3,251.8,290.9,745,309,436
060590524263,784.1,339.7,394.0,864,323,541
060590320472,390.8,167.9,195.1,427,198,229
060590320473,342.2,147.1,170.9,290,158,132
060590320471,398.0,212.0,149.0,403,219,184
060590320482,1144.0,440.0,684.0,1416,597,819
060590320481,649.0,276.0,341.0,768,369,399
060590320544,556.9,259.0,260.3,465,266,199
060590320542,240.8,107.6,118.8,279,157,122
060590320543,211.6,95.7,105.2,146,87,59
060590320553,286.4,126.6,140.4,354,162,192
060590320443,588.1,180.7,381.6,729,201,528
060590320511,409.6,202.2,179.9,506,257,249
060590320501,274.5,116.4,142.5,263,130,133
060590320503,1382.8,641.9,674.5,1350,636,714
060590320541,1125.8,533.0,521.8,829,392,437
060590320513,554.2,270.2,246.8,584,306,278
060590320441,935.0,336.0,545.0,1046,362,684
060590320554,538.5,244.5,253.3,605,263,342
060590320514,339.7,161.2,155.8,199,107,92
060590320512,514.6,232.4,247.5,706,313,393
060590320552,351.0,181.8,141.5,194,116,78
060590320551,210.0,108.8,84.6,190,94,96
060590320502,684.5,315.7,321.0,613,304,309
060590320423,762.0,281.0,442.0,684,234,450
060590320491,1894.5,851.5,938.6,1711,732,979
060590524284,1066.0,462.9,529.9,1100,449,651
060590320492,346.3,110.4,211.7,378,122,256
060590320112,346.1,162.0,155.4,367,187,180
060590524282,393.4,170.0,193.9,404,194,210
060590320421,1782.7,664.0,1002.7,1955,728,1227
060590320422,505.4,178.0,294.3,357,149,208
060590524201,1678.6,1011.3,586.1,1309,754,555
060590524285,411.0,178.3,206.7,408,182,226
060590524261,566.3,245.7,284.8,659,290,369
060590320111,614.4,269.3,295.1,519,277,242
060590219241,12.0,3.0,9.0,2,0,2
060590320432,865.6,297.1,514.0,858,276,582
060590638033,379.6,211.4,140.7,404,263,141
060650481001,2888.2,1164.7,1611.7,2325,1004,1321
060650419093,390.6,178.9,194.7,525,221,304
060650419094,539.2,209.4,302.8,409,165,244
060650419111,1616.8,743.9,791.5,1216,645,571
060650419101,1428.9,625.6,739.8,983,503,480
060490003002,297.0,70.2,219.1,265,88,177
060490004001,362.5,105.1,232.3,269,90,179
060490004002,313.2,85.1,212.1,165,48,117
060510001012,306.7,152.0,132.9,529,287,242
060510001024,230.0,130.3,79.3,115,69,46
060510002009,2.8,1.5,1.1,8,5,3
060510002001,536.0,336.7,160.2,599,377,222
060510001022,292.8,92.0,182.5,421,162,259
060510001023,307.4,104.5,191.9,236,75,161
060510001021,193.1,60.4,120.3,236,92,144
060510001011,474.7,125.0,312.6,668,303,365
060510001014,533.8,293.9,203.8,534,339,195
060510002007,402.2,231.2,136.7,251,166,85
060510002003,226.8,139.1,69.3,135,80,55
060150002021,486.5,207.7,244.6,495,224,271
060150002022,211.8,68.5,129.4,172,81,91
060159900000,0.0,0.0,0.0,0,0,0
060930004001,368.8,109.4,233.5,290,115,175
060930003001,811.9,188.1,579.7,808,244,564
060930002001,585.9,141.5,407.5,615,154,461
060930001001,319.1,68.6,230.1,437,118,319
060650464011,678.5,194.6,441.3,610,239,371
060650464012,500.6,227.9,242.5,414,234,180
060650430081,875.0,356.9,474.0,740,363,377
060650430082,1065.5,408.7,604.3,864,389,475
060650430102,922.6,418.0,473.6,807,384,423
060650430101,1134.6,520.3,562.2,810,398,412
060650430033,388.8,203.6,156.2,268,149,119
060650430031,449.3,235.3,180.5,348,188,160
060650430032,463.3,223.8,208.7,310,178,132
060650464021,572.0,251.3,279.4,473,239,234
060650464022,650.7,266.5,346.7,477,239,238
060650430011,1076.4,540.1,476.7,545,310,235
060650464031,1102.9,441.8,610.7,889,435,454
060650430062,491.3,252.4,206.1,413,268,145
060650430061,504.7,269.7,201.5,287,184,103
060650427153,2457.8,1262.4,1060.4,1695,901,794
060650430051,545.8,254.5,257.2,506,268,238
060650430012,570.9,310.3,226.0,203,146,57
060650464042,370.7,187.4,154.8,196,110,86
060650430071,1598.4,684.4,824.7,1515,663,852
060650430072,961.8,411.1,496.0,795,410,385
060650420071,972.5,298.9,624.1,908,305,603
060650430091,1186.1,476.5,645.1,874,424,450
060650430092,714.2,326.7,350.1,422,213,209
060650430052,297.5,137.6,141.4,275,140,135
060650420072,902.6,260.3,593.5,868,293,575
060650420081,1472.3,592.9,818.2,1454,660,794
060650430053,437.2,186.9,233.0,371,155,216
060650429021,602.0,270.9,303.8,541,276,265
060650429031,580.2,293.0,253.8,537,299,238
060650429022,403.3,289.6,95.4,356,243,113
060650464032,476.6,186.4,257.1,425,189,236
060650464033,798.3,253.2,493.4,712,297,415
060650432711,1484.9,505.6,887.5,1137,453,684
060650432722,1749.7,435.9,1231.4,1580,402,1178
060650432721,811.0,230.7,549.0,797,176,621
060650497003,1848.1,536.0,1228.0,1630,600,1030
060650497002,1748.0,486.9,1180.0,1643,522,1121
060650464051,740.8,246.4,447.7,628,232,396
060650432702,1975.0,683.0,1186.2,1468,592,876
060650432701,262.6,95.5,154.4,267,118,149
060650506002,501.8,157.2,318.5,489,189,300
060650432273,1500.8,569.6,835.9,1065,498,567
060650432761,1568.2,573.1,899.4,1003,380,623
060650432792,593.4,201.6,351.9,501,190,311
060650464052,736.5,264.5,429.4,581,259,322
060650464041,1469.8,598.3,780.5,1021,468,553
060650427151,712.5,313.9,364.9,691,334,357
060650427152,1243.6,380.2,816.8,1050,348,702
060650432741,853.2,337.8,461.7,611,272,339
060650427331,2969.5,1194.2,1630.7,1116,528,588
060650427141,1032.9,220.6,777.4,1063,328,735
060650429011,778.0,501.2,236.7,732,483,249
060650427142,676.1,130.0,518.7,535,165,370
060650506003,510.8,145.4,339.1,431,156,275
060650497001,797.9,209.8,547.3,720,240,480
060650506004,1742.6,528.7,1146.8,1231,417,814
060650506001,465.7,145.1,297.4,485,152,333
060650432282,834.0,312.6,471.8,918,403,515
060650432061,597.0,243.7,322.2,691,308,383
060650498001,914.3,314.7,545.8,841,407,434
060650432293,815.3,299.9,471.6,1303,460,843
060650432783,639.9,203.4,407.9,656,257,399
060650432781,381.6,137.9,223.1,297,122,175
060650432272,806.2,291.7,470.7,520,230,290
060650432271,530.3,191.0,311.7,466,181,285
060650432281,547.8,200.5,317.1,268,150,118
060650432062,345.6,142.1,188.9,377,155,222
060650432063,912.2,358.9,497.8,981,387,594
060650432064,841.4,339.1,443.7,482,248,234
060650498002,506.2,143.0,336.7,275,104,171
060650504004,870.6,322.5,479.5,740,297,443
060650504002,566.1,207.1,324.5,422,191,231
060650504001,557.7,225.9,286.7,391,190,201
060650504005,1376.1,541.8,757.7,1164,534,630
060650432291,1008.1,368.8,600.8,1037,401,636
060650432292,1000.6,366.1,596.3,804,347,457
060650432782,587.2,211.5,347.3,571,212,359
060650504003,366.4,134.9,213.2,280,110,170
060650432784,767.5,261.1,472.0,524,239,285
060650507001,996.2,411.7,532.4,453,209,244
060650432793,576.1,170.0,377.0,384,129,255
060650432791,1085.4,349.8,659.8,978,379,599
060650427161,871.0,173.1,663.2,744,223,521
060650427162,795.8,215.7,548.0,557,187,370
060650427421,2392.6,849.3,1422.2,1221,494,727
060650427332,104.7,41.2,58.2,37,11,26
060650427431,901.1,286.4,564.7,434,153,281
060650427312,1061.9,628.1,365.5,544,322,222
060650427163,834.9,199.2,607.8,824,272,552
060650427171,1486.6,542.2,864.5,1108,478,630
060650429032,542.2,401.9,113.0,397,302,95
060650429042,717.1,484.4,193.4,599,381,218
060650429043,427.0,316.3,89.1,349,262,87
060650429012,833.3,613.0,173.9,706,468,238
060650428001,658.1,484.6,128.0,360,309,51
060650427321,1971.7,709.6,1146.1,1881,831,1050
060650427092,1271.0,429.0,794.0,1188,510,678
060710083012,626.7,342.5,244.8,671,334,337
060710082004,686.0,368.1,268.0,680,387,293
060710082003,407.0,201.5,177.7,457,218,239
060710082002,808.9,367.5,383.6,940,389,551
060710083011,410.2,209.4,173.5,361,167,194
060710081001,353.3,192.6,126.3,422,245,177
060710082001,756.9,412.6,270.6,630,334,296
060710080026,496.7,317.0,141.4,285,208,77
060710080025,396.3,270.1,95.5,341,245,96
060710080013,1413.6,838.3,491.0,1335,734,601
060710080012,589.6,348.7,205.8,389,235,154
060650432113,648.6,232.4,379.9,643,257,386
060650432111,384.4,146.9,214.2,463,190,273
060650432112,519.8,190.6,299.8,451,207,244
060650432114,665.9,234.5,393.7,572,232,340
060650505003,599.1,268.8,298.3,313,179,134
060650432914,261.0,106.8,136.8,331,131,200
060650432911,712.3,280.8,386.3,645,279,366
060650503001,1259.3,476.7,713.0,967,393,574
060650503002,1307.1,535.0,696.7,1053,530,523
060650432912,738.3,288.0,412.9,896,367,529
060650503003,629.3,270.3,321.0,459,226,233
060650505002,832.2,349.2,436.0,578,281,297
060650505004,761.3,331.2,384.7,499,258,241
060650505005,1199.2,526.1,609.7,1126,564,562
060650432915,1345.2,495.9,782.9,1004,389,615
060650432913,480.7,187.1,269.3,488,204,284
060650507002,692.2,287.5,371.0,470,204,266
060650503004,688.6,300.8,345.5,364,175,189
060650432472,2470.5,935.1,1383.6,1199,546,653
060650432442,1048.0,400.8,581.5,623,283,340
060650432352,1277.8,504.8,693.8,416,223,193
060650507004,763.8,260.4,472.6,705,272,433
060650507003,1159.6,474.3,622.0,705,349,356
060650432351,1242.0,493.4,697.9,449,181,268
060650427392,1833.9,728.1,1019.5,741,325,416
060650427371,885.6,347.3,490.8,607,277,330
060650427382,1711.6,593.9,1004.1,1404,605,799
060650427391,1098.8,428.8,615.3,1194,535,659
060650427381,826.7,304.2,473.3,388,168,220
060650432402,1985.0,747.5,1112.0,1219,566,653
060650432401,1201.9,444.9,683.6,1266,588,678
060650432421,2289.0,817.0,1357.2,1368,581,787
060650432422,1331.7,503.8,752.1,692,332,360
060650432393,660.5,148.8,476.3,603,175,428
060650432471,1152.4,415.0,662.6,844,349,495
060650427293,1728.6,672.4,979.6,1885,710,1175
060650427292,1607.0,636.8,898.2,1050,463,587
060650427291,1252.1,543.8,649.8,1108,527,581
060650427241,1476.5,587.0,808.2,782,343,439
060650427261,2911.1,1177.8,1570.6,1148,540,608
060650427281,735.4,321.9,372.2,580,282,298
060650427302,905.9,478.2,390.3,610,308,302
060650427301,468.3,232.7,214.1,218,129,89
060650427311,965.1,403.6,519.5,959,475,484
060650427232,769.2,334.5,398.6,717,311,406
060650427202,780.2,328.3,411.6,1155,505,650
060650427191,885.9,409.3,427.9,615,296,319
060650426202,2230.6,1678.1,424.7,1070,761,309
060650427192,614.4,254.8,324.3,632,270,362
060650427201,455.7,174.6,260.1,477,195,282
060650427451,1205.1,439.2,719.4,1186,465,721
060650427231,666.6,295.5,337.1,723,308,415
060650433173,600.3,278.6,288.8,532,298,234
060650427452,1042.8,367.3,636.8,754,308,446
060650427441,1140.3,448.1,624.4,1068,434,634
060650435042,1509.4,596.1,854.1,1375,545,830
060650432392,1278.1,309.1,905.7,1216,333,883
060650432391,1119.6,259.8,805.4,1068,334,734
060650433042,482.7,125.7,333.3,472,147,325
060650444021,1161.3,326.3,766.5,1079,400,679
060650433172,1726.9,687.0,970.2,1003,458,545
060650433171,689.3,322.6,328.1,614,304,310
060650433162,1260.2,515.0,685.4,1401,532,869
060710111021,428.1,128.6,274.2,509,195,314
060710111023,184.4,78.7,94.8,201,60,141
060710113001,278.8,110.4,147.0,256,117,139
060710111022,356.2,121.9,201.4,292,125,167
060710087031,1279.2,281.2,943.3,1251,363,888
060710115001,445.4,157.1,258.2,484,190,294
060710115002,582.7,217.2,323.5,550,255,295
060710113002,477.1,143.9,308.5,559,192,367
060710112062,328.7,112.5,199.0,319,138,181
060710112061,131.1,44.9,79.4,196,79,117
060710097083,568.0,105.5,437.1,406,122,284
060710097082,1012.6,188.2,776.4,982,280,702
060710097081,604.0,168.4,416.2,593,205,388
060710100243,932.1,239.5,658.7,757,234,523
060710121042,1291.2,287.3,948.4,920,270,650
060710121041,570.9,164.7,371.0,480,177,303
060710097124,478.9,170.2,286.8,213,103,110
060710097123,366.3,132.9,216.8,298,140,158
060710097122,590.1,193.0,369.5,674,303,371
060710097143,493.6,161.8,306.9,438,149,289
060710097133,901.0,310.8,534.2,796,301,495
060710097134,273.2,94.1,162.1,284,105,179
060710097131,608.8,161.7,411.2,547,217,330
060710097132,541.6,143.9,365.8,559,169,390
060710121031,552.9,152.0,372.0,569,212,357
060710121032,730.2,200.8,491.4,572,219,353
060650433043,1257.0,412.2,780.8,1288,482,806
060650437011,660.2,247.0,381.7,782,308,474
060650444022,293.2,86.9,187.7,424,154,270
060650433044,490.9,195.4,267.6,497,191,306
060650433041,691.6,227.8,422.5,849,277,572
060650437022,634.4,206.2,397.3,557,222,335
060650437021,1054.4,373.7,619.1,1017,380,637
060650449221,2194.5,988.4,1120.1,1401,642,759
060650449271,1141.8,490.2,616.4,901,376,525
060650449272,517.8,222.3,279.5,493,201,292
060650445201,265.6,122.9,134.9,170,66,104
060650514002,1202.2,561.4,617.7,1292,612,680
060650514001,1553.0,723.8,798.8,1684,804,880
060650514003,2050.7,955.2,1055.0,2256,1054,1202
060650452281,526.8,264.8,232.8,337,188,149
060650452282,652.9,286.7,331.7,387,199,188
060650456054,1171.7,534.0,607.8,894,386,508
060650456082,913.4,345.7,540.4,623,195,428
060650456091,367.9,266.3,77.8,420,301,119
060650456062,866.0,347.6,487.9,565,249,316
060650456081,613.1,185.6,410.0,408,100,308
060650456061,165.1,82.6,77.5,236,117,119
060650456051,238.1,201.8,24.7,164,129,35
060650456093,197.9,152.4,35.6,166,124,42
060650456042,137.1,122.4,7.2,91,69,22
060650456052,87.5,79.5,3.1,30,20,10
060650456092,264.8,210.1,39.1,178,146,32
060650457072,345.7,294.9,34.7,171,144,27
060650457051,1150.9,993.3,105.1,419,354,65
060659404001,1179.4,1003.5,118.3,775,669,106
060650457031,650.1,576.6,45.3,440,380,60
060650457032,478.6,424.5,33.3,215,186,29
060650457041,468.0,409.7,37.4,534,458,76
060650457061,495.8,431.9,41.7,398,358,40
060650469001,486.2,216.9,242.5,531,209,322
060650457062,188.6,164.3,15.9,181,150,31
060659404002,104.6,94.1,6.2,94,80,14
060650452241,830.0,566.0,224.0,657,430,227
060650452131,1565.6,989.0,492.8,1348,822,526
060650452132,316.4,143.5,160.6,342,127,215
060650452242,982.2,493.7,458.4,1011,552,459
060650491002,883.9,444.3,412.6,446,252,194
060650455012,657.7,518.5,111.6,601,435,166
060650452072,632.6,432.1,167.6,661,390,271
060650452171,850.9,566.0,237.1,821,526,295
060650452092,505.9,380.9,100.4,522,340,182
060650452071,515.1,351.9,136.5,186,133,53
060650452172,735.4,411.5,287.2,515,301,214
060650452091,570.5,400.6,132.8,518,358,160
060650455021,430.9,302.5,100.3,238,178,60
060650455022,375.9,278.9,75.7,325,217,108
060650491001,830.6,387.5,419.9,781,406,375
060650491003,425.4,198.5,215.1,414,206,208
060650452262,573.3,466.6,74.2,322,249,73
060650495001,738.0,588.3,116.4,506,402,104
060650495002,866.3,697.8,132.2,596,456,140
060650455011,332.6,262.0,54.9,163,138,25
060650452261,805.0,655.2,103.4,367,294,73
060650453031,562.8,443.1,93.2,484,359,125
060650453022,199.5,157.4,32.7,218,169,49
060650453021,481.5,380.0,78.8,518,394,124
060650453023,244.7,193.1,40.1,213,161,52
060650453042,1550.5,780.9,701.8,765,432,333
060650453041,622.9,311.7,283.4,472,252,220
060650452161,1373.9,642.0,706.3,852,401,451
060650494001,720.0,336.4,370.2,255,140,115
060650494002,1360.2,635.6,699.3,1018,478,540
060650457071,352.2,298.3,35.3,235,203,32
060650457073,671.6,568.8,67.3,521,433,88
060650453043,1155.9,644.2,462.9,514,328,186
060650452223,266.0,148.3,106.5,110,54,56
060650452221,35.3,20.5,12.1,29,13,16
060650452222,423.1,235.8,169.4,193,92,101
060650445052,864.2,398.1,440.7,937,470,467
060650445202,267.6,122.6,135.7,275,129,146
060650445051,1125.8,743.9,331.6,1015,569,446
060650449211,1082.2,549.3,509.3,1115,473,642
060650472021,634.9,284.0,325.4,533,224,309
060650445221,1238.7,684.1,502.4,1010,522,488
060650456043,558.5,449.6,70.7,325,264,61
060650456055,79.6,67.7,6.7,46,37,9
060650456053,169.3,150.7,8.3,33,27,6
060650456044,358.4,329.2,9.0,201,174,27
060650456041,238.6,219.2,6.0,255,243,12
060710104122,436.6,129.1,285.1,566,174,392
060710104121,1073.8,326.8,681.3,975,405,570
060710104123,1551.7,444.1,1044.6,1412,478,934
060710104133,673.9,247.7,391.5,527,244,283
060710104193,500.8,208.8,259.6,389,162,227
060710104191,826.5,348.5,421.6,826,397,429
060710104192,517.9,224.4,253.5,406,214,192
060710104101,640.7,211.2,393.1,721,309,412
060710104102,581.8,194.4,353.4,502,194,308
060710104202,429.5,175.1,223.4,436,204,232
060710104201,534.9,234.3,257.2,420,189,231
060710104203,296.7,137.1,137.1,237,122,115
060710104163,302.2,120.5,155.9,200,101,99
060710104231,536.2,194.0,312.3,708,317,391
060710104232,415.6,137.8,258.0,362,151,211
060710104161,555.0,208.6,302.1,879,384,495
060710104153,387.4,141.9,214.4,371,153,218
060710104162,265.4,86.4,156.4,251,110,141
060710104151,350.9,130.9,193.3,314,113,201
060710104021,270.0,99.0,143.0,929,364,565
060710104152,817.3,307.4,447.7,736,316,420
060710104221,118.8,39.2,69.7,92,44,48
060710104211,395.1,137.0,224.8,330,168,162
060710104091,501.0,178.7,281.0,69,43,26
060710104212,871.1,324.5,471.2,633,300,333
060710104222,220.7,82.2,119.4,341,108,233
060710104092,275.7,105.6,150.7,307,156,151
060710103001,146.8,44.8,91.5,220,76,144
060710103002,343.7,90.5,240.0,413,160,253
060710251001,262.1,83.2,166.2,254,131,123
060270008001,224.8,134.8,72.9,206,125,81
060270008002,247.9,85.3,135.9,250,103,147
060270005001,403.8,161.3,221.2,472,215,257
060710251002,206.6,72.4,120.5,203,74,129
060719401001,115.3,34.1,74.9,124,46,78
060650459001,240.9,83.1,145.3,319,118,201
060650461031,460.8,190.2,247.4,550,214,336
060650461021,483.5,203.5,256.4,333,187,146
060650462002,428.2,208.8,196.7,402,245,157
060650462001,383.7,186.5,177.3,308,201,107
060650470002,347.1,120.9,206.7,341,131,210
060650470001,154.6,75.3,70.7,136,60,76
060650459002,101.0,63.0,26.0,106,70,36
060650461032,327.9,160.5,150.3,418,171,247
060650461012,405.3,200.5,184.1,500,233,267
060650461011,209.0,103.5,94.8,259,146,113
060659401001,34.9,5.5,29.1,14,3,11
060659401002,46.2,7.3,38.5,0,0,0
060719401002,212.2,55.7,152.8,231,85,146
060710107002,419.1,149.5,247.7,372,179,193
060710107001,263.8,100.2,149.7,404,203,201
060379107061,1662.1,1276.4,303.2,1034,781,253
060379100023,525.6,247.9,244.9,454,204,250
060379107091,701.7,312.3,339.2,697,314,383
060379100021,977.8,497.7,409.6,717,349,368
060379107051,1931.6,1445.5,370.3,1558,1151,407
060379107052,1631.5,1239.4,308.4,838,607,231
060379101011,342.1,255.6,70.1,256,168,88
060379100013,651.0,407.4,192.6,587,345,242
060590635003,386.8,152.0,212.1,445,225,220
060590635005,283.8,121.1,145.3,271,156,115
060590635002,404.9,153.1,229.2,465,220,245
060590635001,731.4,268.0,421.9,769,354,415
060590628002,420.2,163.9,227.9,557,259,298
060590635004,313.1,118.2,174.8,347,193,154
060590628001,577.3,216.9,326.8,707,255,452
060590628003,690.8,275.2,368.6,686,290,396
060590628004,402.3,164.9,208.0,475,208,267
060590629001,737.0,217.0,488.7,725,226,499
060590629002,489.0,144.0,324.3,536,172,364
060590630051,507.8,137.7,354.3,494,115,379
060590636032,781.0,338.0,393.0,792,368,424
060590636031,773.1,371.9,343.1,813,428,385
060590992401,460.9,185.7,248.8,486,197,289
060590992393,637.1,230.9,373.7,588,232,356
060590992394,630.8,249.3,339.7,567,248,319
060590992404,717.9,340.3,328.4,688,396,292
060590992403,325.6,148.9,157.0,452,194,258
060590636041,394.2,226.8,140.0,242,153,89
060590636034,480.9,253.1,192.9,407,231,176
060590636013,343.0,162.0,152.0,338,176,162
060590636042,596.7,342.9,212.2,677,346,331
060590636051,376.1,216.1,133.7,138,96,42
060590636052,491.9,296.5,165.8,415,276,139
060590992402,1086.0,465.0,553.0,1133,500,633
060590992382,1270.0,489.0,698.0,1267,515,752
060590992381,1089.0,405.0,591.0,1109,431,678
060590992172,558.4,239.2,293.4,752,342,410
060590992171,671.6,283.6,359.0,685,286,399
060590992151,1063.8,581.6,416.0,970,569,401
060590992152,930.5,368.8,492.8,935,419,516
060590992153,592.7,239.5,316.2,573,230,343
060590992163,465.8,191.9,249.8,505,232,273
060590992144,540.5,214.5,293.7,516,234,282
060590992141,444.7,176.4,241.6,433,200,233
060590992143,473.2,187.8,257.2,492,201,291
060590992164,350.3,154.6,171.0,324,181,143
060590992162,773.6,329.2,399.9,764,344,420
060590626102,2319.5,1365.3,800.2,1754,1110,644
060590637012,518.4,288.7,192.2,157,111,46
060590638034,480.2,267.4,178.0,451,267,184
060590636012,422.0,235.0,156.4,479,281,198
060590639084,541.7,340.5,144.7,339,221,118
060590638032,371.5,206.9,137.7,481,294,187
060590636011,574.5,319.9,212.9,813,432,381
060590637014,441.6,245.9,163.7,191,142,49
060590638063,529.6,221.3,281.7,873,329,544
060590755151,1004.6,659.3,269.4,411,257,154
060590638031,301.9,168.1,111.9,600,214,386
060590638082,620.8,345.6,230.1,444,287,157
060590638081,1272.9,708.8,471.8,498,350,148
060590637011,353.7,196.9,131.1,343,202,141
060590637024,390.1,256.9,103.2,295,195,100
060590637013,532.9,296.7,197.5,183,118,65
060590639071,892.0,565.0,273.0,436,257,179
060590639052,531.4,267.8,213.0,398,260,138
060590631011,906.2,397.3,445.9,596,302,294
060590992161,431.9,179.6,230.7,372,169,203
060590638022,686.9,247.9,409.5,759,292,467
060590634005,609.4,221.5,354.5,814,234,580
060590634004,408.1,137.6,249.9,430,187,243
060590635006,617.1,222.2,361.5,472,232,240
060590634002,449.1,182.5,238.8,697,246,451
060590630103,1232.8,446.9,718.8,1568,452,1116
060250124002,38.8,11.7,26.0,167,68,99
060259400001,118.8,59.5,51.3,154,88,66
060259400003,102.3,65.1,31.3,97,61,36
060259400002,75.6,49.0,21.0,89,56,33
060250103001,297.5,108.4,172.4,636,272,364
060250123011,275.9,133.6,128.8,226,112,114
060759804011,0.0,0.0,0.0,0,0,0
060759901000,0.0,0.0,0.0,0,0,0
060750601001,1592.2,1383.3,96.7,1625,1409,216
060759803001,91.7,80.3,4.4,39,39,0
060750479012,757.3,587.7,131.5,739,557,182
060530118022,661.8,413.9,209.8,8,7,1
060530118021,392.7,245.5,124.4,172,105,67
060530117003,645.0,422.9,194.0,674,429,245
060530117002,964.2,632.4,285.7,1903,1210,693
060530117001,752.3,485.1,229.2,1626,1063,563
060530118011,784.4,507.0,229.0,94,54,40
060530118012,335.6,216.9,98.0,27,21,6
060530116021,1103.8,724.8,329.2,1066,721,345
060530119003,387.6,218.0,147.5,451,269,182
060530119002,1018.0,523.6,438.7,1159,575,584
060530128002,807.1,545.8,214.2,758,494,264
060530132001,1476.8,746.6,638.2,1311,714,597
060539900000,0.0,0.0,0.0,0,0,0
060530119004,660.5,371.8,251.0,768,387,381
060530119001,510.2,287.2,193.8,515,292,223
060530120001,1009.4,738.0,219.1,944,758,186
060530120002,805.1,552.4,206.0,714,534,180
060530123021,1012.5,737.8,210.0,1070,834,236
060530122002,1133.5,833.0,235.2,1196,938,258
060530121001,520.0,369.1,121.6,575,414,161
060530124023,776.4,543.7,185.6,778,578,200
060530124021,581.3,412.1,133.1,604,432,172
060530124022,349.8,243.5,84.5,382,253,129
060530128005,415.3,283.1,110.3,464,299,165
060530128003,602.9,410.0,162.7,667,456,211
060530128004,477.9,329.2,117.8,387,278,109
060530130001,661.3,458.5,162.0,655,430,225
060530128001,759.1,517.1,202.7,781,551,230
060530127002,316.8,224.0,75.0,297,223,74
060530121002,638.6,453.7,147.7,711,511,200
060530125024,361.0,259.1,76.3,450,351,99
060530125025,319.7,229.4,67.6,240,184,56
060530125023,565.0,404.9,120.6,636,494,142
060530122001,282.3,204.0,59.1,328,260,68
060530124011,643.9,468.8,133.3,620,491,129
060530124012,343.9,249.3,71.8,382,283,99
060250124001,108.9,46.1,58.0,122,70,52
060250101021,244.9,140.6,91.7,307,161,146
060250101011,190.0,81.7,101.5,155,74,81
060250102001,252.2,146.5,95.1,293,144,149
060250101022,257.9,171.2,71.2,181,127,54
060250101023,292.7,194.3,80.8,288,170,118
060250101024,202.4,134.4,55.9,216,144,72
060250119002,3141.6,2679.0,325.6,1634,1366,268
060250108001,198.8,72.4,120.4,195,59,136
060250108002,270.3,97.9,155.5,366,88,278
060250111001,206.6,75.0,122.8,247,102,145
060250119001,209.0,175.7,25.0,74,33,41
060250113001,1394.1,1018.0,310.7,577,370,207
060250118031,1995.5,1194.6,710.8,1335,725,610
060250111002,404.1,165.5,228.4,436,162,274
060250111003,434.1,301.6,92.2,299,178,121
060250118012,935.8,438.0,444.0,819,376,443
060250122003,446.6,404.0,28.6,293,259,34
060250122001,930.8,803.1,92.0,654,534,120
060250122004,569.4,496.6,55.9,449,412,37
060250121002,680.7,579.6,74.3,417,330,87
060250121001,426.4,358.1,50.7,189,154,35
060250121003,490.0,435.3,38.0,290,250,40
060250122002,461.9,396.4,45.9,413,343,70
060730210001,364.2,130.5,206.6,263,109,154
060730211004,246.0,92.9,144.0,226,108,118
060730211003,1407.3,410.6,909.0,1317,405,912
060730211002,668.7,188.2,450.8,586,185,401
060730209021,285.8,92.7,176.7,298,99,199
060730212021,1027.1,280.7,700.7,1062,378,684
060730209042,471.5,162.0,283.2,501,193,308
060730209033,768.2,260.2,457.9,913,370,543
060250123012,95.9,26.2,65.9,101,43,58
060250110005,1499.3,727.6,688.4,987,454,533
060250110006,1785.8,954.1,730.0,1186,627,559
060250110004,298.8,167.9,114.4,350,175,175
060250110001,272.5,153.5,103.9,271,156,115
060730210003,480.7,253.2,205.8,501,294,207
060730210004,406.9,216.2,172.9,173,100,73
060730210002,373.2,199.1,157.6,578,261,317
060650444033,750.8,251.4,452.9,640,268,372
060250123021,156.1,94.9,56.3,127,70,57
060250123022,435.9,208.9,209.2,219,127,92
060250123023,213.3,101.7,102.1,221,112,109
060730209041,737.1,280.7,422.2,761,313,448
060730209032,179.2,46.9,110.8,180,56,124
060730209031,213.9,78.3,123.9,277,119,158
060730191061,1583.5,534.7,953.0,1297,408,889
060730191012,279.4,105.4,158.5,283,100,183
060730191011,545.5,258.2,242.0,862,478,384
060730191062,699.6,194.7,471.2,656,151,505
060730191014,352.7,159.0,159.3,218,90,128
060730207091,1628.5,654.8,869.0,1460,537,923
060650432573,405.6,150.0,234.3,263,119,144
060650444031,332.8,88.5,218.0,423,156,267
060650444032,310.0,88.6,202.9,233,90,143
060650444023,646.5,190.4,419.0,523,202,321
060730209043,533.2,212.5,294.3,490,198,292
060730167021,922.0,307.5,548.5,849,323,526
060650444024,412.6,183.3,207.0,389,204,185
060650432622,1152.0,421.0,677.0,1095,441,654
060650432182,1304.0,452.6,781.9,1017,381,636
060650432183,846.9,288.0,509.1,727,265,462
060650432671,1407.1,478.4,860.9,1255,472,783
060650432461,468.5,91.2,352.9,457,113,344
060730191031,653.2,208.6,408.6,549,166,383
060730191013,1533.9,549.4,885.6,1168,438,730
060650432462,2015.6,672.1,1230.7,1648,614,1034
060650432653,536.4,187.8,311.9,326,146,180
060650505001,893.3,395.1,446.2,722,356,366
060650496003,939.4,392.2,490.2,553,294,259
060650496002,1108.2,465.9,579.8,746,342,404
060650496001,604.2,255.3,316.6,508,246,262
060650432171,1210.3,493.0,646.6,1271,518,753
060650432202,555.8,238.8,278.9,740,311,429
060650432201,638.2,274.2,320.1,323,171,152
060650432221,1100.0,348.4,680.3,923,361,562
060650432163,892.6,344.6,480.5,825,330,495
060650432162,743.7,301.0,378.9,796,374,422
060650432662,1019.7,439.3,481.8,744,361,383
060650432661,180.3,77.7,85.2,262,100,162
060650432672,2014.2,717.7,1208.5,1905,723,1182
060650432443,1201.3,482.3,652.0,1003,467,536
060650432441,965.7,384.4,538.6,997,451,546
060650432181,790.8,303.8,432.1,854,321,533
060650432542,417.1,154.5,229.6,424,146,278
060650432503,894.9,368.2,475.4,499,249,250
060650432521,1712.7,710.7,911.5,1071,520,551
060650432501,484.5,203.7,252.0,255,135,120
060650432504,722.8,288.1,395.6,632,264,368
060650432505,934.3,416.0,471.8,703,375,328
060650432522,1229.1,486.5,689.7,735,311,424
060650432481,1832.0,670.8,1049.6,1577,608,969
060650432563,455.5,181.2,247.1,352,190,162
060650432561,384.1,142.7,210.9,289,144,145
060650432651,1634.6,569.0,956.8,1202,468,734
060650432643,1596.0,596.9,898.3,1344,544,800
060650432571,970.9,361.1,559.9,706,296,410
060650432572,1977.7,754.1,1119.9,1182,497,685
060650432562,495.7,201.0,267.9,379,195,184
060650432642,768.9,307.2,410.2,808,372,436
060650432641,813.1,324.8,433.8,595,280,315
060650432621,1350.0,478.0,793.0,1325,490,835
060650432652,849.1,285.7,511.3,557,230,327
060730186112,1925.2,798.1,993.8,1269,544,725
060730189062,364.2,171.9,170.9,200,78,122
060730189061,468.1,245.9,185.3,370,187,183
060730187001,1408.8,477.6,763.6,1589,636,953
060730188011,1070.3,349.7,666.5,1132,359,773
060730189053,1416.4,585.8,753.3,1227,469,758
060730189052,184.1,110.3,54.5,111,67,44
060730189063,1117.4,418.3,653.7,1183,436,747
060730189051,301.7,180.9,89.0,268,146,122
060730189042,335.4,162.8,150.2,237,122,115
060730189041,138.8,83.2,40.9,204,89,115
060730189033,536.6,266.5,232.2,365,212,153
060730189034,255.9,140.4,96.5,257,112,145
060730189031,610.2,217.3,357.6,851,355,496
060730188021,1022.4,310.3,673.2,747,216,531
060730188025,1134.8,370.8,710.7,1188,358,830
060730188033,1528.7,552.0,887.1,1276,444,832
060730188031,390.9,104.9,270.8,478,140,338
060730188022,1085.0,315.9,714.5,1123,330,793
060730188012,982.9,330.4,603.5,950,304,646
060730188023,979.9,304.8,628.5,981,292,689
060730190013,1909.4,625.2,1193.8,1724,521,1203
060730189044,886.2,391.3,446.5,809,310,499
060730189043,333.9,161.0,150.8,361,164,197
060730190012,957.5,340.2,567.5,919,321,598
060730190011,466.6,178.8,261.3,515,196,319
060730189032,322.3,110.4,194.0,194,85,109
060730188024,879.3,303.1,542.1,763,286,477
060650432541,481.3,181.8,265.7,405,176,229
060650512001,980.8,382.2,540.3,669,244,425
060650512002,445.3,130.5,291.9,430,116,314
060730171101,1099.2,446.1,602.0,1103,412,691
060730196022,1088.4,464.2,568.5,1077,436,641
060730192082,1071.1,408.4,590.9,1072,413,659
060730192071,1748.3,662.5,983.8,1866,665,1201
060730199021,1005.3,479.7,470.9,954,425,529
060730192081,732.3,281.2,401.6,652,248,404
060730192031,479.5,210.1,246.5,438,196,242
060730193031,1311.1,540.9,696.2,1248,502,746
060730192032,892.3,437.6,403.2,815,376,439
060730193033,1097.9,453.2,578.0,988,395,593
060730192054,341.9,182.8,140.7,339,151,188
060730192053,683.3,364.0,282.1,414,196,218
060730192052,578.1,308.0,227.4,644,304,340
060730192072,783.3,366.1,362.8,800,371,429
060730192074,237.7,124.9,95.5,172,86,86
060730192073,462.1,252.1,178.0,190,118,72
060730186121,923.8,408.9,448.5,905,415,490
060730188032,533.1,181.5,322.2,600,219,381
060730186111,774.2,259.2,476.7,883,308,575
060250109001,487.6,262.2,204.4,339,181,158
060250109005,162.1,110.9,44.1,173,104,69
060250109002,453.7,269.6,153.1,320,167,153
060250109003,363.6,224.7,115.5,389,207,182
060250102002,349.0,246.9,91.0,277,181,96
060730212022,461.3,107.9,331.6,431,118,313
060730211001,576.3,313.1,230.6,510,255,255
060730209022,968.1,235.5,689.8,917,260,657
060730208052,796.1,274.3,474.5,762,266,496
060730208061,664.7,224.3,401.3,484,190,294
060730208071,1561.6,424.1,1045.7,1359,392,967
060730208012,1001.6,281.8,662.2,1279,387,892
060730208062,801.4,241.9,505.7,551,227,324
060730208051,529.8,142.3,357.0,534,157,377
060730208092,1458.8,406.7,971.7,1457,465,992
060730208091,636.3,190.7,410.1,652,219,433
060730208063,765.8,181.6,544.5,787,243,544
060730208093,687.4,204.4,457.5,604,177,427
060730208101,776.4,220.6,506.8,668,218,450
060730208111,765.2,217.4,505.7,789,255,534
060730208113,1065.7,305.2,694.1,1093,359,734
060730170301,7453.0,4289.0,2767.4,4394,2147,2247
060730170292,1321.5,527.2,731.4,1376,481,895
060730171061,814.4,355.2,425.2,955,371,584
060730171062,788.6,328.8,418.5,814,320,494
060730170291,3571.3,1706.4,1694.7,3252,1335,1917
060730083361,369.9,198.3,151.5,506,246,260
060730083353,3317.8,1840.5,1290.2,3297,1697,1600
060730083351,613.0,295.7,269.9,634,311,323
060730083362,862.1,468.4,342.6,857,416,441
060730170331,619.2,370.8,193.1,597,331,266
060730170332,391.4,226.0,141.2,453,238,215
060730170333,1294.9,750.4,476.2,1452,723,729
060730170321,4263.5,2390.5,1623.2,3821,1861,1960
060730170225,344.6,206.4,114.1,399,231,168
060730170224,404.1,246.6,128.2,630,361,269
060730170226,635.5,372.7,218.8,568,304,264
060730170432,642.9,367.8,242.5,1011,523,488
060730170431,1830.5,1060.9,663.6,1446,808,638
060730170461,1444.2,814.7,543.4,1540,740,800
060730170442,1137.1,668.3,404.5,1185,607,578
060730170223,439.6,256.2,158.6,473,238,235
060730170221,436.4,252.0,159.7,484,256,228
060730170222,463.8,270.3,167.3,545,276,269
060730170473,818.6,422.3,345.8,751,366,385
060730170462,809.0,456.4,320.6,621,324,297
060730170441,1085.5,610.4,421.4,1261,669,592
060730095041,3139.2,1738.6,1241.7,2174,1107,1067
060730170371,1176.0,650.9,450.8,944,486,458
060730170182,778.0,465.0,267.0,806,475,331
060730170392,1436.7,776.9,565.5,1430,736,694
060730170423,1127.2,651.4,409.2,1055,536,519
060730170322,1110.9,584.5,444.3,1222,602,620
060730170311,578.0,291.8,235.5,741,334,407
060730170304,1218.6,676.5,463.5,1100,572,528
060730170313,805.8,436.6,309.6,705,369,336
060730170312,360.8,193.2,141.4,387,182,205
060730170552,650.3,389.2,223.7,784,400,384
060730170561,1094.4,617.6,413.2,951,493,458
060730170391,531.0,270.0,238.0,372,169,203
060730170551,790.9,486.3,269.0,703,366,337
060730170553,813.6,452.9,317.3,863,435,428
060730170522,1231.7,667.9,504.3,1101,545,556
060730170523,329.2,175.5,137.6,443,219,224
060730170401,1133.1,535.6,536.7,880,370,510
060730170411,983.4,417.1,496.8,1065,407,658
060730170402,478.3,212.7,239.2,788,290,498
060730170501,695.3,330.8,330.8,684,314,370
060730170511,578.9,312.5,238.4,716,368,348
060730170502,694.7,302.6,350.9,716,285,431
060730170541,1288.3,561.0,635.7,869,368,501
060730170542,598.1,258.3,295.4,446,179,267
060730170544,771.6,359.2,381.6,1365,640,725
060730170521,732.6,397.3,299.9,761,404,357
060730170513,1163.3,606.5,504.5,1187,551,636
060730170512,491.8,237.8,235.8,567,255,312
060730170141,961.1,466.1,453.9,802,357,445
060730170142,1078.1,523.4,522.2,981,450,531
060730170153,1724.1,907.8,714.2,2149,1111,1038
060730170152,733.9,338.9,349.7,531,212,319
060730170062,688.8,270.6,362.7,892,330,562
060730170061,910.7,413.8,438.0,941,438,503
060730170191,1161.4,562.7,544.5,1331,579,752
060730029052,403.1,278.9,97.6,383,245,138
060730148053,896.6,513.4,312.5,816,453,363
060730097061,781.8,419.6,323.6,827,399,428
060730148062,503.6,319.7,147.3,477,305,172
060730148061,419.4,266.3,122.7,323,215,108
060730148052,734.8,461.0,222.7,643,399,244
060730148043,611.4,362.7,206.9,627,373,254
060730148051,477.7,300.8,143.9,459,260,199
060730097063,807.8,441.6,321.5,929,496,433
060730097064,399.5,214.3,163.3,455,226,229
060730097065,677.1,373.0,272.9,706,350,356
060730148042,1155.8,669.5,419.8,1132,647,485
060730148032,617.6,341.3,243.3,723,400,323
060730148033,490.4,265.4,192.0,488,274,214
060730169021,1171.8,327.7,779.9,956,327,629
060730208013,1005.8,311.0,632.9,944,307,637
060730208102,363.0,107.6,232.9,365,93,272
060730208011,797.2,276.7,473.3,587,220,367
060730208112,1139.4,308.2,778.8,1120,337,783
060730208103,1952.1,525.8,1319.8,1764,540,1224
060730212042,1319.0,396.3,865.0,1274,392,882
060730212041,1173.0,275.3,844.2,1460,414,1046
060730155021,583.1,153.6,401.6,556,197,359
060730212052,701.7,207.9,457.7,782,309,473
060730212051,1294.9,382.2,852.0,1058,368,690
060730212043,300.3,79.0,208.2,271,73,198
060730212053,1191.2,358.9,780.9,890,311,579
060730213022,1452.2,432.9,922.0,1238,419,819
060730212061,1774.1,439.9,1266.9,1703,523,1180
060730155022,1012.2,248.7,710.3,894,276,618
060730155012,1403.0,396.4,941.1,1484,457,1027
060730155011,464.1,142.4,302.0,565,189,376
060730168022,1289.3,330.1,909.2,1004,285,719
060730213031,1360.7,476.1,826.0,1322,501,821
060730155013,736.2,223.1,485.0,745,265,480
060730168073,1186.9,381.5,734.3,1219,403,816
060730168101,1377.2,378.0,903.7,1442,472,970
060730169011,871.5,245.0,576.8,929,310,619
060730168044,509.4,165.1,311.3,384,155,229
060730168111,1479.4,413.5,994.0,1337,418,919
060730168112,778.7,231.0,514.8,825,287,538
060730168043,507.6,172.0,301.6,556,215,341
060730168042,699.7,228.3,424.1,585,216,369
060730168041,646.3,165.0,452.5,728,204,524
060730168092,894.0,248.0,617.0,837,272,565
060730168024,1402.3,389.5,963.2,1331,424,907
060730168093,870.5,260.6,569.3,915,329,586
060730168021,678.9,177.0,475.3,683,204,479
060730168023,596.9,167.9,405.7,579,191,388
060730213021,763.1,332.3,388.6,790,317,473
060730213042,594.6,181.0,390.0,615,212,403
060730213033,505.6,177.2,308.5,422,169,253
060730213041,851.5,278.3,536.4,897,340,557
060730213032,3034.6,1467.5,1411.6,2372,1030,1342
060730154061,1550.9,493.1,986.8,1504,487,1017
060730154053,876.2,259.2,567.9,945,329,616
060730154052,915.9,289.8,571.2,948,314,634
060730156021,826.6,224.9,566.5,862,229,633
060730156022,492.2,154.7,320.3,574,175,399
060730154051,913.2,340.2,525.1,954,394,560
060730156012,947.6,326.3,582.1,903,358,545
060730156011,703.6,279.2,384.8,823,346,477
060730164021,1159.3,326.0,780.2,1299,422,877
060730168091,574.0,177.2,364.4,527,191,336
060730156013,313.0,143.4,145.8,275,139,136
060730168074,690.4,245.3,408.5,652,223,429
060730168063,643.1,248.1,355.2,505,212,293
060730157042,536.1,239.1,266.8,565,255,310
060730157041,521.1,239.6,243.7,567,267,300
060730157012,545.5,306.8,203.1,500,280,220
060730157011,253.7,138.7,97.7,250,154,96
060730163022,488.0,247.6,208.8,535,296,239
060730154043,798.9,287.6,474.3,814,320,494
060730164024,386.2,159.5,203.6,276,167,109
060730163023,392.6,205.6,160.5,375,234,141
060730165024,592.0,224.9,331.5,622,258,364
060730165023,592.0,302.4,255.3,407,220,187
060730165021,431.6,148.9,257.1,451,188,263
060730162021,392.1,176.7,190.7,374,211,163
060730163021,373.9,181.0,170.6,315,160,155
060730165022,608.6,282.9,279.9,568,282,286
060730164012,705.0,277.4,389.5,716,298,418
060730164013,986.5,333.9,600.7,988,373,615
060730167011,3339.5,1234.3,1930.9,2666,1031,1635
060730164025,498.0,248.0,218.0,385,177,208
060730164022,298.4,101.0,182.1,375,145,230
060730164023,436.9,182.6,229.4,248,107,141
060730164011,445.4,134.4,297.2,427,140,287
060730168061,592.6,181.3,379.7,479,172,307
060730168062,349.3,106.8,224.3,292,107,185
060730168072,1146.7,308.2,781.2,1068,346,722
060730166171,451.0,169.1,256.5,517,189,328
060730166151,1175.9,498.1,599.1,865,405,460
060730166172,898.7,344.8,496.1,829,358,471
060730166071,1371.0,466.6,841.6,1357,512,845
060730166101,1019.9,406.7,539.5,915,381,534
060730166102,951.2,306.7,585.0,1071,385,686
060730166091,1089.9,344.6,665.2,1127,401,726
060730166092,588.1,168.6,377.4,588,186,402
060730166072,817.3,229.5,536.3,761,255,506
060730167012,696.6,250.4,410.7,656,244,412
060730166073,1028.6,379.4,581.8,1024,417,607
060730166093,826.0,306.8,463.4,887,394,493
060730166081,1317.0,377.0,868.0,1306,451,855
060730169013,823.6,234.8,550.5,753,213,540
060730169012,527.6,152.5,344.5,615,205,410
060730167024,760.7,213.3,506.5,711,248,463
060730167023,376.3,111.6,243.6,371,147,224
060730167022,909.0,305.0,551.5,895,318,577
060730169014,1189.6,341.1,781.5,995,345,650
060730168071,383.4,101.0,261.3,410,140,270
060730170492,955.2,425.1,458.5,780,316,464
060730170484,378.1,185.6,167.9,421,194,227
060730170483,680.9,336.6,299.4,763,361,402
060730170451,1174.4,668.5,449.8,1312,621,691
060730170482,474.4,232.0,208.0,505,237,268
060730170413,391.1,185.0,179.2,389,158,231
060730170412,850.5,411.4,365.0,768,354,414
060730170092,718.4,280.1,376.8,742,307,435
060730170491,747.1,334.6,355.9,486,198,288
060730170101,778.7,343.9,379.1,708,280,428
060730170102,808.3,340.8,414.4,952,358,594
060730170414,682.1,307.7,332.4,656,297,359
060730170543,608.7,269.2,302.1,527,201,326
060730170091,958.6,396.9,485.5,1105,452,653
060730170532,834.6,371.4,409.2,1121,410,711
060730170531,836.1,395.1,388.1,1007,421,586
060730170201,1589.3,675.0,818.4,1575,555,1020
060730170202,760.9,318.0,401.9,688,272,416
060730170212,829.0,292.3,482.6,806,296,510
060730170211,1273.6,512.5,671.1,1119,411,708
060730180002,1014.5,563.0,373.7,908,538,370
060730180003,316.7,167.6,128.3,314,184,130
060730180001,356.9,189.3,144.0,446,211,235
060730181004,361.4,200.9,136.8,322,181,141
060730179003,589.8,366.1,181.3,320,217,103
060730179002,357.7,212.3,118.3,308,194,114
060730179004,699.1,400.6,251.2,525,344,181
060730178132,1392.9,637.6,690.9,1230,573,657
060730221003,1653.0,884.0,671.4,1272,639,633
060730178131,1110.4,570.2,498.8,1090,547,543
060730178111,800.1,459.3,292.7,586,324,262
060730178112,1451.9,732.7,647.3,1378,622,756
060730179005,357.3,202.4,131.0,237,136,101
060730178102,1828.0,890.9,810.6,1766,847,919
060730178101,1305.9,639.0,570.5,1376,681,695
060730178091,1253.1,584.0,570.9,1356,699,657
060730221001,1752.0,863.3,788.1,1281,590,691
060730200131,3303.0,1726.0,1390.9,2630,1278,1352
060730136052,907.9,400.0,460.8,945,383,562
060730136051,1387.1,570.7,756.9,1517,629,888
060730136043,1047.9,405.2,595.0,1312,513,799
060730136044,441.6,212.2,209.9,447,247,200
060730136042,451.5,145.1,283.5,428,179,249
060730136041,559.5,193.2,340.4,539,216,323
060730089014,640.0,421.0,166.0,486,295,191
060730089012,299.2,185.9,93.4,222,129,93
060730089011,395.9,245.9,123.6,489,299,190
060730089013,938.9,597.2,291.0,822,494,328
060730090001,828.9,560.3,220.9,914,585,329
060730090002,387.1,261.7,103.1,328,193,135
060730088002,250.1,161.9,74.7,275,169,106
060730088001,664.0,472.5,158.1,467,276,191
060730088003,377.6,246.9,110.5,617,378,239
060730088004,476.3,322.7,128.7,302,167,135
060730087022,945.1,548.2,346.5,944,537,407
060730086003,228.4,167.1,48.2,162,113,49
060730086004,297.7,217.8,62.8,110,79,31
060730086002,297.7,217.8,62.8,236,152,84
060730086001,948.1,579.4,287.1,993,620,373
060730087012,368.2,229.4,114.7,340,222,118
060730087011,330.9,189.6,117.3,483,273,210
060730087021,539.5,359.4,138.2,564,354,210
060730093042,709.6,471.7,193.0,775,528,247
060730093043,1616.8,1075.3,437.3,1396,923,473
060730010001,763.0,606.0,104.4,726,602,124
060730092021,1612.6,988.0,528.9,670,325,345
060730087023,359.6,240.8,90.5,340,236,104
060730092013,611.5,326.4,234.8,638,328,310
060730092012,290.9,182.2,85.9,156,96,60
060730085093,536.6,323.4,178.8,555,315,240
060730085094,1085.2,694.5,315.2,1244,764,480
060730085092,752.0,430.1,269.6,573,302,271
060730085104,557.9,365.4,149.7,588,384,204
060730085091,665.5,374.3,246.4,553,293,260
060730085102,980.9,545.6,368.2,1039,533,506
060730085103,768.5,480.2,232.7,692,403,289
060730085095,241.4,161.5,63.3,364,216,148
060730085073,598.9,363.9,192.4,515,310,205
060730085074,416.0,279.0,106.9,359,252,107
060730085072,313.2,203.9,86.7,330,209,121
060730085044,578.9,321.1,215.6,532,292,240
060730085075,615.2,331.3,241.0,562,301,261
060730085071,713.8,392.0,272.3,852,412,440
060730085076,441.9,245.8,165.6,397,226,171
060730085101,547.0,337.0,170.0,593,376,217
060730185102,482.0,272.2,170.6,357,193,164
060730185123,617.0,329.2,272.6,564,284,280
060730185122,548.7,295.5,234.6,469,248,221
060730185121,776.7,408.6,332.1,864,473,391
060730185152,2302.8,1123.8,1037.3,1814,867,947
060730185161,1002.9,518.4,414.9,1177,535,642
060730185133,825.2,398.5,392.4,758,368,390
060730185131,1126.6,611.2,439.0,944,515,429
060730185132,2091.1,1048.3,900.9,1792,943,849
060730186081,908.1,421.4,429.8,1260,594,666
060730186012,1521.1,721.9,711.8,1382,668,714
060730186032,397.7,223.7,144.7,190,122,68
060730186131,909.6,489.5,339.8,798,462,336
060730186141,586.9,327.5,225.2,544,308,236
060730186143,970.5,537.2,374.3,776,434,342
060730186142,779.5,410.0,327.3,720,374,346
060730185073,634.5,301.2,296.2,619,292,327
060730186132,355.8,190.7,142.1,339,191,148
060730185074,1264.3,601.8,570.1,1228,571,657
060730186082,429.7,207.4,188.2,267,152,115
060730186093,633.5,409.3,184.4,411,270,141
060730186092,394.0,255.3,113.6,408,263,145
060730186091,1028.5,477.4,497.2,811,369,442
060730186101,874.1,373.4,448.2,977,470,507
060730175011,415.5,278.4,104.8,407,291,116
060730177023,529.8,353.4,148.3,503,347,156
060730177021,592.5,395.8,157.0,534,368,166
060730175012,622.3,392.6,175.5,585,414,171
060730177022,455.4,296.0,129.7,494,347,147
060730176031,621.2,422.5,154.1,639,439,200
060730174011,1080.4,720.9,290.5,1127,726,401
060730175013,802.5,581.7,169.2,742,561,181
060730174013,841.7,548.1,237.6,707,498,209
060730175022,531.0,356.4,137.2,521,369,152
060730175021,403.3,273.5,101.5,423,301,122
060730175023,585.1,411.5,132.4,438,303,135
060730176041,1765.7,1051.5,602.8,1440,838,602
060730176032,654.1,435.2,173.1,645,444,201
060730176012,1045.8,615.9,370.6,956,568,388
060730176043,885.6,585.3,240.1,836,529,307
060730177012,1019.1,619.6,317.2,943,620,323
060730177014,729.8,491.2,179.5,647,475,172
060730177011,485.2,312.6,141.0,639,444,195
060730177013,635.6,405.7,190.2,340,249,91
060730176011,617.0,409.1,163.6,667,462,205
060730171102,3138.8,1628.0,1301.2,3270,1611,1659
060730200162,701.8,377.5,287.4,779,370,409
060730176013,1547.1,810.8,647.4,1612,774,838
060730174041,664.9,442.5,172.3,420,283,137
060730174042,577.9,384.0,150.0,587,419,168
060730174033,692.9,426.1,216.0,649,400,249
060730174043,1154.2,703.3,381.1,1145,683,462
060730174034,868.2,500.5,318.8,853,465,388
060730176042,1105.7,610.8,436.9,1012,585,427
060730174032,827.3,469.9,308.1,814,430,384
060730174031,771.7,444.6,287.4,732,409,323
060730171084,543.0,344.0,157.0,540,322,218
060730171081,544.0,338.0,180.0,545,312,233
060730171082,948.2,593.3,287.3,927,601,326
060730171072,769.3,477.1,242.2,741,416,325
060730171083,681.8,442.8,189.9,674,426,248
060730171071,1003.3,609.2,328.7,1078,579,499
060730171103,1208.1,621.9,516.2,1221,536,685
060730171041,1394.4,832.0,475.5,1538,887,651
060730200165,552.1,299.5,230.4,534,287,247
060730200164,628.4,348.8,246.3,597,319,278
060730200161,1603.2,901.4,592.8,1528,787,741
060730200163,2009.1,1109.5,779.3,1769,866,903
060730200151,1285.6,718.1,500.1,1160,662,498
060730200142,1266.4,728.9,454.9,1147,658,489
060730200141,806.1,429.8,329.9,774,389,385
060730178081,683.0,319.8,330.1,777,312,465
060730178114,611.3,290.2,294.1,446,193,253
060730178113,951.7,505.9,384.2,880,481,399
060730178082,1132.3,602.1,460.8,1190,572,618
060730178083,602.7,281.0,291.7,777,307,470
060730221002,1121.8,598.7,446.2,1300,694,606
060730198043,1290.9,649.4,559.6,1057,568,489
060730198063,2313.7,1188.0,999.5,1617,837,780
060730198062,511.0,264.5,223.4,575,235,340
060730178084,1054.0,547.0,437.0,861,418,443
060730200143,940.0,485.7,390.7,888,472,416
060730200133,1351.4,747.1,527.0,1276,648,628
060730198081,570.4,291.8,257.0,744,338,406
060730198083,1388.1,710.2,635.8,1429,706,723
060730198064,2135.2,1071.9,916.8,2006,917,1089
060730198061,1297.9,669.9,529.3,1198,635,563
060730171042,923.4,584.0,276.7,756,481,275
060730171063,808.2,313.8,452.4,821,250,571
060730171091,1403.3,727.5,589.8,1264,545,719
060730171092,540.7,298.5,204.2,652,355,297
060730171093,615.2,318.3,246.5,478,265,213
060730171094,1047.4,559.3,412.5,1049,496,553
060730200152,1542.4,751.9,691.6,1038,553,485
060730200271,5088.6,2589.4,2191.5,3659,1788,1871
060730171064,660.9,265.4,369.7,644,222,422
060730203071,1133.0,458.8,589.0,1613,683,930
060730200144,999.1,518.1,422.6,634,312,322
060730200132,1999.9,1068.1,821.8,2002,1023,979
060730200273,1672.9,776.1,832.6,1271,532,739
060730200193,1308.9,648.1,580.6,1203,578,625
060730200261,535.6,239.7,274.8,440,195,245
060730191051,701.7,234.8,435.8,926,333,593
060730191071,1019.5,312.5,660.5,902,287,615
060730191052,2081.9,758.4,1196.3,1865,614,1251
060730191053,1075.2,344.6,662.3,956,314,642
060730190021,698.5,274.3,381.7,636,255,381
060730191032,1483.6,528.8,865.4,1370,491,879
060650432543,1016.2,391.2,542.9,939,397,542
060650432222,1091.0,345.6,674.7,967,314,653
060650432502,221.2,102.1,108.4,218,108,110
060650432161,631.9,257.5,319.1,330,198,132
060730083453,788.7,504.5,237.9,737,474,263
060730083452,658.1,393.6,219.5,556,329,227
060730083441,1003.1,635.0,319.2,1013,642,371
060730083442,939.9,594.0,299.9,944,605,339
060730085052,441.1,258.5,155.0,415,247,168
060730085062,512.7,297.4,183.5,589,319,270
060730085055,542.9,321.7,186.4,475,278,197
060730085054,681.1,402.2,235.8,652,359,293
060730083451,628.2,372.9,211.6,649,354,295
060730085051,601.6,344.4,221.8,686,385,301
060730085053,314.5,180.0,115.9,370,200,170
060730083402,225.9,144.8,71.6,315,206,109
060730083404,823.4,549.3,234.0,932,598,334
060730083401,1180.6,863.9,235.4,1682,1198,484
060730083403,671.0,493.0,125.0,108,81,27
060730083391,632.0,470.0,120.9,812,659,153
060730083501,889.9,510.2,322.7,807,422,385
060730083121,364.0,251.3,95.7,396,277,119
060730172001,706.7,435.0,233.2,821,503,318
060730172003,472.4,278.3,166.5,490,337,153
060730172004,849.5,562.4,243.5,802,546,256
060730172002,610.1,354.9,211.5,617,373,244
060730083242,1410.2,935.4,400.4,1407,874,533
060730083243,629.1,429.2,157.7,418,276,142
060730083241,1262.4,841.4,351.0,1656,1132,524
060730083244,963.5,649.4,268.3,786,508,278
060730174014,668.2,431.1,188.8,797,502,295
060730174012,658.7,428.8,183.5,594,414,180
060730173041,530.4,328.0,170.9,553,328,225
060730173043,862.9,545.9,268.6,746,458,288
060730173033,330.4,207.8,97.3,377,229,148
060730173044,843.0,505.0,287.0,834,519,315
060730173042,385.0,226.0,130.0,467,299,168
060730173061,1295.3,697.5,541.4,1142,548,594
060730173062,722.9,422.9,259.3,721,390,331
060730173053,684.1,375.2,276.7,733,389,344
060730173052,549.6,297.3,215.0,456,221,235
060730173051,590.5,330.9,228.6,833,396,437
060730173031,838.1,533.8,257.2,665,424,241
060730173032,692.2,478.6,185.1,736,496,240
060730174045,511.0,316.1,160.5,517,304,213
060730174044,636.5,419.7,167.1,780,544,236
060730083332,3229.7,1929.6,1129.2,2765,1558,1207
060730083331,3190.2,2009.7,1007.3,2726,1540,1186
060730083461,1650.1,1014.2,520.0,1438,864,574
060730083293,1236.0,788.4,387.1,1049,656,393
060730083292,841.3,532.0,251.3,1013,613,400
060730083291,940.8,596.5,289.5,801,499,302
060730083311,1372.6,871.9,434.6,1290,748,542
060730083273,549.3,336.8,185.1,580,324,256
060730083271,1094.8,670.4,362.6,1106,635,471
060730083301,1530.7,965.9,489.9,1405,825,580
060730083302,1260.0,844.7,349.7,1118,749,369
060730083272,1273.0,794.9,430.3,1326,791,535
060730083281,2534.5,1463.4,956.6,2524,1363,1161
060730215003,604.7,388.5,194.6,503,251,252
060730215002,1302.3,811.5,432.4,1377,750,627
060730134191,2943.3,1832.4,987.1,2286,1294,992
060730134192,368.7,239.6,115.9,273,175,98
060730134101,2213.4,1310.6,815.2,1853,1014,839
060730133141,6192.2,4026.5,1882.3,4072,2458,1614
060730135041,388.1,213.7,156.5,356,200,156
060730135043,809.4,403.6,367.1,751,400,351
060730135061,1415.0,722.0,624.0,1345,699,646
060730135042,439.6,209.0,208.9,439,188,251
060730135033,1043.1,486.8,501.9,1038,478,560
060730135053,280.5,144.1,122.2,383,180,203
060730135051,1223.3,597.3,568.2,1192,582,610
060730135031,539.4,246.1,256.8,604,266,338
060730135032,724.7,402.3,270.7,598,347,251
060730135052,596.2,323.6,238.6,586,347,239
060730136012,888.9,460.6,382.1,932,452,480
060730136013,811.5,403.7,368.7,862,424,438
060730136011,496.8,244.2,228.1,542,246,296
060730152001,786.1,388.8,356.3,832,376,456
060730137011,822.9,418.2,354.0,907,431,476
060730153022,773.5,365.4,366.9,826,355,471
060730136053,876.5,446.6,393.6,864,400,464
060730136061,302.7,153.7,135.3,322,176,146
060730136062,809.2,371.3,400.8,723,351,372
060730136064,537.3,266.7,250.3,629,301,328
060730154032,739.3,315.7,378.3,710,306,404
060730154031,734.0,291.6,405.0,750,339,411
060730136063,1071.0,484.0,539.0,1123,519,604
060730207063,1223.7,456.8,697.6,1164,426,738
060730207061,1694.3,688.8,899.4,1664,614,1050
060730207062,652.3,257.0,349.7,766,268,498
060730207093,666.3,269.2,355.2,762,270,492
060730207051,560.3,262.8,253.8,466,206,260
060730202093,223.5,140.5,67.3,152,82,70
060730202092,529.4,332.8,159.4,544,288,256
060730202102,724.4,416.8,259.5,628,337,291
060730207092,923.1,381.3,486.1,647,248,399
060730207094,744.8,298.5,402.2,529,207,322
060730201031,1733.6,736.3,890.6,1468,612,856
060730202101,866.8,434.4,381.4,541,283,258
060730201032,1107.8,471.9,563.5,1246,497,749
060730191063,1319.3,458.1,792.2,1000,381,619
060730191064,550.7,163.8,352.7,522,155,367
060730191033,991.4,304.3,622.1,1122,377,745
060730201033,1603.7,585.2,930.7,1387,533,854
060730201051,653.6,266.9,336.7,591,257,334
060730201034,525.7,179.4,320.8,482,161,321
060730207101,1079.3,478.4,536.5,1017,364,653
060730203061,3032.8,1565.6,1270.5,2641,1313,1328
060730204012,881.3,402.7,436.4,994,457,537
060730203074,764.7,341.0,368.7,533,237,296
060730200272,304.3,156.8,129.2,319,145,174
060730200262,976.4,477.3,434.0,1177,552,625
060730200291,805.6,447.4,306.8,532,273,259
060730200293,271.3,203.1,47.4,125,95,30
060730200282,246.8,184.7,43.2,153,100,53
060730200281,214.0,160.2,37.4,61,47,14
060730200292,343.9,173.0,148.0,141,80,61
060730200212,304.6,206.2,79.1,188,141,47
060730200211,848.5,521.9,271.9,760,435,325
060730203062,810.3,375.2,390.0,632,298,334
060730200223,1281.0,682.5,511.6,783,443,340
060730200231,876.3,450.8,366.4,760,355,405
060730200221,1287.1,547.9,654.9,1387,580,807
060730200222,634.5,278.4,311.2,758,292,466
060730203072,674.4,281.4,339.4,530,237,293
060730203091,849.2,349.5,437.4,741,318,423
060730203041,1025.7,430.7,526.9,1937,750,1187
060730200251,659.5,340.9,275.4,595,277,318
060730200252,539.0,282.0,218.1,421,208,213
060730200232,992.1,434.0,499.2,877,417,460
060730203044,918.9,394.5,469.0,704,275,429
060730200253,741.1,357.9,336.7,735,345,390
060730200243,480.8,216.4,222.9,442,206,236
060730200242,371.5,167.3,166.8,413,195,218
060730200241,1051.0,489.0,502.0,1206,514,692
060730203043,794.6,316.1,425.0,626,220,406
060730203051,1508.1,618.5,803.1,1240,481,759
060730203053,619.6,259.4,319.3,494,199,295
060730170302,649.6,336.6,277.2,667,324,343
060730201052,917.9,416.9,435.3,1161,554,607
060730204043,829.5,328.1,453.1,1027,349,678
060730204031,746.5,359.0,342.1,792,370,422
060730204042,817.0,383.6,363.1,349,153,196
060730204032,787.5,344.6,386.4,898,361,537
060730203052,658.4,320.5,286.0,266,133,133
060730201071,957.5,410.7,483.2,936,347,589
060730201061,920.3,381.3,485.5,848,326,522
060730204051,1147.5,420.4,678.9,779,276,503
060730204052,1208.3,460.2,693.9,1170,443,727
060730204011,634.9,241.5,366.3,696,258,438
060730207081,972.1,415.1,478.2,1041,426,615
060730170154,805.3,418.6,347.1,731,387,344
060730170303,663.6,342.1,290.5,685,324,361
060730170151,439.4,178.8,232.7,453,169,284
060730170192,1000.9,468.7,500.6,1196,502,694
060730170193,1962.8,891.1,999.5,1690,738,952
060730133102,6796.1,4534.9,1955.8,5859,3479,2380
060730100151,1126.9,865.6,202.4,622,463,159
060730100141,4.6,3.2,1.3,6,6,0
060730133131,5360.0,3532.0,1568.0,2444,1463,981
060730133111,1600.8,1060.5,447.7,843,493,350
060730133114,1057.8,643.3,355.9,866,480,386
060730134122,962.9,613.4,308.1,1012,596,416
060730134092,1205.8,710.9,426.5,891,515,376
060730032072,1208.7,704.4,450.1,982,515,467
060730032071,764.1,448.0,278.3,798,417,381
060730032042,661.1,452.7,164.5,626,387,239
060730032121,478.5,318.3,144.1,471,287,184
060730032092,730.3,527.0,172.4,466,321,145
060730032085,821.5,546.3,237.9,729,454,275
060730134121,1338.6,747.8,522.7,1159,603,556
060730134202,901.8,598.7,254.2,778,459,319
060730134093,855.2,535.3,281.8,813,448,365
060730134212,1131.0,731.4,350.7,1055,569,486
060730134111,1148.1,636.3,456.6,1230,657,573
060730134113,581.5,316.3,234.8,448,195,253
060730134112,565.9,296.3,239.5,673,326,347
060730032084,358.0,254.9,80.5,361,230,131
060730032083,472.8,336.7,106.3,375,240,135
060730032093,471.0,341.0,104.9,378,271,107
060730032091,786.8,518.1,230.9,569,307,262
060730031154,623.6,371.9,224.4,658,320,338
060730031142,834.8,532.1,270.9,666,400,266
060730031153,454.7,298.4,138.9,475,279,196
060730031152,360.0,233.6,112.0,398,235,163
060730031141,548.0,372.2,156.9,469,244,225
060730032132,567.1,326.9,208.8,794,376,418
060730032131,647.7,367.4,243.5,759,412,347
060730215001,2037.9,1242.9,689.1,1742,949,793
060730102001,673.8,399.3,221.2,535,310,225
060730102004,430.1,233.6,162.5,350,200,150
060730102003,418.2,207.1,178.2,354,198,156
060730102005,283.9,140.8,120.7,250,132,118
060730102006,419.6,221.6,166.3,447,255,192
060730105011,622.5,318.7,252.3,624,348,276
060730106012,665.0,282.7,355.5,624,224,400
060730102002,438.4,191.6,216.8,452,225,227
060730103001,380.3,178.3,178.5,397,191,206
060730103004,349.2,191.6,131.6,332,182,150
060730103003,466.9,256.2,176.0,358,228,130
060730105024,366.1,226.1,116.1,372,242,130
060730105023,430.9,277.1,126.9,323,221,102
060730101031,612.6,445.3,136.3,376,245,131
060730106011,577.0,245.3,308.5,578,175,403
060730104021,543.3,365.8,142.1,504,319,185
060730104023,519.0,341.2,137.0,391,258,133
060730028042,617.9,432.4,131.3,954,673,281
060730028041,796.3,531.2,198.4,824,563,261
060730028043,696.8,487.4,156.3,483,340,143
060730027121,561.9,418.7,115.3,549,389,160
060730027111,352.3,235.8,95.4,272,181,91
060730027034,684.6,454.3,187.1,693,425,268
060730029031,562.7,393.0,136.3,632,448,184
060730027032,414.8,303.3,86.2,442,293,149
060730027031,515.0,369.0,112.1,673,490,183
060730029033,489.7,302.3,144.6,482,320,162
060730029032,511.3,336.5,138.2,521,341,180
060730030031,887.2,657.2,173.7,868,666,202
060730144002,595.3,405.1,151.6,385,285,100
060730145002,589.7,370.2,185.7,483,306,177
060730143001,914.7,577.9,275.6,884,561,323
060730029022,1284.2,856.0,333.1,1100,780,320
060730029021,1441.0,995.4,338.0,1360,901,459
060730029042,927.0,647.2,202.0,1184,853,331
060730029044,299.2,200.4,71.9,327,214,113
060730029043,457.7,306.5,110.0,388,286,102
060730147003,1177.0,697.7,409.3,1165,665,500
060730029051,383.9,262.7,94.4,444,314,130
060730100094,211.6,185.9,18.8,10,6,4
060730100131,833.1,740.9,57.0,467,394,73
060730100091,791.4,695.1,70.2,361,288,73
060730100132,780.3,679.1,71.5,479,399,80
060730100041,924.0,689.0,188.0,797,571,226
060730100051,749.6,610.2,107.0,734,532,202
060730100052,378.6,307.7,54.6,412,325,87
060730100142,4822.4,3438.8,1176.7,3229,2046,1183
060730100032,611.8,422.1,158.7,545,339,206
060730100031,653.8,457.3,172.2,598,380,218
060730100034,635.1,436.2,161.0,531,332,199
060730133081,921.8,727.8,150.8,538,391,147
060730100011,625.8,430.3,165.9,458,282,176
060730100012,972.7,651.6,273.3,881,503,378
060730133072,878.1,645.7,180.3,855,541,314
060730133082,457.4,335.7,96.4,373,295,78
060730133061,800.5,563.9,191.1,739,444,295
060730133062,1001.2,682.5,266.8,831,550,281
060730133121,1097.0,763.0,267.0,961,592,369
060730096023,466.7,267.4,171.8,554,293,261
060730096021,621.9,356.6,232.5,733,360,373
060730097031,662.2,341.4,286.7,682,323,359
060730096024,485.4,275.2,177.9,365,195,170
060730095111,145.2,66.4,61.7,197,113,84
060730095112,160.8,73.6,68.3,240,121,119
060730095102,254.2,104.7,119.8,394,192,202
060730095101,86.8,35.8,40.9,142,73,69
060730095103,113.0,46.5,53.2,167,73,94
060730095092,935.9,485.7,382.6,1005,501,504
060730095022,920.0,514.0,342.0,821,482,339
060730095062,999.0,613.0,316.0,986,623,363
060730095053,1593.0,931.7,556.6,1163,607,556
060730095061,1134.2,604.8,445.5,1407,778,629
060730095072,252.7,142.2,92.0,256,143,113
060730095071,868.4,475.0,329.4,1172,645,527
060730095051,841.2,500.0,285.4,836,470,366
060730028012,483.0,332.0,105.0,707,530,177
060730097053,666.7,405.4,208.0,593,346,247
060730029041,1179.7,818.6,272.6,1089,757,332
060730097052,529.0,270.3,230.5,957,487,470
060730097032,469.2,256.9,192.3,493,257,236
060730097033,986.5,560.8,381.2,895,494,401
060730097051,603.3,307.6,262.9,549,268,281
060730097067,567.5,291.4,249.4,580,264,316
060730029053,685.3,476.8,159.4,806,579,227
060730097062,828.2,487.5,294.5,601,286,315
060730097044,459.1,254.8,181.4,509,285,224
060730097045,747.8,413.1,296.7,803,431,372
060730097066,631.2,343.3,263.4,565,269,296
060730097041,850.3,495.3,302.5,781,465,316
060730095073,466.0,267.0,171.0,457,249,208
060730097043,1046.8,604.9,375.3,937,502,435
060730097042,296.6,164.0,108.3,433,262,171
060730098054,882.6,479.6,347.7,962,540,422
060730098053,632.9,352.6,244.5,722,348,374
060730095021,1051.0,566.0,410.0,1118,552,566
060730095054,968.3,574.1,329.3,797,445,352
060730095052,623.4,369.4,213.2,883,500,383
060730094001,169.3,71.7,72.7,171,74,97
060730083503,294.0,175.4,102.4,405,188,217
060730083504,637.2,380.1,221.9,565,318,247
060730083502,337.8,201.5,117.7,455,230,225
060730083483,593.1,368.4,193.2,697,383,314
060730083481,913.5,549.9,314.2,931,497,434
060730083471,1370.0,822.7,461.1,1150,651,499
060730083462,537.4,319.3,189.3,817,418,399
060730083514,526.7,309.3,188.0,511,257,254
060730083513,410.7,240.4,147.3,341,186,155
060730083512,281.7,167.2,99.0,337,184,153
060730083511,323.9,192.2,113.8,314,170,144
060730083492,722.5,409.7,270.7,757,406,351
060730083491,601.3,337.4,227.4,549,294,255
060730083482,549.4,323.7,195.6,427,244,183
060730083474,262.7,154.0,95.0,312,153,159
060730083473,637.8,380.9,224.0,522,265,257
060730083472,737.5,420.9,273.6,715,387,328
060730083652,1037.0,582.5,393.3,727,364,363
060730083661,3037.7,1740.5,1147.0,3023,1593,1430
060730083603,1012.8,625.4,326.3,824,456,368
060730083581,728.0,427.0,262.0,717,346,371
060730083583,719.6,434.7,242.4,758,411,347
060730083584,704.1,421.7,237.5,715,375,340
060730083602,608.8,386.1,189.0,594,325,269
060730022022,494.7,397.7,65.8,330,212,118
060730022021,315.0,253.1,42.4,219,148,71
060730022023,315.5,253.2,42.9,212,151,61
060730021003,290.6,224.1,47.0,261,196,65
060730023013,208.8,160.1,34.1,186,130,56
060730021002,376.0,289.3,61.1,329,237,92
060730020022,635.2,474.6,115.6,814,596,218
060730023012,331.5,254.1,54.1,232,167,65
060730020013,615.4,467.1,114.1,587,419,168
060730020012,947.4,681.0,229.6,1080,745,335
060730020011,817.1,597.7,186.4,761,513,248
060730023023,310.0,248.6,44.6,183,129,54
060730023022,262.4,210.5,37.8,234,146,88
060730027074,200.8,161.1,28.9,118,89,29
060730027073,137.6,110.4,19.8,84,64,20
060730027091,454.9,359.7,57.8,255,207,48
060730023021,434.6,338.1,70.6,486,313,173
060730027092,390.2,308.3,49.2,383,288,95
060730027102,448.0,356.7,66.7,414,286,128
060730027101,310.4,247.1,46.2,289,203,86
060730027084,317.3,254.1,46.2,173,126,47
060730027082,88.1,70.2,13.1,68,47,21
060730027071,234.5,181.8,38.7,138,96,42
060730027072,209.9,162.7,34.6,135,94,41
060730023011,403.7,297.3,76.7,310,233,77
060730020021,790.1,586.8,157.1,614,413,201
060730027083,332.3,268.5,46.8,150,118,32
060730027081,262.9,212.4,37.0,318,252,66
060730028031,708.5,522.4,149.7,474,324,150
060730028032,547.0,407.9,112.2,568,382,186
060730028034,757.0,536.0,176.3,751,522,229
060730028033,372.5,263.8,86.8,429,283,146
060730031111,350.5,310.8,26.4,234,210,24
060730031112,392.5,348.2,29.6,491,434,57
060730030012,728.1,621.1,72.4,503,462,41
060730030013,587.4,500.5,59.3,637,583,54
060730031122,1135.7,854.8,227.4,901,686,215
060730031113,827.0,657.0,137.5,761,504,257
060730030041,680.8,561.7,78.2,542,449,93
060730030042,675.1,540.6,97.2,502,419,83
060730030011,374.6,320.0,38.0,459,411,48
060730027122,456.0,354.2,82.0,524,382,142
060730031121,468.3,349.4,94.0,489,365,124
060730031032,861.0,711.0,111.0,920,796,124
060730030033,519.9,370.5,115.1,457,340,117
060730030032,744.4,535.3,158.0,724,532,192
060730027112,459.6,301.7,128.5,428,282,146
060730027052,760.2,519.0,202.2,795,500,295
060730027033,687.0,524.9,127.0,339,238,101
060730027023,850.5,631.0,161.6,608,457,151
060730027021,423.0,317.4,73.7,492,370,122
060730027022,507.1,367.7,112.3,533,381,152
060730092014,321.5,201.3,94.9,175,111,64
060730092011,364.2,228.1,107.5,331,193,138
060730085111,1589.0,986.0,503.0,1161,670,491
060730092022,1397.2,811.0,500.9,1514,844,670
060730093051,1163.5,753.8,333.6,1154,715,439
060730093012,644.4,359.3,239.9,702,390,312
060730093011,384.6,214.5,143.2,425,222,203
060730093013,491.5,313.9,136.1,458,290,168
060730093014,378.4,243.3,102.8,368,244,124
060730019001,611.9,482.1,89.2,636,487,149
060730019003,528.4,416.1,78.0,486,373,113
060730093041,926.4,626.5,223.4,1014,676,338
060730011001,678.5,561.4,82.8,578,489,89
060730096031,564.4,386.1,147.9,538,384,154
060730018002,589.0,475.7,73.2,458,379,79
060730019002,801.2,628.9,127.6,842,657,185
060730018001,342.7,278.7,42.3,304,254,50
060730093053,294.7,168.2,107.5,352,190,162
060730093052,650.0,346.0,261.0,492,243,249
060730093062,384.5,216.8,141.8,324,185,139
060730095091,911.0,583.0,257.0,763,514,249
060730093061,974.8,571.7,345.1,935,541,394
060730093064,534.7,324.5,182.1,922,548,374
060730093063,712.0,434.0,218.0,510,319,191
060730083601,458.4,305.0,124.9,580,383,197
060730096033,492.6,336.9,129.1,467,330,137
060730096034,610.7,377.2,197.0,535,315,220
060730096032,498.3,303.8,161.0,509,320,189
060730028011,712.0,480.0,200.0,883,557,326
060730096042,375.3,220.4,121.3,496,271,225
060730096044,400.2,235.0,129.3,394,220,174
060730096043,520.1,295.6,191.1,469,232,237
060730096041,393.7,221.6,150.7,389,217,172
060730096022,523.1,302.7,188.5,462,262,200
060730083101,593.9,357.8,214.7,764,413,351
060730083032,1152.1,670.0,429.3,1029,597,432
060730083103,1435.1,787.5,586.6,1625,819,806
060730083102,1095.4,597.2,452.2,1204,596,608
060730085012,726.1,370.5,296.7,1100,615,485
060730085013,590.8,340.3,207.2,635,360,275
060730078001,552.4,361.9,143.2,507,363,144
060730078003,535.3,341.2,140.8,505,365,140
060730078004,260.5,171.6,66.3,309,195,114
060730078005,269.7,167.7,82.8,250,138,112
060730083011,859.5,493.5,320.1,894,478,416
060730078002,456.4,275.1,153.4,424,236,188
060730085031,975.5,558.7,350.8,1033,588,445
060730085034,738.9,422.5,267.5,783,437,346
060730085033,1038.9,591.5,371.9,1166,671,495
060730085011,1211.8,705.9,428.0,732,425,307
060730085014,473.4,269.3,169.2,438,262,176
060730091063,453.5,254.6,169.9,471,277,194
060730091061,538.2,302.3,201.5,531,320,211
060730091062,837.8,553.0,218.0,491,319,172
060730091041,939.6,519.6,354.5,704,390,314
060730091042,776.4,441.4,279.5,1004,559,445
060730091014,1055.9,567.1,413.5,1031,579,452
060730091034,582.8,335.6,204.3,578,347,231
060730091033,751.2,442.5,268.3,795,449,346
060730091032,525.9,306.1,189.8,444,270,174
060730091013,831.4,485.3,292.6,483,286,197
060730091071,961.5,660.6,231.9,1036,701,335
060730091072,465.9,313.4,114.7,750,488,262
060730091031,437.1,258.8,156.6,421,234,187
060730091022,739.5,472.6,204.6,671,455,216
060730091021,459.6,293.7,127.3,585,378,207
060730091012,852.9,495.7,303.2,1066,649,417
060730085131,1014.9,558.0,398.6,944,511,433
060730085132,658.1,365.0,255.4,642,316,326
060730091011,559.7,313.7,216.0,557,292,265
060730085043,426.2,263.1,137.8,676,388,288
060730085032,662.7,370.4,244.8,490,282,208
060730085025,553.7,334.7,183.8,600,380,220
060730085024,792.8,470.0,268.3,737,431,306
060730085045,1175.1,632.0,466.5,1218,635,583
060730085042,446.2,270.6,155.8,343,207,136
060730085041,508.7,303.9,179.3,315,195,120
060730085122,1186.0,604.1,512.0,773,389,384
060730085123,1044.4,568.6,422.5,1275,662,613
060730085121,286.6,166.2,107.5,465,263,202
060730153021,1239.1,556.4,620.1,1206,534,672
060730153012,406.3,208.8,170.9,406,195,211
060730153011,285.1,144.9,125.0,491,231,260
060730154041,671.8,274.8,355.4,748,349,399
060730163012,656.8,347.2,263.2,647,397,250
060730158011,405.2,209.8,169.5,431,291,140
060730159022,322.0,165.6,140.4,307,179,128
060730154042,318.5,161.3,141.5,248,134,114
060730157033,415.0,216.0,164.0,347,247,100
060730158022,518.8,266.9,219.7,542,294,248
060730158021,171.2,88.1,72.5,187,115,72
060730161001,1238.6,561.4,603.6,1280,583,697
060730162011,799.4,332.2,418.1,920,361,559
060730161002,926.7,434.6,448.3,918,400,518
060730162012,1014.0,439.3,524.5,1147,476,671
060730166162,1238.6,439.8,732.3,1073,420,653
060730163011,695.6,327.7,325.9,658,323,335
060730165032,481.1,166.8,282.6,507,196,311
060730165042,660.3,335.9,278.0,584,330,254
060730165044,166.0,83.8,69.5,86,41,45
060730165041,610.5,314.5,250.4,724,365,359
060730165043,201.5,103.9,85.3,219,107,112
060730165031,625.5,233.6,351.6,536,250,286
060730154044,815.4,290.6,478.9,774,327,447
060730157032,408.6,216.4,166.9,453,269,184
060730157031,346.8,183.7,141.7,350,209,141
060730157013,304.3,183.2,103.3,307,195,112
060730081015,481.7,316.2,133.6,498,339,159
060730083111,1111.2,641.0,423.9,1132,589,543
060730083031,670.7,425.3,213.6,879,501,378
060730080033,503.9,341.4,121.7,574,410,164
060730080031,639.8,432.6,155.4,722,513,209
060730080065,503.0,339.7,126.0,513,357,156
060730080032,699.6,448.7,197.2,770,517,253
060730080063,390.1,273.8,84.7,377,284,93
060730080062,388.9,262.1,99.8,424,279,145
060730080064,400.8,273.6,98.2,386,279,107
060730080021,472.1,269.5,170.6,519,315,204
060730080022,540.1,308.6,200.6,650,362,288
060730083112,705.1,393.9,276.8,725,376,349
060730081013,475.5,298.3,154.4,484,319,165
060730082002,744.3,458.5,240.1,900,480,420
060730081014,591.3,375.8,182.2,525,360,165
060730082001,487.3,300.3,157.8,541,312,229
060730081012,443.3,313.8,108.5,488,347,141
060730081011,336.8,235.0,84.6,416,293,123
060730082003,430.7,271.6,134.8,545,305,240
060730083124,605.5,380.3,187.8,663,326,337
060730083033,404.4,245.5,141.8,419,220,199
060730083123,434.4,278.2,126.0,522,320,202
060730083122,669.7,400.9,219.1,626,367,259
060730083132,621.3,404.0,183.9,753,445,308
060730077011,525.4,315.8,174.2,725,460,265
060730077013,757.2,488.3,205.2,702,511,191
060730077021,448.5,243.2,170.2,457,271,186
060730077022,529.7,324.8,157.5,677,443,234
060730077012,480.8,281.6,160.1,589,324,265
060730076003,375.8,216.3,125.2,538,349,189
060730076001,155.0,87.0,49.0,431,247,184
060730077024,366.6,229.3,103.2,296,227,69
060730079071,831.0,555.8,204.9,855,634,221
060730079034,491.7,326.3,117.3,543,376,167
060730079033,474.1,292.9,143.1,490,324,166
060730079072,669.3,445.1,161.8,728,540,188
060730079032,704.2,459.7,174.3,806,586,220
060730079082,888.1,576.0,225.5,1126,834,292
060730077023,578.8,374.1,153.5,547,377,170
060730079081,300.3,194.3,75.3,313,231,82
060730080023,337.7,208.2,105.1,433,278,155
060730079031,461.8,291.0,123.0,549,416,133
060730083012,644.4,367.1,246.3,741,361,380
060730083013,512.3,320.0,169.1,516,273,243
060730148031,715.0,386.3,279.8,859,455,404
060730149021,1339.0,769.5,478.6,1165,653,512
060730150003,521.7,272.1,220.3,578,296,282
060730150002,952.0,521.3,377.4,559,314,245
060730148041,553.8,307.6,216.3,573,287,286
060730098021,685.4,341.8,303.7,706,337,369
060730098013,788.2,413.1,332.5,773,417,356
060730098012,933.8,497.4,391.7,967,469,498
060730098011,564.0,279.2,251.0,585,282,303
060730098025,319.5,165.6,136.2,313,170,143
060730098052,411.4,217.2,163.1,445,225,220
060730098014,585.2,332.2,221.3,508,278,230
060730098051,763.0,418.8,296.9,731,407,324
060730098042,471.8,258.8,188.0,490,254,236
060730098041,990.8,521.9,415.0,1007,508,499
060730098043,465.6,254.1,185.5,492,256,236
060730166053,790.2,296.1,438.8,665,288,377
060730166052,934.4,389.1,480.2,960,386,574
060730166061,924.2,348.2,514.3,754,305,449
060730149013,831.2,470.1,301.8,844,458,386
060730149012,791.8,466.2,266.1,794,490,304
060730149022,395.0,224.8,143.4,323,191,132
060730151004,515.4,268.6,207.3,510,266,244
060730151003,423.8,225.7,167.1,438,212,226
060730152003,555.3,277.8,250.9,548,255,293
060730152004,552.7,275.6,253.3,490,218,272
060730150001,849.6,451.4,338.4,839,465,374
060730150004,448.9,240.4,178.1,498,281,217
060730098024,928.1,476.6,407.2,957,484,473
060730098023,520.4,302.0,180.2,519,274,245
060730098022,514.5,311.4,160.6,488,299,189
060730151001,525.2,276.3,206.1,621,297,324
060730161003,722.1,342.1,322.6,693,325,368
060730152002,555.8,278.4,247.1,667,346,321
060730151002,851.0,456.4,326.2,886,438,448
060730160002,875.0,379.0,445.0,849,348,501
060730098044,838.5,437.9,361.5,869,424,445
060730075011,445.0,316.2,95.2,455,344,111
060730075012,322.0,228.8,68.8,388,301,87
060730074002,488.2,307.4,127.3,493,354,139
060730074001,371.9,234.2,97.0,403,296,107
060730074004,669.0,412.7,202.6,679,413,266
060730076002,273.6,170.2,79.3,331,215,116
060730068011,1160.0,757.0,301.0,1164,760,404
060730069002,634.7,372.2,216.9,580,333,247
060730069001,1471.9,864.1,490.2,1438,836,602
060730069003,1047.6,611.9,366.3,1041,528,513
060730068023,602.6,376.7,165.9,684,472,212
060730068022,725.1,443.4,217.4,663,435,228
060730066001,136.4,80.1,45.0,219,122,97
060730068021,183.1,107.5,60.4,593,380,213
060730065003,390.3,257.2,107.4,257,186,71
060730065001,534.4,316.1,189.9,523,332,191
060730065002,483.3,298.2,156.8,426,295,131
060730089021,601.8,384.3,165.1,508,308,200
060730001002,1090.8,728.3,295.6,1224,721,503
060730001001,815.2,598.0,174.6,830,570,260
060730061002,298.9,201.2,73.8,297,202,95
060730089022,527.2,331.7,150.9,578,380,198
060730076006,317.1,178.7,109.3,388,249,139
060730076007,222.5,125.8,76.3,288,192,96
060730079101,751.6,473.2,214.2,814,565,249
060730079102,616.6,397.9,163.4,671,480,191
060730079052,608.2,382.1,164.9,774,551,223
060730079051,607.6,376.4,166.4,617,436,181
060730081023,874.6,558.4,261.0,803,503,300
060730080061,476.2,300.9,147.9,473,275,198
060730081021,535.9,306.8,200.7,574,288,286
060730081022,701.0,453.1,208.1,664,417,247
060730083561,609.8,375.6,199.0,668,379,289
060730083573,685.1,431.2,217.4,608,354,254
060730083562,624.1,362.2,218.6,696,365,331
060730083522,447.2,248.2,167.0,430,227,203
060730083523,334.8,185.8,125.0,261,139,122
060730083572,371.9,210.8,141.6,323,148,175
060730083571,460.6,262.6,173.1,517,276,241
060730083552,854.3,507.4,295.0,783,408,375
060730083551,369.8,217.8,128.8,374,195,179
060730083521,506.7,266.9,206.7,437,203,234
060730083533,542.3,288.1,223.3,388,213,175
060730083582,347.2,211.0,115.9,390,217,173
060730083592,491.2,311.1,141.0,501,307,194
060730083591,501.8,317.9,144.0,513,305,208
060730083532,1053.7,613.8,380.3,1237,662,575
060730083542,1078.9,672.4,343.6,874,510,364
060730083541,1635.6,1077.8,473.7,1233,728,505
060730083531,528.1,288.5,204.0,518,262,256
060730083651,855.3,496.0,319.7,803,405,398
060730083373,767.6,417.0,303.3,840,428,412
060730083352,348.7,193.1,131.8,478,255,223
060730083371,980.8,538.5,379.3,1006,542,464
060730083372,445.6,237.5,182.5,519,255,264
060730170373,813.0,459.5,308.0,847,439,408
060730170374,568.1,324.6,212.5,562,308,254
060730170361,486.1,299.3,158.5,434,265,169
060730170362,338.9,208.7,110.5,427,222,205
060730170363,709.5,389.5,279.6,744,399,345
060730170372,311.9,173.0,120.7,480,254,226
060730146021,943.2,548.9,320.9,921,547,374
060730146011,925.6,548.2,305.3,796,479,317
060730146022,266.4,160.3,86.9,525,303,222
060730140022,926.5,555.5,314.4,898,514,384
060730139082,742.7,487.1,217.2,653,412,241
060730139061,1500.0,889.0,512.9,1255,738,517
060730139062,248.1,156.6,77.6,217,143,74
060730139072,594.3,440.7,119.3,615,406,209
060730139071,303.9,204.2,82.5,211,148,63
060730139031,539.6,289.1,221.6,582,349,233
060730139032,1024.3,547.0,420.1,1010,435,575
060730139081,405.6,251.4,131.9,345,228,117
060730139092,1036.7,650.0,322.3,811,502,309
060730139053,368.7,216.9,128.0,336,198,138
060730139052,388.7,238.7,128.5,390,247,143
060730139051,732.8,417.1,266.7,707,429,278
060730139091,611.4,396.8,176.3,551,339,212
060730138013,643.8,379.3,219.0,526,305,221
060730138022,378.0,240.4,116.0,280,182,98
060730138021,506.9,322.4,155.6,470,315,155
060730138011,831.5,436.2,347.1,923,500,423
060730138012,466.8,238.7,195.6,508,261,247
060730149011,437.0,250.4,157.6,463,243,220
060730137023,420.6,231.3,160.0,455,242,213
060730137022,494.0,271.6,187.8,287,205,82
060730137021,827.0,432.0,359.0,833,435,398
060730136014,265.2,163.6,82.0,260,157,103
060730137012,440.7,221.2,191.6,461,220,241
060730134184,562.9,306.8,229.7,487,244,243
060730134183,613.1,334.2,250.3,600,329,271
060730134182,1144.7,821.9,271.6,902,596,306
060730134181,498.3,353.1,115.4,425,287,138
060730134171,1115.2,669.1,392.6,1088,630,458
060730133112,1023.6,658.7,324.4,1054,635,419
060730133113,451.8,294.6,138.9,455,241,214
060730142002,429.5,257.2,145.0,411,229,182
060730142004,443.4,245.8,173.7,478,265,213
060730142001,819.0,484.9,283.3,830,480,350
060730141011,731.5,430.0,254.8,734,419,315
060730141012,653.3,415.2,195.8,756,458,298
060730141022,447.7,318.0,106.1,304,230,74
060730140014,510.2,296.3,178.3,460,251,209
060730140012,351.3,204.0,125.8,355,209,146
060730031073,377.3,248.3,108.4,366,249,117
060730031072,709.7,517.4,149.9,630,477,153
060730031071,973.0,622.3,297.0,979,631,348
060730031051,994.4,751.3,185.6,814,581,233
060730031052,545.7,391.2,126.2,500,342,158
060730031081,803.1,458.2,289.2,648,357,291
060730031082,462.7,278.5,157.2,397,245,152
060730140021,743.9,443.5,250.0,666,372,294
060730146023,745.3,435.0,259.4,803,439,364
060730145001,499.3,315.9,154.9,549,341,208
060730143002,432.9,276.4,127.6,384,211,173
060730145003,412.2,264.9,125.0,411,249,162
060730147004,721.8,395.6,282.2,793,473,320
060730147002,673.0,407.1,223.5,800,476,324
060730147001,1131.9,658.2,395.5,1027,612,415
060730146012,863.8,532.1,270.5,734,467,267
060730146013,317.4,178.6,116.7,227,131,96
060730144001,617.0,425.6,151.1,677,467,210
060730140011,368.1,220.7,120.4,320,189,131
060730140013,712.0,426.0,246.0,633,346,287
060730134012,1070.2,631.0,378.5,1034,534,500
060730134011,1047.5,636.8,357.8,1026,519,507
060730216002,153.8,65.9,77.0,461,177,284
060730109001,428.0,197.8,202.0,493,216,277
060730109002,564.2,260.7,266.3,575,274,301
060730110002,724.0,343.0,337.0,700,332,368
060730111001,998.2,474.7,451.0,1002,426,576
060730110001,673.5,336.7,297.8,658,304,354
060730219001,501.7,381.7,92.9,194,157,37
060730219002,54.1,41.2,10.0,213,152,61
060730124011,480.1,290.2,159.5,326,198,128
060730038001,362.5,289.2,49.9,70,47,23
060730051002,1931.7,1327.6,462.1,1092,773,319
060730049002,377.3,322.3,34.8,284,247,37
060730049003,648.1,540.3,64.7,385,324,61
060730050001,528.7,425.0,68.0,336,273,63
060730049001,303.2,260.6,27.4,196,175,21
060730039023,163.9,140.4,13.9,177,151,26
060730039021,195.1,169.1,14.8,161,137,24
060730039024,197.4,171.4,14.7,151,135,16
060730039022,55.1,43.9,7.6,187,165,22
060730036011,669.9,574.1,57.8,410,357,53
060730036031,381.9,314.2,46.1,258,223,35
060730036032,363.4,288.5,48.0,222,189,33
060730035023,433.8,382.3,32.9,301,256,45
060730035022,493.8,431.9,40.9,377,333,44
060730035021,203.0,178.9,15.4,156,138,18
060730054001,417.1,264.6,130.9,517,308,209
060730054004,1502.5,964.2,443.1,1350,870,480
060730054003,605.1,391.9,174.6,538,324,214
060730054002,1140.1,741.2,332.5,1041,639,402
060730053002,636.4,433.2,161.6,489,357,132
060730053004,662.7,410.0,223.5,698,446,252
060730053003,910.3,584.3,282.7,255,170,85
060730053001,320.3,217.4,83.1,397,287,110
060730061001,878.0,584.5,224.1,898,631,267
060730056001,1201.0,809.0,313.0,975,693,282
060730057002,441.2,320.4,85.7,353,265,88
060730057001,186.8,135.6,36.3,340,255,85
060730059003,404.0,297.6,81.7,357,278,79
060730059002,426.1,312.4,87.0,457,344,113
060730060003,1123.8,800.3,261.0,1204,865,339
060730060002,631.6,471.8,127.7,572,430,142
060730060001,681.2,547.7,97.4,541,415,126
060730051001,594.4,429.4,120.1,440,325,115
060730052001,1273.3,886.3,268.2,941,712,229
060730052002,1121.7,770.7,248.8,475,355,120
060730056002,1053.0,768.4,201.1,855,621,234
060730059001,735.9,554.1,133.3,645,484,161
060730055001,18.0,10.6,4.9,10,5,5
060730002021,803.6,574.1,182.2,735,515,220
060730002023,1399.6,1069.3,257.5,1335,1027,308
060730002011,1253.8,949.8,235.3,1159,865,294
060730002022,476.2,351.2,93.7,479,358,121
060730003004,721.6,585.8,92.1,618,491,127
060730003003,1037.4,865.3,126.7,925,762,163
060730003005,609.3,490.5,81.2,603,495,108
060730003001,319.9,255.3,44.6,369,310,59
060730003002,425.2,342.4,55.3,414,366,48
060730004003,603.2,501.1,67.1,537,447,90
060730004002,533.4,441.9,56.4,504,437,67
060730004001,925.4,767.0,98.5,956,816,140
060730007003,575.2,467.7,73.6,589,480,109
060730007002,1029.0,869.4,101.3,989,851,138
060730007001,855.8,721.0,86.1,828,712,116
060730006003,861.0,712.0,105.0,858,735,123
060730006002,627.0,514.5,73.9,624,523,101
060730006001,493.0,404.5,58.1,501,428,73
060730005002,804.9,644.5,104.1,790,647,143
060730005003,540.1,432.5,69.9,518,425,93
060730005001,553.6,437.9,78.5,601,468,133
060730046002,209.0,164.5,26.6,206,172,34
060730047002,316.0,246.8,41.5,223,185,38
060730047001,222.9,174.0,29.2,237,189,48
060730048003,284.7,243.8,24.2,136,117,19
060730048002,396.3,328.6,43.1,236,203,33
060730011002,675.7,544.9,84.7,567,468,99
060730011003,438.2,355.7,54.6,436,358,78
060730015003,540.5,432.1,70.3,485,399,86
060730015002,552.7,441.8,71.9,459,384,75
060730015001,562.7,455.5,67.4,472,410,62
060730015004,522.1,422.6,62.5,467,402,65
060730016004,519.0,415.0,61.0,419,340,79
060730016003,314.9,261.3,34.4,247,197,50
060730042002,1104.9,867.3,174.6,1063,786,277
060730042001,1296.3,980.7,234.6,1193,902,291
060730024012,488.1,377.8,76.1,333,265,68
060730024013,561.9,434.9,87.6,396,314,82
060730024011,191.3,154.5,23.3,146,118,28
060730013001,509.5,414.1,57.0,388,330,58
060730013002,806.3,662.7,85.9,803,680,123
060730012002,503.6,415.9,50.5,442,373,69
060730012001,564.4,466.1,56.5,441,365,76
060730016002,464.9,384.1,50.6,403,335,68
060730018004,327.8,256.7,39.9,323,270,53
060730018003,254.0,199.7,30.5,255,211,44
060730018005,432.8,335.7,59.3,365,298,67
060730018006,401.3,311.3,55.0,347,288,59
060730017002,594.3,481.2,67.4,519,427,92
060730017001,661.4,536.7,74.2,512,411,101
060730017003,583.9,475.9,64.2,507,423,84
060730017004,284.9,229.9,32.8,215,181,34
060730016001,481.8,385.4,51.1,388,327,61
060730022012,366.4,293.1,38.9,231,194,37
060730125021,363.0,274.4,66.0,243,180,63
060730125023,375.3,283.6,68.3,277,205,72
060730124023,672.8,503.0,130.0,530,349,181
060730116012,426.3,357.6,51.7,256,189,67
060730116013,677.7,568.4,82.3,485,374,111
060730124012,652.0,464.0,137.0,539,355,184
060730124022,511.2,347.9,131.7,489,327,162
060730124021,474.8,323.1,122.3,411,259,152
060730123021,617.8,416.9,160.6,576,384,192
060730127002,654.8,470.5,144.7,529,355,174
060730123032,581.9,360.2,186.5,659,376,283
060730123031,920.2,563.7,304.0,835,487,348
060730116022,274.6,217.6,40.3,195,150,45
060730116021,515.4,408.4,75.7,373,276,97
060730116011,379.5,284.7,66.2,228,134,94
060730117001,654.6,458.7,167.8,496,304,192
060730117002,481.7,349.7,104.6,308,215,93
060730122001,297.6,216.4,63.4,234,154,80
060730122002,772.2,564.1,165.2,538,376,162
060730121011,630.0,426.4,171.3,603,367,236
060730121021,444.4,318.7,105.8,382,256,126
060730117004,289.3,219.3,57.1,197,135,62
060730117003,474.5,365.2,87.2,436,296,140
060730118011,529.3,418.8,88.5,397,290,107
060730118012,250.9,199.9,40.5,182,140,42
060730118013,275.3,219.3,44.5,211,144,67
060730118022,473.8,370.0,80.8,390,274,116
060730118023,510.2,404.3,81.7,398,287,111
060730036033,294.8,231.1,40.0,202,164,38
060730036022,377.9,324.9,37.1,280,227,53
060730036021,374.5,322.0,36.7,281,231,50
060730033012,485.5,416.0,42.5,404,359,45
060730033011,474.6,408.5,40.1,336,306,30
060730085063,793.0,467.2,271.6,718,413,305
060730085061,641.0,367.6,232.9,479,283,196
060730083062,781.6,493.1,250.0,675,399,276
060730083063,862.2,540.1,282.4,951,523,428
060730083131,609.5,407.3,173.7,673,438,235
060730083622,322.1,217.6,83.2,351,245,106
060730083623,672.6,478.5,157.8,702,507,195
060730083621,600.7,419.1,143.9,654,455,199
060730083642,645.1,456.7,136.4,860,636,224
060730083641,760.3,508.0,209.6,655,395,260
060730083643,527.6,373.2,112.0,560,415,145
060730083061,336.2,209.8,111.6,425,255,170
060730085023,647.7,384.8,218.9,487,267,220
060730085021,759.9,456.0,257.0,909,536,373
060730083071,541.6,335.4,172.4,565,306,259
060730083072,1242.0,774.5,395.7,1313,767,546
060730083633,344.4,276.5,43.8,394,329,65
060730083632,621.2,498.8,79.0,867,683,184
060730083631,166.4,133.6,21.2,262,223,39
060730083432,388.7,298.8,59.2,569,444,125
060730083431,635.7,491.4,93.9,1004,790,214
060730083433,465.7,351.7,77.8,161,126,35
060730083051,758.0,663.0,44.0,3116,2616,500
060730083611,812.2,580.7,179.8,972,686,286
060730083612,299.4,214.1,66.3,269,192,77
060730083411,882.0,679.0,153.0,970,690,280
060730083052,744.0,596.0,69.0,1194,1043,151
060730083412,1429.5,1017.0,331.6,1630,1146,484
060730083073,506.3,311.1,169.9,551,313,238
060730085022,431.7,253.8,152.1,384,231,153
060730133021,960.8,618.0,280.2,927,576,351
060730133033,542.1,375.9,131.6,552,368,184
060730133094,732.6,460.7,232.5,753,428,325
060730133093,507.2,303.3,173.8,432,232,200
060730133095,732.5,459.5,243.1,621,353,268
060730133091,576.6,355.9,184.0,539,275,264
060730133011,1218.0,736.6,406.2,1094,604,490
060730133012,1053.0,668.4,319.8,852,493,359
060730134091,529.3,292.6,204.3,600,310,290
060730133101,3485.6,2243.6,1078.9,3186,1882,1304
060730133092,561.0,385.6,150.6,453,273,180
060730134142,878.4,567.0,265.2,742,433,309
060730134144,1103.6,658.0,388.8,1023,586,437
060730134141,1042.6,662.0,329.4,917,550,367
060730134143,343.4,194.0,127.6,323,165,158
060730134151,826.0,534.0,249.0,779,442,337
060730033032,490.7,421.1,39.6,476,423,53
060730118021,438.2,342.5,71.1,263,204,59
060730033031,273.7,234.9,22.1,97,80,17
060730119023,373.0,274.8,77.2,344,218,126
060730033052,721.6,645.0,59.2,553,514,39
060730033051,277.4,248.0,22.8,188,174,14
060730220001,426.4,305.2,100.0,288,181,107
060730120032,679.9,494.7,148.2,602,377,225
060730220002,577.8,413.4,130.6,466,284,182
060730120021,264.9,189.7,64.1,197,107,90
060730120022,561.3,401.9,135.9,557,296,261
060730033053,746.9,647.4,71.4,697,632,65
060730119024,498.4,372.7,98.2,410,297,113
060730119022,644.8,448.8,157.7,592,379,213
060730123042,1407.0,887.0,427.0,1194,634,560
060730123041,303.4,190.4,92.8,244,144,100
060730128001,376.7,246.9,105.2,409,216,193
060730128003,775.9,504.9,226.4,516,314,202
060730032041,776.9,425.9,304.3,844,401,443
060730121022,508.5,373.2,111.7,432,303,129
060730032022,990.9,722.1,224.4,1025,650,375
060730032122,1088.0,700.7,335.7,951,542,409
060730120031,480.8,307.0,144.1,394,235,159
060730032021,656.8,456.3,165.3,525,341,184
060730032012,501.2,323.9,146.5,607,361,246
060730119021,614.4,377.5,198.7,401,245,156
060730031132,794.9,547.9,214.7,728,441,287
060730031012,485.4,423.0,46.3,593,553,40
060730031013,429.3,355.3,57.3,550,479,71
060730031011,402.4,360.9,29.5,353,326,27
060730031131,968.1,682.6,246.3,912,604,308
060730032111,892.0,543.7,294.8,737,436,301
060730032011,230.5,140.8,74.1,383,201,182
060730032013,395.1,241.3,127.1,219,135,84
060730032082,235.0,163.2,63.0,295,169,126
060730032081,389.3,270.3,104.4,241,156,85
060730032112,288.4,200.2,77.4,313,193,120
060730031093,391.2,213.8,163.8,402,183,219
060730031091,360.1,196.8,150.8,358,204,154
060730031092,375.7,205.3,157.3,348,171,177
060730034032,461.9,389.6,49.5,337,300,37
060730034031,290.9,245.3,31.2,216,184,32
060730034033,282.3,238.1,30.3,182,156,26
060730033041,232.3,181.6,36.4,205,168,37
060730034042,683.0,583.0,60.0,519,454,65
060730034012,192.8,140.0,38.4,170,128,42
060730025021,1098.0,796.0,244.0,1130,808,322
060730025022,744.0,577.9,108.2,563,437,126
060730025023,349.0,271.1,50.8,355,277,78
060730025011,610.7,470.8,100.2,490,392,98
060730033042,418.7,327.4,65.6,289,245,44
060730034041,447.0,379.0,44.0,365,330,35
060730034013,384.8,312.4,54.8,236,199,37
060730034014,944.2,785.6,125.2,989,805,184
060730034011,670.2,502.0,126.6,493,356,137
060730027123,554.1,452.2,67.7,469,385,84
060730027051,813.3,601.2,170.9,812,548,264
060730025013,478.6,386.8,68.6,247,191,56
060730025012,373.7,304.4,52.2,355,271,84
060730022011,390.5,316.8,45.9,291,222,69
060730024022,489.0,393.0,58.0,309,229,80
060730026021,261.1,199.1,43.6,171,127,44
060730026023,327.4,249.7,54.6,258,197,61
060730026022,262.6,200.2,43.8,208,162,46
060730024021,470.0,377.0,62.0,415,305,110
060730026012,509.0,411.0,71.5,255,176,79
060730026011,387.0,312.5,54.4,270,204,66
060730026013,314.0,253.5,44.1,310,227,83
060730021004,520.9,424.8,61.5,428,366,62
060730021005,591.1,482.3,69.8,475,404,71
060730021001,566.8,438.3,91.3,593,467,126
060730031151,502.0,332.8,150.9,379,235,144
060730032073,924.9,495.4,388.5,924,488,436
060730032141,744.2,506.4,202.7,740,416,324
060730032143,489.4,359.5,109.2,485,317,168
060730032142,488.9,329.4,141.4,401,303,98
060730134213,571.4,386.3,154.6,334,210,124
060730134201,375.0,269.1,78.3,246,166,80
060730134211,421.9,279.4,122.8,357,207,150
060730134114,555.5,317.1,210.5,609,311,298
060730134161,942.4,498.7,399.4,883,457,426
060730134102,690.9,369.1,293.6,659,301,358
060730134103,535.3,273.0,235.7,607,270,337
060730134162,844.0,466.0,337.0,870,430,440
060730031033,427.9,350.1,57.1,528,456,72
060730031031,895.2,736.9,123.9,838,732,106
060730141021,1115.0,842.0,230.0,1073,828,245
060730142003,850.0,535.0,267.0,727,451,276
060730103002,576.4,346.1,199.9,522,269,253
060730104022,433.3,224.1,187.0,303,155,148
060730101091,659.4,453.1,171.7,632,388,244
060730101105,363.8,234.0,107.7,394,231,163
060730101104,378.6,212.9,139.7,232,160,72
060730101041,384.2,216.0,141.7,477,216,261
060730101103,584.0,409.8,147.4,444,271,173
060730101102,717.4,502.0,183.0,487,277,210
060730101092,1054.1,799.1,212.2,781,527,254
060730101122,578.4,472.0,74.9,393,294,99
060730101121,843.2,642.1,160.7,455,325,130
060730101061,842.6,676.9,125.7,655,450,205
060730101062,541.6,460.2,58.3,372,291,81
060730101063,486.5,402.4,60.4,382,299,83
060730101112,628.8,527.5,78.0,360,279,81
060730101111,451.2,378.5,56.0,361,282,79
060730100092,728.7,588.8,107.5,502,370,132
060730100093,308.3,249.2,45.5,182,146,36
060730100123,273.8,235.8,28.2,151,123,28
060730100121,293.5,248.8,27.8,291,227,64
060730100122,721.6,613.7,69.6,449,362,87
060730100054,491.1,420.9,43.6,209,176,33
060730100042,1056.7,804.2,200.0,885,585,300
060730100053,1048.5,886.5,106.2,521,416,105
060730105021,389.3,259.3,106.8,330,211,119
060730104011,717.4,470.8,196.8,573,388,185
060730105022,287.4,188.6,78.8,158,102,56
060730101033,691.4,498.9,156.2,493,332,161
060730101042,867.0,490.0,316.0,836,420,416
060730101032,501.6,361.4,112.7,399,260,139
060730101101,623.7,448.5,140.0,421,275,146
060730101071,973.9,752.8,166.8,700,480,220
060730101072,363.9,263.6,81.4,349,203,146
060730132051,734.2,568.8,121.5,423,289,134
060730131031,350.4,272.1,57.0,226,158,68
060730131032,466.7,358.8,83.6,392,274,118
060730126001,337.3,254.6,61.6,307,196,111
060730125012,596.5,450.6,108.8,466,330,136
060730125011,482.9,352.2,105.6,528,358,170
060730125022,426.0,310.7,93.1,232,170,62
060730126004,389.2,296.9,71.2,324,238,86
060730126003,479.8,366.1,87.8,331,227,104
060730131041,549.3,422.2,98.4,371,273,98
060730126002,396.1,274.3,98.9,320,220,100
060730130003,620.8,442.9,146.2,512,325,187
060730130004,384.9,262.2,103.0,366,214,152
060730130002,485.5,330.7,127.4,423,253,170
060730130001,653.0,431.6,196.0,500,293,207
060730127001,979.5,724.3,208.0,824,594,230
060730101073,559.5,427.8,106.6,494,344,150
060730101074,406.7,282.4,105.2,418,241,177
060730100102,787.6,587.1,165.5,679,458,221
060730132063,574.8,425.5,122.2,667,397,270
060730132061,824.4,607.6,178.7,576,411,165
060730132062,474.8,343.4,107.3,418,275,143
060730132043,614.5,480.4,103.2,494,366,128
060730132041,436.3,344.1,71.2,300,213,87
060730100101,609.8,442.9,137.1,461,304,157
060730100103,590.2,435.8,123.7,540,309,231
060730100112,844.8,601.0,198.1,693,423,270
060730100111,602.5,431.1,137.2,511,320,191
060730100033,552.3,384.3,131.1,461,308,153
060730132042,428.0,326.6,77.6,287,202,85
060730133071,568.5,420.5,111.5,416,300,116
060730131042,304.0,219.1,67.8,326,216,110
060730131043,502.7,364.9,116.1,429,306,123
060730131044,404.1,289.9,88.2,218,146,72
060730132032,319.8,251.1,54.1,128,104,24
060730132031,404.5,311.8,72.2,311,202,109
060730132034,443.1,348.3,73.8,223,152,71
060730131022,925.1,666.1,207.6,776,543,233
060730131023,500.6,375.6,95.9,353,269,84
060730129003,638.5,380.6,213.7,577,323,254
060730129002,389.9,225.6,139.3,388,207,181
060730129001,695.7,408.0,241.4,550,317,233
060730128002,474.1,301.2,147.5,502,272,230
060730133031,841.7,651.5,152.8,791,547,244
060730132033,797.6,629.0,126.2,322,248,74
060730131021,565.6,375.6,161.4,480,284,196
060730133032,496.9,345.2,119.4,440,295,145
060730133022,1109.1,736.4,299.8,1064,677,387
060730046001,694.1,549.7,86.7,604,506,98
060730041002,740.8,582.0,97.8,523,423,100
060730045013,247.1,191.6,33.8,240,193,47
060730039013,311.0,264.8,28.1,236,196,40
060730039012,285.1,243.0,25.8,145,129,16
060730040003,265.5,224.3,25.2,170,148,22
060730040004,225.3,190.7,20.4,170,153,17
060730040002,183.0,154.1,18.5,110,99,11
060730045011,625.5,492.4,70.8,483,397,86
060730045012,248.5,195.6,28.1,258,217,41
060730048001,236.9,194.5,27.4,150,135,15
060730041004,750.1,599.9,96.8,598,498,100
060730041003,560.1,437.3,70.7,437,363,74
060730041001,335.9,261.3,42.1,284,239,45
060730044004,417.9,331.0,65.6,439,341,98
060730044001,509.8,395.8,77.4,565,467,98
060730044003,490.1,396.4,60.1,489,406,83
060730044002,762.6,622.6,94.0,642,546,96
060730043003,629.4,504.9,87.8,647,521,126
060730043002,1134.0,917.4,141.3,1142,938,204
060730039011,251.2,216.5,22.6,160,134,26
060730040001,330.9,277.7,36.4,190,169,21
060730035012,209.4,177.6,21.2,148,127,21
060730035011,412.6,349.9,41.8,363,325,38
060730035013,227.0,192.5,23.0,115,99,16
060730042004,524.8,404.4,87.9,496,397,99
060730042003,411.7,323.5,60.8,491,398,93
060730008003,636.6,525.0,67.9,717,605,112
060730008002,285.3,239.3,26.5,363,304,59
060730008004,1149.2,947.6,123.0,984,815,169
060730009005,337.5,269.6,48.7,317,257,60
060730009004,508.9,405.4,75.4,506,409,97
060730008001,430.0,351.1,49.6,318,253,65
060730009002,497.2,406.9,54.1,374,334,40
060730009003,430.4,352.2,46.8,364,317,47
060730043001,385.4,312.2,43.8,365,281,84
060730014003,1148.6,928.5,152.6,1017,827,190
060730014002,412.9,332.1,57.7,432,350,82
060730014001,412.5,330.4,59.7,362,286,76
060730013003,585.9,488.9,57.4,512,426,86
060730013005,574.4,479.1,56.7,506,434,72
060730009001,608.0,485.4,81.1,535,450,85
060730009006,389.0,310.6,51.9,367,320,47
060730010003,628.8,527.0,60.3,628,533,95
060730010004,569.2,475.2,54.9,480,406,74
060730010002,624.0,522.8,59.8,695,595,100
060730013004,594.0,497.2,56.0,568,487,81
060730012003,732.0,588.0,90.7,590,490,100
060730012004,932.0,749.0,116.3,779,649,130
060730170422,682.7,382.6,250.7,709,421,288
060730170421,1321.4,735.8,507.6,1405,702,703
060730170393,1056.9,587.8,403.5,1329,667,662
060730170472,796.2,401.1,342.8,668,326,342
060730095042,636.0,315.0,286.0,674,285,389
060730170471,982.8,551.4,385.5,923,479,444
060730170403,609.6,290.2,281.0,535,228,307
060730170481,573.8,273.5,254.1,388,195,193
060730170351,410.3,232.6,150.5,513,257,256
060730170181,770.0,424.4,293.8,630,340,290
060730170352,45.8,24.7,19.0,258,141,117
060730170353,607.9,357.0,209.3,205,130,75
060730170341,780.4,428.9,304.3,985,525,460
060730170343,694.2,339.5,316.2,681,335,346
060730170562,703.3,387.3,273.8,599,324,275
060730170342,811.9,435.0,324.5,527,255,272
060730162013,1210.7,496.6,654.0,1322,532,790
060730166161,679.6,262.8,372.2,507,231,276
060730166051,1090.3,471.1,560.3,1082,503,579
060730166062,961.5,338.8,544.6,864,344,520
060730166054,886.0,377.0,474.0,931,394,537
060730166132,656.5,243.7,374.6,537,230,307
060730166121,1167.8,458.4,640.5,1381,559,822
060730166122,610.0,190.0,379.0,458,155,303
060730166123,1221.5,429.9,700.5,1332,498,834
060730166131,394.8,154.2,218.7,370,141,229
060730166142,1035.5,414.9,541.4,1003,384,619
060730166141,773.5,310.1,404.6,780,346,434
060730159023,337.4,152.9,172.5,334,136,198
060730159021,329.2,149.1,168.3,258,121,137
060730159024,481.5,256.4,200.5,435,248,187
060730160001,216.6,126.4,70.6,202,129,73
060730159012,225.8,146.4,68.0,211,146,65
060730158023,190.3,123.4,57.3,296,165,131
060730159011,300.9,195.2,90.7,202,133,69
060730162022,590.1,350.2,194.5,623,391,232
060730158012,319.4,193.4,105.9,234,143,91
060730183004,219.1,112.7,89.1,267,128,139
060730182001,591.6,326.8,224.1,586,359,227
060730182005,470.3,244.0,188.3,464,299,165
060730183002,297.6,159.3,116.0,221,132,89
060730182003,280.4,167.9,89.3,131,85,46
060730183001,253.9,135.6,99.2,233,115,118
060730184001,483.9,246.9,199.7,368,218,150
060730183003,209.5,106.9,86.5,290,133,157
060730184002,400.1,211.8,157.1,251,153,98
060730186011,607.0,269.0,287.0,499,270,229
060730186033,621.2,406.3,165.8,465,318,147
060730186031,590.5,386.5,156.9,553,367,186
060730181005,336.3,186.9,127.2,272,156,116
060730181003,571.5,313.3,220.4,451,269,182
060730181001,751.5,398.2,302.7,698,389,309
060730181002,473.6,259.9,182.4,394,241,153
060730181006,510.8,248.0,230.7,489,279,210
060730182004,261.6,159.3,80.8,113,60,53
060730179001,830.1,468.1,295.7,774,434,340
060730185041,587.0,280.7,274.4,602,308,294
060730185044,883.0,425.3,418.1,1176,543,633
060730185042,844.3,440.9,356.8,848,437,411
060730184003,301.4,184.5,92.0,297,174,123
060730182002,291.5,178.3,88.9,173,102,71
060730186034,306.8,203.2,76.2,176,134,42
060730185091,426.3,237.9,162.2,190,112,78
060730185093,295.0,161.9,113.6,253,148,105
060730185092,465.4,247.9,183.1,331,189,142
060730185111,325.5,171.4,129.0,350,186,164
060730185094,166.8,87.8,66.1,180,106,74
060730185101,441.9,214.6,187.5,576,281,295
060730185112,261.0,132.4,109.6,336,173,163
060730185113,233.9,130.1,87.6,348,189,159
060730178011,970.0,492.9,413.5,835,471,364
060730178012,493.6,245.8,213.7,517,268,249
060730178013,1177.4,588.3,520.8,1254,594,660
060730178014,821.0,467.0,291.0,706,407,299
060730185043,940.5,501.5,366.9,703,411,292
060730198041,926.0,397.0,466.0,934,418,516
060730198033,385.4,193.9,160.1,454,230,224
060730198031,706.8,385.1,257.3,818,443,375
060730185151,473.3,198.0,246.8,435,181,254
060730185172,1029.1,505.2,455.9,1079,605,474
060730185171,655.2,336.2,273.9,493,276,217
060730185114,737.1,429.3,258.2,430,273,157
060730195031,501.3,313.6,160.0,344,200,144
060730195033,433.9,262.1,145.5,396,215,181
060730197022,351.0,170.3,153.9,370,206,164
060730195012,348.6,234.9,89.3,147,94,53
060730194032,499.3,297.8,163.7,378,215,163
060730194031,1305.7,675.3,533.7,1269,658,611
060730194041,346.1,215.1,106.5,329,186,143
060730194033,265.9,128.5,118.6,240,145,95
060730194042,355.3,257.6,74.1,301,191,110
060730195011,333.9,242.1,69.6,131,83,48
060730185141,1257.3,657.9,522.2,1126,576,550
060730185072,896.9,484.6,343.7,722,393,329
060730185071,666.6,370.2,243.5,528,301,227
060730186104,576.7,377.2,161.3,360,233,127
060730186103,321.2,210.1,89.8,234,129,105
060730186102,462.1,279.5,158.7,261,152,109
060730186122,621.5,326.7,249.1,456,260,196
060730185143,969.4,426.0,495.5,1040,452,588
060730185142,1332.6,581.0,674.9,1295,577,718
060730186113,932.7,531.6,335.2,506,289,217
060730193013,1074.4,470.4,526.6,1411,621,790
060730193012,1419.5,650.6,683.2,1341,604,737
060730193011,813.0,360.8,407.0,619,275,344
060730193032,947.1,486.8,398.0,683,366,317
060730199043,1087.5,485.0,528.1,1091,475,616
060730199041,1264.9,584.5,603.2,1075,430,645
060730199051,918.3,465.3,401.9,956,450,506
060730199052,964.3,475.5,418.4,885,472,413
060730197024,896.9,364.2,470.2,902,406,496
060730199042,524.5,249.3,233.9,422,221,201
060730197023,398.4,195.4,171.7,582,281,301
060730196021,617.3,280.5,303.5,591,285,306
060730196023,513.3,248.3,225.9,167,106,61
060730199022,396.0,194.3,175.2,383,184,199
060730198091,893.5,409.7,427.8,911,415,496
060730199031,991.3,427.5,510.8,967,437,530
060730195032,410.8,202.7,185.0,141,66,75
060730195021,255.7,205.4,33.3,155,93,62
060730195023,261.6,161.6,76.7,155,100,55
060730195022,250.7,168.0,62.0,129,66,63
060730196013,954.4,480.7,409.2,599,310,289
060730196012,467.7,242.8,188.8,470,215,255
060730196011,739.1,319.3,370.7,768,367,401
060730192061,420.7,257.8,133.5,167,113,54
060730192063,276.8,156.6,102.0,240,137,103
060730192062,466.1,258.0,179.4,443,229,214
060730192051,257.5,136.7,100.3,284,147,137
060730196014,607.1,271.9,290.8,472,233,239
060730199032,887.5,419.8,413.3,730,301,429
060730200201,1970.2,978.0,867.8,1945,954,991
060730200202,1040.2,566.8,411.2,825,418,407
060730199053,255.0,119.8,118.2,308,145,163
060730200191,878.8,413.2,427.2,1255,531,724
060730200192,1195.3,595.5,557.7,708,386,322
060730200184,961.9,549.3,356.8,808,415,393
060730200171,454.8,224.3,201.9,469,234,235
060730200172,338.1,171.8,142.2,325,177,148
060730200173,255.2,117.5,126.1,76,44,32
060730200263,1219.3,510.5,644.5,826,300,526
060730200183,383.3,209.4,147.5,164,83,81
060730200182,346.0,243.7,85.1,359,210,149
060730200181,256.0,180.3,62.9,240,145,95
060730200213,480.9,252.9,196.1,373,194,179
060730198042,561.3,270.0,249.2,598,256,342
060730198032,860.7,407.5,384.7,746,362,384
060730198053,364.7,189.1,152.2,297,162,135
060730202071,350.0,243.0,81.0,330,182,148
060730202072,403.0,289.0,85.0,350,223,127
060730202091,672.8,345.8,297.9,724,344,380
060730201092,493.5,265.2,185.6,369,186,183
060730202061,429.6,219.0,182.3,259,139,120
060730201091,390.7,204.5,161.1,309,127,182
060730202081,764.0,365.0,345.0,629,281,348
060730203042,440.2,191.7,220.7,4,3,1
060730198052,342.7,199.9,116.0,338,190,148
060730198051,843.8,465.4,317.2,658,347,311
060730185182,524.6,312.7,178.6,409,224,185
060730185181,429.2,254.5,146.7,370,215,155
060730185192,571.3,367.3,162.7,382,247,135
060730185191,567.1,344.6,185.2,566,309,257
060730198093,706.1,336.7,331.8,659,297,362
060730194053,317.6,205.6,86.8,306,191,115
060730194052,349.2,179.4,141.8,174,97,77
060730185162,309.7,161.4,122.2,337,185,152
060730185193,480.1,291.6,156.7,318,208,110
060730193022,1017.3,478.0,473.7,1067,547,520
060730193021,608.0,315.5,260.9,431,214,217
060730193024,707.9,332.8,332.2,969,479,490
060730198092,879.0,371.0,448.0,852,379,473
060730197011,1083.3,532.2,475.7,1036,527,509
060730197013,439.6,214.3,195.5,685,328,357
060730198082,902.4,450.4,397.6,654,325,329
060730197012,741.8,362.4,329.0,271,157,114
060730197021,452.1,180.7,237.9,419,169,250
060730194063,556.8,294.2,217.6,532,275,257
060730194051,373.4,191.8,151.7,345,172,173
060730194061,561.0,283.6,237.8,437,227,210
060730194062,738.2,409.2,267.3,545,308,237
060730193023,1013.8,499.1,452.7,638,332,306
060730206011,424.1,238.8,153.6,388,233,155
060730207082,755.0,343.6,359.4,482,195,287
060730207053,1133.2,435.5,630.3,1045,403,642
060730207071,892.7,448.0,380.8,673,373,300
060730207072,515.8,269.6,209.8,467,203,264
060730204041,550.5,275.0,240.3,617,292,325
060730203073,572.0,296.0,240.0,567,257,310
060730205001,377.9,200.0,154.6,351,164,187
060730205002,429.1,270.8,129.2,259,171,88
060730205003,527.3,313.9,173.1,392,208,184
060730202142,274.7,195.2,60.5,151,95,56
060730202141,373.1,236.8,109.8,259,157,102
060730206013,412.7,275.5,105.2,215,137,78
060730206012,322.8,194.9,102.6,229,148,81
060730203092,328.3,190.8,114.8,347,162,185
060730203083,1157.4,576.7,509.1,1103,554,549
060730203082,279.0,157.3,101.3,358,197,161
060730203081,561.7,307.5,210.3,257,130,127
060730202111,389.5,211.0,151.2,328,165,163
060730201081,365.8,210.1,128.7,196,134,62
060730201082,361.0,206.0,128.0,168,99,69
060730201062,549.5,263.6,253.4,503,246,257
060730202143,107.1,72.6,25.2,77,49,28
060730202131,187.0,126.8,44.1,100,63,37
060730202021,295.9,200.6,69.7,244,162,82
060730201083,319.6,193.2,103.9,175,114,61
060730201084,231.1,139.7,75.1,259,134,125
060730201072,517.7,224.5,265.1,518,236,282
060730206024,699.4,332.9,322.0,735,310,425
060730206023,432.5,238.7,160.3,467,254,213
060730206022,533.5,294.3,197.7,373,214,159
060730202023,240.8,161.4,62.3,179,113,66
060730206021,208.2,133.5,59.6,161,102,59
060730202132,174.8,112.1,50.1,126,68,58
060730202113,424.8,255.9,136.3,500,282,218
060730207052,471.5,194.8,243.8,409,158,251
060730202133,147.3,106.1,31.0,57,42,15
060730202022,288.9,208.2,60.9,316,205,111
060730201094,526.3,302.3,190.2,453,207,246
060730201093,288.5,170.6,100.0,191,92,99
060730202112,502.0,327.1,144.2,425,241,184
060730202114,274.8,164.9,88.2,202,138,64
060730202062,333.7,227.7,89.3,331,205,126
060730202063,344.3,220.4,104.2,149,98,51
060250106004,1239.5,559.7,609.5,896,373,523
060250105001,724.4,517.6,163.6,736,471,265
060250105003,367.7,149.1,195.7,387,149,238
060250106003,528.2,136.8,364.9,511,115,396
060250105004,366.6,219.8,127.4,415,205,210
060250104005,483.0,342.9,111.1,238,177,61
060250106001,328.1,216.8,93.3,347,192,155
060250104003,148.1,102.8,37.4,124,93,31
060250106002,285.0,185.0,83.2,263,158,105
060250105002,237.6,161.7,64.0,191,133,58
060250107003,333.3,266.2,52.3,269,194,75
060250107001,357.9,263.7,77.5,368,319,49
060250104002,237.0,190.2,37.0,255,215,40
060250107002,311.2,249.2,48.3,363,314,49
060250104001,298.7,241.2,44.1,281,249,32
060250104004,471.1,382.3,67.4,180,139,41
060250109006,159.7,109.9,42.8,104,68,36
060250109004,256.1,176.3,68.7,325,155,170
060250120011,743.4,659.7,54.8,515,436,79
060250120021,1450.8,1260.7,133.7,1174,971,203
060250120012,295.9,261.5,22.1,237,205,32
060250121004,693.6,622.3,48.5,502,448,54
060250119003,503.3,421.9,54.1,264,225,39
060250113003,513.9,431.0,53.7,427,358,69
060250113004,261.1,219.0,27.3,318,263,55
060250113002,362.3,260.2,84.8,262,164,98
060250120022,1090.2,894.0,155.9,976,748,228
060250112011,1348.1,767.9,521.8,1211,654,557
060250118024,390.3,231.7,135.8,357,189,168
060250118011,660.7,402.3,220.7,785,476,309
060250118023,639.1,384.7,218.7,613,312,301
060250116001,563.5,349.6,184.7,462,251,211
060250118021,510.9,324.6,155.0,333,168,165
060250112022,493.3,418.3,56.9,387,301,86
060250112023,243.7,206.7,28.1,203,163,40
060250112012,785.9,521.8,224.0,456,314,142
060250110003,313.0,176.3,119.3,329,192,137
060250117002,386.0,226.5,137.0,463,218,245
060250118022,296.8,174.1,105.3,245,126,119
060250117001,717.2,541.1,142.9,544,422,122
060250117003,501.6,354.2,119.3,553,334,219
060250112021,508.4,388.7,92.2,345,238,107
060250115001,72.3,55.3,13.1,218,173,45
060250115002,247.3,189.1,44.9,226,155,71
060250116002,621.3,471.4,119.3,294,215,79
060250116003,184.1,136.4,39.2,202,116,86
060250114002,187.2,142.9,34.8,86,71,15
060250116004,394.7,300.1,74.9,473,304,169
060250114003,746.8,630.4,79.9,562,493,69
060250114001,209.7,169.3,30.7,232,197,35
060250115004,778.8,603.8,139.2,401,288,113
060250115003,268.0,222.0,35.3,257,177,80
060250110002,223.9,126.1,85.4,171,87,84
060710042021,463.8,397.7,44.2,490,434,56
060710042013,451.8,392.3,42.1,420,388,32
060710042014,453.6,401.5,36.4,462,422,40
060710041032,304.1,258.6,26.9,247,202,45
060710041033,267.6,219.8,31.1,213,168,45
060710042023,302.4,262.6,28.4,313,280,33
060710047005,199.3,172.2,18.2,200,169,31
060710047003,209.6,182.1,19.7,138,117,21
060710047001,228.8,188.1,23.9,187,160,27
060710041041,426.0,325.5,73.9,409,303,106
060710027061,1606.8,911.7,620.0,500,290,210
060710041042,444.8,344.7,73.8,338,263,75
060710041012,414.3,310.6,75.3,278,197,81
060710041011,694.7,525.4,129.7,629,462,167
060710046013,496.2,299.4,159.9,323,219,104
060710045043,1392.5,821.7,488.1,1208,722,486
060710046012,376.5,229.3,119.3,347,228,119
060710046011,552.4,329.9,181.1,618,378,240
060710046015,328.8,205.9,101.3,444,273,171
060710046042,360.3,248.3,88.7,324,225,99
060710046043,375.6,230.4,125.3,436,268,168
060710046034,753.8,441.0,267.8,653,363,290
060710046044,550.1,363.4,152.9,421,266,155
060710046032,323.8,180.0,122.7,267,145,122
060710046014,303.7,192.2,89.6,352,219,133
060710046033,631.4,384.3,203.0,669,440,229
060710045102,465.2,310.2,114.6,257,181,76
060710045103,280.7,187.2,69.2,546,391,155
060710045072,401.5,258.5,115.6,366,242,124
060710045092,418.3,248.6,146.2,423,246,177
060710045041,888.1,474.5,362.8,604,374,230
060710045042,790.4,382.8,360.2,859,440,419
060710045101,493.1,317.3,138.8,658,410,248
060710092021,737.9,297.0,396.9,618,291,327
060710045031,1049.3,533.7,447.7,940,509,431
060710045032,570.4,169.6,380.3,558,191,367
060710108021,531.2,207.1,300.9,617,246,371
060710100173,1144.5,300.2,799.7,1091,326,765
060710108025,483.6,173.3,273.9,466,212,254
060710108024,418.7,147.9,246.2,343,134,209
060710108023,335.0,117.9,190.4,329,146,183
060650316024,483.2,273.7,175.7,537,266,271
060650316021,85.7,48.5,31.2,70,42,28
060650316022,482.9,273.5,175.5,401,255,146
060650412032,476.8,341.2,105.8,254,176,78
060650315014,290.3,168.2,103.4,295,169,126
060650315022,394.4,226.8,137.7,393,228,165
060650315021,685.6,394.2,239.3,540,346,194
060650406153,1227.1,715.2,457.2,871,498,373
060650406132,1879.1,1073.2,720.6,1077,665,412
060650406151,1269.4,743.8,465.2,774,461,313
060650406162,1305.7,752.8,499.2,793,501,292
060650406152,461.0,294.0,145.0,258,187,71
060650406072,1000.9,564.8,362.9,794,506,288
060650406043,880.0,402.5,429.0,713,298,415
060650406041,723.4,312.4,375.2,594,264,330
060650407031,533.2,136.4,371.7,434,135,299
060650407021,547.3,154.4,361.4,511,190,321
060650407022,598.2,161.3,405.8,519,178,341
060650410043,275.9,118.1,138.2,298,122,176
060650406031,544.8,311.4,202.7,493,264,229
060650406042,740.3,367.3,325.8,611,284,327
060650405021,1132.7,682.2,395.0,538,342,196
060650405033,475.9,296.4,159.9,463,312,151
060650405032,161.1,79.9,70.9,66,45,21
060650406051,324.0,204.2,102.2,263,155,108
060650406062,276.1,174.0,87.1,239,137,102
060650406061,343.6,216.5,108.4,339,217,122
060650406052,306.4,193.1,96.6,209,132,77
060650404033,531.3,302.3,202.3,440,252,188
060710127002,911.4,560.7,301.5,683,434,249
060710127001,764.8,502.8,225.0,691,443,248
060710019061,1804.8,1074.9,649.4,1422,884,538
060650410031,838.4,399.3,373.8,735,378,357
060650410022,492.0,280.9,176.5,389,232,157
060650410041,421.4,251.6,140.8,368,191,177
060650404021,431.6,231.9,173.5,306,159,147
060650404022,588.7,317.8,237.2,795,390,405
060650404032,376.5,212.5,144.5,317,167,150
060650404031,507.3,288.7,193.1,405,235,170
060650405013,592.3,358.3,199.9,534,285,249
060650405011,538.1,312.1,191.9,511,294,217
060650405012,598.7,336.4,222.2,533,292,241
060650404051,920.3,421.1,458.7,640,280,360
060650405022,445.8,292.7,131.8,262,173,89
060650410011,587.3,421.9,128.9,786,544,242
060650410042,471.0,338.4,103.3,0,0,0
060650410021,330.3,237.2,72.5,249,158,91
060650309001,407.8,242.1,134.6,365,224,141
060650309002,550.5,326.8,181.7,489,288,201
060650310023,349.3,215.5,109.7,218,159,59
060650310022,421.4,255.5,135.5,287,175,112
060650404041,990.5,550.0,387.2,783,456,327
060650404052,1227.1,538.0,630.9,1227,614,613
060650403022,818.4,394.0,383.6,904,446,458
060650403023,459.6,217.4,220.5,554,278,276
060650403021,1293.1,685.4,521.7,1075,629,446
060650403014,448.2,262.3,153.8,435,239,196
060650402022,404.9,202.2,181.9,408,219,189
060650403031,1051.3,592.7,404.0,633,390,243
060650405031,724.6,454.2,241.1,683,412,271
060710026024,422.8,312.2,88.7,200,148,52
060710026021,560.8,415.2,116.2,447,318,129
060710026041,447.5,332.7,90.8,324,240,84
060710026044,358.4,267.3,73.7,289,217,72
060710026043,240.8,179.6,49.5,85,58,27
060710026042,384.8,287.0,79.1,248,181,67
060710026023,654.4,489.5,130.2,492,378,114
060710026022,474.4,355.4,92.7,456,346,110
060650401022,573.1,337.6,204.4,549,331,218
060710026061,720.6,546.4,137.8,693,500,193
060710026062,658.5,500.3,124.0,451,333,118
060710022041,163.7,124.4,29.8,90,62,28
060710026011,554.2,391.3,135.4,478,305,173
060710025024,331.8,257.0,55.7,282,218,64
060710025022,413.6,322.4,67.8,334,239,95
060710025013,402.5,324.0,58.2,264,183,81
060710025014,243.2,199.7,32.2,181,134,47
060710025012,395.1,323.7,52.9,387,310,77
060710025021,494.0,397.6,73.1,262,209,53
060710026063,694.5,524.8,136.4,534,381,153
060710026073,464.0,351.5,92.9,443,319,124
060710026074,656.9,497.7,139.7,419,311,108
060710026071,796.8,604.0,166.0,560,419,141
060710026072,449.8,341.3,91.2,394,295,99
060710026012,2286.8,1619.5,562.7,1849,1220,629
060710033011,500.7,376.4,100.2,424,307,117
060710033012,275.6,207.2,55.2,259,191,68
060710033013,338.9,254.8,67.8,160,121,39
060374052022,931.6,737.3,142.9,790,610,180
060374051021,695.0,566.0,88.0,580,452,128
060374052013,403.4,316.4,62.1,289,226,63
060374052012,526.5,403.7,93.8,546,398,148
060374052011,433.9,335.0,75.8,416,310,106
060374052031,973.2,744.9,167.3,919,666,253
060374050011,911.5,742.2,123.9,798,643,155
060374050012,494.7,397.2,71.9,434,341,93
060374051012,575.2,455.0,80.3,581,440,141
060374051011,562.7,453.1,82.1,561,423,138
060374050022,279.2,226.9,38.1,216,182,34
060374050021,583.5,471.0,81.7,498,411,87
060374053011,542.5,394.6,112.8,594,400,194
060374053021,487.2,327.4,127.8,526,345,181
060374053025,228.4,148.1,65.4,283,187,96
060374053012,465.3,310.0,127.5,419,266,153
060374053022,395.5,252.0,114.6,308,200,108
060374054003,476.3,332.5,119.6,400,231,169
060374300022,382.3,254.5,108.3,389,254,135
060374300023,465.9,308.7,133.0,487,297,190
060374300025,1007.2,669.5,282.9,994,631,363
060374300024,470.4,325.4,125.8,400,257,143
060374300021,507.5,354.5,126.6,441,340,101
060374046002,81.6,63.4,14.6,66,51,15
060374046001,560.4,398.6,120.4,558,405,153
060374300031,389.7,237.4,131.4,454,279,175
060374055003,384.8,260.8,101.3,317,229,88
060374055005,509.2,338.1,141.8,545,363,182
060374055004,483.7,321.6,136.1,446,286,160
060374055006,321.5,209.0,95.5,354,212,142
060374054002,478.1,333.0,122.1,455,310,145
060374054001,358.2,256.3,87.9,347,242,105
060374054004,389.5,278.7,95.6,332,217,115
060650408141,962.2,567.9,339.3,723,429,294
060650408152,527.1,318.2,180.8,468,266,202
060650408151,628.8,377.3,220.3,548,304,244
060650414121,876.9,524.3,310.1,657,406,251
060650408142,502.5,297.9,178.5,445,257,188
060650408131,1308.5,389.0,857.6,1250,463,787
060650408161,1008.2,541.5,412.6,763,423,340
060650407032,597.8,173.3,398.4,620,207,413
060650409042,802.3,413.3,333.5,633,359,274
060650409021,561.3,292.7,231.4,660,314,346
060650414094,205.5,96.3,93.6,134,77,57
060650414122,562.0,315.3,219.0,619,350,269
060650414093,1504.3,757.1,668.1,864,488,376
060650414092,1598.1,725.6,799.5,1654,792,862
060650414051,540.0,290.4,221.1,453,236,217
060650414041,692.8,358.4,298.6,547,292,255
060650414091,3047.4,1422.1,1486.8,2331,1118,1213
060650420082,1291.7,447.7,776.0,1269,465,804
060650414052,712.3,375.7,299.1,346,207,139
060650409023,579.0,312.5,243.7,603,295,308
060650409022,719.1,402.9,272.3,611,305,306
060650409011,871.9,488.2,336.7,563,329,234
060650409012,656.9,375.0,238.9,481,288,193
060650409032,469.9,261.6,179.4,307,185,122
060650414061,1077.2,656.1,356.4,906,556,350
060650414042,547.3,301.6,215.0,431,239,192
060650414062,566.0,333.6,197.6,604,348,256
060650414071,585.5,353.0,196.1,440,252,188
060650414073,498.8,302.1,165.6,377,263,114
060650409013,487.2,318.1,137.5,479,294,185
060650414072,415.8,271.4,117.4,263,164,99
060650316013,400.4,261.5,114.3,328,205,123
060650409041,378.4,204.8,152.1,278,159,119
060650409031,418.0,226.1,168.0,354,177,177
060650413012,344.9,224.4,100.4,306,173,133
060650413022,354.5,238.4,93.6,187,131,56
060650413011,395.1,257.8,114.0,315,182,133
060650412021,238.6,161.4,61.9,175,118,57
060650411022,500.1,322.9,148.9,486,280,206
060650411011,218.5,143.7,62.4,91,60,31
060650411021,399.7,258.1,119.0,265,167,98
060650414031,889.7,455.7,384.0,694,355,339
060650414032,460.0,233.5,201.3,326,158,168
060650414081,363.1,228.3,109.2,656,347,309
060650414082,620.7,387.6,183.7,407,277,130
060650317021,463.4,241.1,195.1,485,241,244
060650317031,424.7,195.5,204.2,271,150,121
060650317022,451.4,219.1,205.6,420,160,260
060650412012,484.4,333.0,119.3,286,174,112
060650413021,586.6,403.2,144.5,473,328,145
060650412011,625.2,434.2,148.1,519,335,184
060650412031,376.2,261.7,88.6,263,168,95
060650412023,258.5,190.8,53.4,210,149,61
060650411012,421.9,311.5,87.1,158,112,46
060650412022,411.3,303.6,84.9,398,265,133
060650411013,263.2,194.3,54.3,115,89,26
060650316023,225.6,147.4,64.4,205,120,85
060650316012,215.1,140.5,61.4,138,79,59
060650316011,346.5,209.9,114.7,351,195,156
060710109012,572.9,164.7,376.0,815,295,520
060710109011,339.8,103.7,217.8,381,158,223
060710091192,600.0,135.0,438.0,712,218,494
060710100171,952.9,209.9,698.9,804,220,584
060710100172,3147.6,1476.8,1502.9,2280,1081,1199
060710091191,698.7,155.0,517.0,607,194,413
060710091193,834.9,227.3,565.2,759,254,505
060710100091,773.5,311.9,429.2,543,237,306
060710091183,2899.5,1659.9,1104.1,2122,1186,936
060710100092,519.6,218.1,277.8,469,177,292
060710100181,1309.0,614.6,629.2,836,434,402
060710100231,1015.3,343.6,626.0,859,310,549
060710100232,1083.5,368.1,662.3,951,359,592
060710100182,930.3,366.6,526.3,862,374,488
060710100193,445.6,149.6,278.4,412,159,253
060710100201,739.7,263.2,433.4,667,291,376
060710100202,789.0,310.1,438.3,580,266,314
060710100191,476.4,180.5,275.6,533,176,357
060710100192,627.0,236.3,364.1,558,237,321
060710100161,776.6,384.9,333.1,704,327,377
060710100162,640.6,297.5,302.2,549,253,296
060710100101,372.9,172.7,182.5,385,149,236
060710100151,867.5,374.9,440.1,745,314,431
060710100104,535.5,245.2,262.7,535,225,310
060650419112,1006.3,503.7,453.1,639,347,292
060650419113,2087.2,895.8,1109.6,1605,708,897
060650419102,1531.0,588.6,901.2,1360,542,818
060590218283,1029.6,383.0,598.5,900,322,578
060590218282,621.9,221.9,370.8,655,213,442
060650419042,695.9,293.5,360.5,1567,710,857
060650419041,575.1,237.0,298.5,609,246,363
060650419122,615.9,253.8,319.7,649,279,370
060650406091,1832.3,947.7,798.7,772,456,316
060710001164,1633.2,805.9,751.6,1360,661,699
060710001151,838.5,426.8,370.3,846,399,447
060710001162,1725.6,878.5,771.5,1555,763,792
060650419121,1123.0,512.0,553.0,7,4,3
060650419123,594.5,263.2,296.6,593,265,328
060650419132,867.5,378.3,422.9,715,378,337
060650419133,749.8,332.0,374.1,606,292,314
060650419051,893.9,434.2,393.8,658,369,289
060650419131,601.8,262.2,291.6,620,270,350
060650419043,465.9,225.5,210.2,418,211,207
060650418041,852.9,349.7,454.4,805,355,450
060650418042,984.8,408.2,523.4,870,341,529
060650418062,971.7,426.7,502.1,940,419,521
060650418032,896.9,388.0,456.6,775,420,355
060650418031,1411.8,629.7,714.5,1281,602,679
060650418081,1056.6,435.7,570.4,876,444,432
060650418082,1120.2,527.7,549.1,916,448,468
060650418083,771.0,342.2,399.0,411,198,213
060650418051,499.0,262.1,203.7,421,237,184
060650418053,672.0,352.9,274.3,620,342,278
060650419064,421.9,230.1,161.4,301,154,147
060650419062,394.3,220.6,146.1,355,200,155
060650419063,472.0,257.4,180.6,355,171,184
060650419061,443.9,248.7,164.1,375,194,181
060650418061,806.2,400.0,370.6,690,357,333
060650417023,476.9,236.7,207.6,434,223,211
060650418072,505.0,239.7,230.3,469,240,229
060650418071,413.4,196.2,188.5,408,212,196
060650417022,809.1,394.6,360.4,703,360,343
060650418052,688.8,343.5,300.8,650,304,346
060650417042,323.9,227.2,77.1,182,122,60
060650417041,392.4,275.6,93.1,252,171,81
060650417021,241.7,167.6,59.3,293,157,136
060650417031,311.9,216.3,76.6,164,109,55
060650417032,368.0,259.4,86.4,250,160,90
060650408061,1258.3,425.4,759.7,1129,432,697
060650415001,118.1,84.5,26.6,109,77,32
060650408081,498.6,244.0,224.4,482,252,230
060650408082,554.6,334.2,184.0,289,174,115
060650408083,729.9,391.1,293.1,630,339,291
060510002006,333.6,190.0,114.1,333,215,118
060510002008,216.0,137.8,59.2,247,162,85
060190064032,170.6,32.5,126.4,140,22,118
060190064033,694.2,156.0,516.1,620,194,426
060190064031,968.0,248.4,663.8,1052,378,674
060190064034,735.1,169.3,531.4,723,207,516
060190064042,310.6,50.4,246.0,284,89,195
060190064022,606.6,145.7,425.2,845,302,543
060190064026,198.5,57.1,131.4,218,60,158
060190064024,80.4,21.4,54.7,79,28,51
060190064023,434.6,103.5,303.1,656,223,433
060190064025,47.9,11.2,34.0,47,16,31
060510002004,246.4,151.1,73.7,213,127,86
060510002002,332.6,214.1,92.4,294,195,99
060510002005,290.9,188.3,80.0,256,173,83
060510001013,345.2,225.1,101.2,285,193,92
060270001002,731.3,251.2,434.2,771,299,472
060270002001,559.2,236.8,291.5,568,281,287
060270002002,359.1,98.2,235.3,393,140,253
060270001001,567.1,199.0,334.7,608,259,349
060270003001,747.0,278.0,415.0,722,312,410
060270003002,821.1,230.4,538.6,824,267,557
060290052014,660.0,192.3,428.8,665,253,412
060290052013,391.2,107.9,261.9,545,193,352
060290052017,562.2,200.7,334.0,570,232,338
060290052016,285.9,92.7,183.1,292,125,167
060290052041,361.5,72.4,274.8,472,128,344
060290052011,431.5,37.8,384.7,495,97,398
061070027005,310.5,82.5,215.3,322,84,238
061070027001,297.4,65.9,218.4,333,104,229
061070027004,1068.9,270.9,738.4,1002,303,699
060290052012,252.7,67.3,168.7,391,122,269
060290052032,346.7,82.6,243.4,364,130,234
060290052031,404.6,97.7,284.4,511,178,333
060290052033,690.7,164.9,492.3,678,240,438
060290065002,702.0,251.5,400.1,205,74,131
060290055016,334.4,83.0,221.2,300,86,214
060290055015,531.2,106.7,384.7,474,115,359
060290055013,1171.6,299.9,786.1,1276,348,928
060270008004,283.1,107.4,155.0,458,190,268
060270008003,443.2,190.8,223.1,331,162,169
060290055012,360.2,78.1,253.5,438,137,301
060290053001,56.0,20.0,21.0,66,29,37
060290055011,358.2,74.0,256.7,382,105,277
060290053002,370.7,114.2,222.6,215,99,116
060270005002,797.2,292.5,421.9,825,367,458
060270004002,476.8,221.5,226.1,464,235,229
060270004004,304.3,154.5,119.2,310,166,144
060270004003,638.1,285.4,310.3,646,326,320
060710100152,596.8,282.5,274.1,660,289,371
060710100143,355.5,191.8,138.9,188,95,93
060710100142,374.2,201.8,146.2,313,174,139
060710100141,221.2,119.3,86.4,259,127,132
060710100133,480.4,185.1,265.1,507,203,304
060710100102,325.1,148.3,159.6,340,157,183
060710100103,465.1,212.1,228.4,357,169,188
060710091121,2293.0,1500.0,654.0,1633,1073,560
060710091171,991.2,632.4,319.0,791,482,309
060710091142,989.0,672.0,276.0,890,612,278
060710091181,1294.8,700.1,530.7,1195,589,606
060710091182,2706.4,1643.8,947.0,1893,1113,780
060710099061,559.0,314.0,226.0,536,316,220
060710091141,1279.3,877.1,342.5,964,626,338
060710091102,1411.3,804.2,524.1,1019,585,434
060710091101,3111.1,2046.9,896.1,2152,1381,771
060710091164,285.9,204.6,65.9,278,179,99
060710091162,162.3,114.7,38.5,99,65,34
060710091161,116.9,82.6,27.7,140,82,58
060710091172,228.9,91.9,122.7,265,108,157
060710091163,231.9,164.0,54.9,213,138,75
060710099062,992.0,536.0,393.0,987,529,458
060710099111,1420.4,695.3,630.4,1303,678,625
060710099112,656.0,310.8,303.4,642,324,318
060710099081,705.7,352.9,310.7,648,383,265
060710099082,720.0,395.6,288.2,415,195,220
060710100251,1148.9,646.7,453.1,1040,604,436
060710099101,568.0,338.4,206.1,599,352,247
060710099102,824.8,395.0,385.8,832,410,422
060710099043,1465.6,891.5,483.9,1119,697,422
060710100262,1264.3,683.7,506.7,1147,600,547
060710100252,781.3,398.7,344.4,298,122,176
060650403012,414.0,255.2,128.3,357,226,131
060650402021,370.0,213.9,129.5,434,223,211
060650402011,866.1,596.2,215.2,783,502,281
060650403013,308.0,184.4,101.6,156,89,67
060650402031,290.6,210.4,62.7,163,125,38
060650402032,427.9,309.8,92.3,258,191,67
060650311005,488.8,253.5,201.0,499,280,219
060650310011,658.8,346.3,268.5,643,358,285
060650308004,924.6,512.2,351.5,878,475,403
060650307003,434.0,234.0,170.6,396,244,152
060650307001,548.9,315.5,193.9,710,423,287
060650307002,604.2,351.8,208.4,399,258,141
060650307004,380.9,205.4,149.7,328,183,145
060650307005,460.0,266.3,160.4,473,273,200
060650302003,499.0,291.2,168.3,346,240,106
060650308001,298.8,154.5,120.2,304,148,156
060650308002,319.2,163.8,129.9,344,176,168
060650302002,216.8,112.1,87.2,236,143,93
060650302004,404.3,220.8,151.2,337,210,127
060650308005,462.8,215.8,212.6,515,233,282
060650311001,607.4,297.0,261.1,541,325,216
060650311002,254.9,124.7,109.6,259,128,131
060650311003,279.3,136.6,120.1,354,173,181
060650311004,136.2,66.6,58.6,81,44,37
060650306031,892.4,414.8,420.4,880,389,491
060650304004,219.1,175.1,30.7,196,166,30
060650402042,351.4,277.5,54.4,266,212,54
060650402041,215.6,170.2,33.4,150,114,36
060650403011,482.9,381.3,74.8,371,270,101
060650401021,711.6,426.3,246.6,401,270,131
060650302001,548.7,353.8,152.1,561,348,213
060650302005,273.6,176.4,75.8,339,220,119
060650301032,319.5,202.9,89.8,220,152,68
060650401011,468.1,306.4,140.8,445,272,173
060710033021,300.3,214.3,67.2,286,208,78
060710033024,192.2,130.1,52.0,165,112,53
060710033023,421.8,302.5,91.5,366,250,116
060710033022,302.9,196.4,92.8,332,221,111
060710040011,631.2,449.0,149.8,564,399,165
060710040012,373.0,282.7,69.9,361,281,80
060710034031,308.9,209.8,75.4,240,146,94
060710036063,630.0,446.4,144.2,429,297,132
060650401012,322.7,279.7,27.6,238,214,24
060650401013,164.9,142.9,14.1,123,102,21
060710040032,846.7,612.4,189.7,693,478,215
060710040031,304.9,237.2,50.6,286,216,70
060710040042,785.7,423.9,315.6,675,350,325
060710036061,213.0,155.5,45.0,155,104,51
060710036062,364.5,276.6,68.0,333,237,96
060710036051,591.0,441.2,123.6,474,339,135
060710036052,527.1,391.7,116.6,530,381,149
060710040041,647.5,432.2,182.7,582,385,197
060650314014,598.7,334.1,217.0,530,315,215
060650313002,390.8,280.1,86.5,251,200,51
060650314021,673.7,375.9,244.2,683,368,315
060650314013,399.3,209.2,164.3,238,132,106
060650314024,450.0,259.6,154.8,346,177,169
060650317043,341.1,196.0,124.7,402,202,200
060650317011,394.6,282.8,87.4,246,206,40
060650313001,311.5,223.3,69.0,285,226,59
060650312004,640.5,398.4,203.7,614,421,193
060650312005,851.5,428.2,372.1,555,333,222
060650314012,186.7,95.6,80.0,272,144,128
060650314011,189.3,96.9,81.1,198,104,94
060650312002,325.2,169.9,136.3,371,179,192
060650312003,538.1,281.2,225.6,503,294,209
060650306021,603.4,267.6,299.5,683,323,360
060650306023,348.1,162.0,167.4,414,157,257
060650420091,812.8,363.0,406.5,603,336,267
060650420032,935.6,325.2,559.9,817,307,510
060650420042,835.4,286.5,500.5,872,326,546
060650420031,1492.7,591.4,828.9,1192,555,637
060650420041,677.3,247.3,396.4,580,243,337
060650420141,1660.2,773.0,793.0,1454,690,764
060650420052,1106.6,436.2,610.0,779,383,396
060650420092,879.9,477.2,355.5,670,415,255
060650306011,1184.3,457.3,659.8,1195,463,732
060650317012,623.2,273.3,312.4,661,239,422
060650306012,541.0,208.9,299.0,543,225,318
060650306013,1187.8,523.7,605.9,1202,498,704
060650420051,1190.3,455.9,669.4,1142,454,688
060650306022,829.8,320.6,469.7,874,404,470
060650422173,744.8,314.7,393.4,674,340,334
060650420122,1332.1,628.9,625.9,1326,670,656
060650420142,642.6,290.4,313.8,715,336,379
060650420143,1751.7,789.6,865.4,1507,760,747
060650420132,1336.4,569.1,693.5,1084,534,550
060650420121,953.4,440.2,448.2,737,397,340
060650422174,629.3,273.9,321.7,489,239,250
060650422172,656.5,285.8,335.6,866,427,439
060650422071,978.9,435.7,490.9,959,440,519
060659800041,4.9,2.3,2.4,0,0,0
060650422081,661.8,313.2,313.5,784,385,399
060650422082,709.6,335.8,336.1,681,325,356
060650422171,632.3,360.1,229.6,759,425,334
060650422072,686.9,348.2,300.9,625,291,334
060650509001,661.2,396.7,220.2,491,307,184
060650509003,297.2,178.2,99.1,344,189,155
060650509002,595.2,328.8,215.7,547,325,222
060650402012,603.4,295.3,267.8,550,284,266
060650310021,404.4,255.1,123.3,360,238,122
060650310012,825.2,423.1,345.4,729,404,325
060650310013,655.5,336.1,274.4,633,357,276
060650308003,653.4,302.2,302.8,497,294,203
060650427091,1177.9,448.4,687.3,941,453,488
060650427082,1127.2,411.9,647.0,869,381,488
060650427081,716.2,273.6,410.6,586,250,336
060650427112,791.2,317.8,446.0,711,321,390
060650427411,506.3,203.4,285.4,677,267,410
060650427113,1005.4,403.8,566.7,935,401,534
060650427111,970.7,371.8,556.5,1044,440,604
060650427412,813.9,309.8,475.0,681,286,395
060650427401,864.7,329.2,504.6,1044,412,632
060650427402,327.5,124.7,191.1,356,145,211
060650428002,644.9,479.8,123.9,341,267,74
060650428003,784.4,564.7,177.2,552,393,159
060650426172,462.4,366.7,66.1,450,345,105
060650427064,382.5,303.5,55.1,330,261,69
060650426171,669.6,531.6,98.5,464,360,104
060650426181,1230.0,979.0,195.0,795,597,198
060650427061,265.9,212.1,40.2,208,168,40
060650427062,500.2,399.0,75.6,367,307,60
060650427063,619.5,494.2,93.7,442,351,91
060650426173,1498.5,1180.1,226.3,857,647,210
060650317032,829.1,364.7,415.4,809,399,410
060650317041,532.1,263.6,237.1,490,296,194
060650317042,495.2,250.5,215.4,419,199,220
060650317044,521.0,263.6,226.7,308,162,146
060650315011,291.4,169.1,103.6,344,195,149
060650315013,257.8,149.6,91.7,212,130,82
060650315012,437.8,211.1,182.7,404,214,190
060650315015,178.7,97.5,67.4,298,136,162
060650315024,398.0,211.7,157.8,340,197,143
060650315023,779.5,414.6,309.1,645,391,254
060650315025,358.5,190.7,142.2,284,156,128
060650314022,476.8,261.7,184.0,343,189,154
060650314015,543.5,298.2,209.8,571,351,220
060650314023,343.9,188.7,132.7,375,212,163
060710023051,1755.5,1168.8,500.1,1589,1101,488
060710023042,3721.1,2225.5,1350.2,2968,1783,1185
060710024015,520.5,418.1,76.2,375,286,89
060710024022,439.7,345.5,70.3,195,146,49
060710024023,336.5,264.3,53.2,57,37,20
060710025023,526.3,404.5,98.1,421,319,102
060710024021,400.8,323.4,61.4,251,195,56
060710024013,260.6,211.1,34.3,231,178,53
060710024012,299.8,237.2,46.3,229,178,51
060710024011,309.3,224.2,72.3,92,68,24
060710031012,452.0,331.8,94.4,432,321,111
060710031011,272.3,202.5,55.5,261,193,68
060710024024,317.5,246.4,56.1,240,197,43
060710031013,234.3,182.4,40.3,132,94,38
060710028041,310.5,241.2,53.9,218,169,49
060710031021,308.2,242.1,48.4,270,187,83
060710031022,200.9,157.8,31.6,150,112,38
060710031023,235.5,185.0,37.0,152,122,30
060710030002,256.9,194.8,48.8,302,212,90
060710028033,177.6,138.6,32.2,199,135,64
060710028043,264.8,213.6,43.5,143,122,21
060710028031,290.3,221.5,56.0,146,127,19
060710028042,182.0,136.0,37.0,79,54,25
060710028032,158.1,118.1,32.2,223,156,67
060710028011,513.3,391.2,94.8,535,410,125
060710028013,229.0,174.5,42.3,131,95,36
060710028012,329.7,251.3,60.9,238,187,51
060710023043,1888.0,1162.6,631.5,1460,909,551
060710023041,1628.4,1118.5,446.4,1379,946,433
060710023053,501.8,354.5,125.4,277,210,67
060710023052,559.3,387.8,150.3,359,256,103
060710023012,1160.1,835.9,269.4,632,496,136
060710023054,648.4,477.3,134.1,588,423,165
060710023013,1040.1,756.8,229.2,611,445,166
060710027042,2914.8,1764.1,993.9,2097,1368,729
060710020102,921.5,551.6,322.3,523,319,204
060710020101,1962.8,1014.6,858.9,1284,725,559
060710020103,1076.5,572.9,444.0,945,511,434
060710092022,310.0,86.3,207.4,312,134,178
060710119001,143.5,32.2,100.5,232,59,173
060710119002,97.6,21.9,68.3,165,49,116
060710119003,251.8,75.6,164.1,301,131,170
060710119004,416.8,121.7,275.8,344,118,226
060710120011,656.3,291.1,328.4,681,289,392
060710120013,409.9,182.9,203.8,332,203,129
060710118004,923.8,269.0,598.8,868,302,566
060710095005,310.1,140.3,146.1,429,220,209
060710095004,423.9,188.4,197.9,400,222,178
060710095001,316.7,138.9,150.6,306,176,130
060710095002,276.7,134.7,116.2,263,142,121
060710095003,250.0,128.0,97.7,356,186,170
060710093001,366.4,112.9,228.3,381,139,242
060710094001,272.2,129.1,124.1,240,107,133
060710094002,359.2,180.9,149.0,337,218,119
060710120012,674.6,294.9,333.3,704,353,351
060710120023,289.5,126.5,143.1,234,113,121
060710120022,317.5,140.6,148.9,361,197,164
060710120024,756.0,333.8,356.2,991,487,504
060710120021,23.0,5.0,14.0,20,9,11
060710089011,222.9,47.5,158.5,222,62,160
060710089012,110.5,33.8,67.0,113,42,71
060710089013,294.6,62.7,209.5,336,118,218
060710103004,220.4,57.4,152.6,148,47,101
060710116001,479.5,137.8,321.6,449,156,293
060710250001,369.0,166.0,156.0,374,220,154
060710103003,227.8,60.2,158.4,269,92,177
060270004001,392.0,228.0,113.0,418,296,122
060133040021,409.1,163.7,221.8,468,254,214
060770052063,4638.3,3064.4,1317.7,2265,1473,792
060770039001,182.3,82.1,90.2,166,67,99
060770052062,431.7,169.7,237.8,397,186,211
060133040051,1726.7,722.4,899.4,1504,807,697
060133040041,1331.0,453.0,801.0,1268,576,692
060133040042,595.6,211.4,361.0,704,298,406
060133040031,1050.8,379.9,632.6,980,423,557
060133031031,778.4,340.5,388.0,751,365,386
060133040052,1067.9,533.4,470.9,562,309,253
060133040033,438.5,161.7,251.7,430,129,301
060133031032,803.6,506.6,249.0,910,596,314
060133031033,1262.4,771.4,415.2,583,412,171
060133040032,407.3,151.5,232.9,357,160,197
060133020081,1278.5,779.8,435.2,837,566,271
060133010003,986.9,513.4,411.2,418,220,198
060770052061,262.0,128.9,115.5,309,174,135
060770039002,184.0,66.0,109.8,190,68,122
060770052021,897.9,431.2,400.6,427,187,240
060710117001,345.6,105.5,219.7,337,129,208
060710116003,1139.9,317.7,773.4,1094,339,755
060710116002,1476.0,360.7,1032.2,1362,443,919
060710121012,1880.3,584.2,1187.2,1803,604,1199
060710121011,423.8,93.8,307.8,382,118,264
060710118002,352.6,93.4,234.4,367,131,236
060710118001,447.2,143.9,274.3,430,166,264
060710118003,432.6,150.7,252.7,415,160,255
060710104242,624.5,236.0,363.0,557,239,318
060710104241,171.5,43.9,115.3,253,74,179
060710104173,313.8,114.9,180.0,265,123,142
060710104233,350.8,130.6,202.8,342,151,191
060710104132,397.1,135.0,239.9,521,199,322
060710104114,488.2,163.0,297.5,448,177,271
060710104113,572.8,201.6,334.9,418,183,235
060710104111,422.2,153.4,243.2,477,179,298
060710104134,644.3,236.6,374.4,627,229,398
060710104131,581.2,197.3,351.9,480,225,255
060710104112,1062.0,329.3,679.2,931,374,557
060379303012,143.0,46.0,91.0,142,44,98
060710092013,629.4,201.6,374.1,561,213,348
060710092012,742.7,227.3,456.7,677,274,403
060710092011,800.9,248.1,488.2,1005,411,594
060710091071,1217.0,282.1,875.7,1319,441,878
060710091073,891.6,196.4,641.7,750,232,518
060710091072,655.4,139.5,471.6,619,201,418
060710091091,718.6,163.3,517.1,605,181,424
060710091092,557.3,126.7,401.0,578,157,421
060710091093,398.4,94.4,285.4,330,77,253
060710091094,612.7,145.1,438.9,495,147,348
060710087092,424.1,122.1,276.1,324,135,189
060710091083,948.1,265.4,629.1,935,319,616
060710091082,678.4,191.3,449.3,609,218,391
060710091081,589.1,166.5,390.0,524,208,316
060710091173,106.9,74.9,27.8,186,107,79
060379200121,500.2,154.6,310.1,459,184,275
060379201023,1179.3,471.1,631.0,1079,517,562
060379201022,256.4,61.5,176.9,221,84,137
060379012101,686.4,192.0,444.3,708,267,441
060379012131,2063.6,609.8,1336.9,1800,565,1235
060379012091,609.3,138.9,432.9,626,176,450
060379012054,1170.9,421.0,671.2,816,306,510
060290055062,319.4,63.7,240.3,271,85,186
060290055061,993.7,242.0,693.4,1050,277,773
060379009001,1090.1,263.4,761.0,994,290,704
060379102061,1421.2,787.9,536.3,847,516,331
060379103021,673.3,235.1,403.1,582,186,396
060379103023,965.9,371.1,537.4,829,328,501
060379012053,1038.2,361.1,621.7,799,324,475
060230105021,853.9,484.3,304.9,961,554,407
060230105022,929.7,534.8,314.9,736,427,309
060230105014,660.3,415.0,175.3,605,442,163
060230105013,688.8,422.9,203.9,716,467,249
060230104002,804.9,482.2,253.0,877,536,341
060230105023,805.2,467.4,265.9,871,531,340
060230104001,912.6,527.1,301.7,936,598,338
060230103003,385.5,237.6,105.0,330,221,109
060230103002,303.5,169.5,104.3,351,209,142
060230103001,512.4,333.8,143.0,524,347,177
060230102003,491.1,364.7,73.3,265,230,35
060230102001,614.7,387.1,154.4,633,462,171
060230102002,449.4,319.3,80.1,745,597,148
060230103005,272.2,151.9,95.1,252,154,98
060230101021,491.7,221.4,217.1,1024,634,390
060230101022,62.8,41.6,12.9,81,67,14
060230101023,215.4,118.6,52.5,225,143,82
060239400002,211.3,152.9,36.8,28,20,8
060239400001,249.7,180.8,43.4,97,75,22
060150001022,551.9,215.4,278.6,570,272,298
060150001021,554.0,203.6,302.3,783,360,423
060150002024,512.9,222.3,265.2,372,175,197
060150002031,371.4,176.3,165.8,292,139,153
060150001011,523.8,214.7,252.4,642,348,294
060150001055,564.2,227.5,283.6,599,337,262
060150001041,658.8,255.7,344.1,518,259,259
060150001012,524.2,250.4,221.8,450,247,203
060150001053,368.2,140.5,198.6,407,225,182
060150001051,773.6,270.6,446.9,492,240,252
060150001054,250.2,89.7,138.1,237,112,125
060150001052,866.9,269.9,528.2,618,286,332
060150002011,209.6,59.1,134.9,357,148,209
060150002012,577.7,176.6,369.0,645,269,376
060150002013,866.6,227.4,586.8,501,207,294
060150002023,459.9,201.9,223.8,376,206,170
060450111023,1118.1,847.4,200.3,967,806,161
060971543031,521.6,379.0,104.1,645,493,152
060971543041,447.3,298.2,92.9,394,303,91
060971543042,334.4,233.8,69.9,333,278,55
060971543032,468.6,376.0,75.1,444,333,111
060490003003,482.6,109.8,347.4,654,225,429
060490002002,402.7,76.3,312.6,425,105,320
060490003001,376.1,74.5,286.3,177,33,144
060490001001,306.7,61.4,234.6,770,223,547
060490001004,90.1,22.7,62.4,132,54,78
060630003001,422.3,132.2,266.5,497,219,278
060630003003,471.3,159.6,282.1,549,217,332
060630003004,575.4,139.3,421.7,593,168,425
060630003002,476.4,192.9,245.2,457,218,239
060630002011,647.4,242.6,374.2,808,359,449
060350405001,536.2,91.2,416.8,470,115,355
060350405003,632.3,110.2,488.2,665,181,484
060350403022,846.2,147.2,668.2,899,214,685
060350404001,504.1,70.8,414.1,781,180,601
060350403021,578.1,107.4,438.5,624,179,445
060350405002,444.0,74.2,347.0,324,89,235
060350406001,501.7,118.1,356.8,530,188,342
060630004001,464.5,174.9,251.6,547,271,276
060350406003,406.6,67.7,310.5,265,78,187
060350406002,7.6,1.7,5.6,41,19,22
060350401003,114.4,19.1,89.4,132,38,94
060350404002,126.2,17.6,100.8,16,4,12
060350403031,555.4,119.0,405.3,582,184,398
060350403051,649.6,151.8,464.8,809,276,533
060490001003,317.8,91.9,204.8,232,91,141
060490001005,276.2,74.1,186.4,368,133,235
060490001002,216.9,54.4,150.2,436,154,282
060350403023,710.4,145.3,515.9,835,276,559
060350403053,475.1,135.3,310.6,541,217,324
060350403041,339.5,94.1,216.8,343,124,219
060350403042,234.0,62.3,145.3,249,98,151
060350403033,263.4,72.2,172.2,281,91,190
060350403052,333.0,100.8,209.4,320,116,204
060350403032,399.8,99.3,270.1,372,116,256
060350402001,464.7,103.3,335.6,545,224,321
060890127021,342.3,88.2,231.5,402,124,278
060890127022,604.8,155.9,408.9,440,143,297
060890127023,446.0,106.5,313.0,433,122,311
060890127011,566.8,142.7,390.8,645,196,449
060350401002,406.8,74.3,312.9,419,111,308
060350401001,247.1,30.6,209.4,228,54,174
060490002001,316.1,51.5,247.7,342,69,273
060930005003,200.0,80.6,101.3,172,92,80
060930005001,372.0,124.6,215.8,482,253,229
060930008003,406.0,130.6,241.0,199,97,102
060930008001,1073.5,280.0,721.4,959,285,674
060930009002,738.9,365.1,320.3,883,460,423
061050001021,578.9,251.5,281.9,331,195,136
061050001011,299.5,102.1,178.4,772,406,366
060930006001,809.0,211.1,543.0,657,236,421
060930008002,238.9,76.0,147.7,190,78,112
060930007014,354.6,78.3,261.3,221,78,143
060930007012,471.3,125.9,317.0,587,200,387
060930007013,582.8,122.0,429.1,727,227,500
060930007033,654.1,187.0,417.9,660,252,408
060930007022,951.9,281.0,598.4,876,352,524
060930007021,679.2,220.7,405.6,721,310,411
061030003002,807.1,251.9,507.1,798,310,488
061030003001,1048.2,227.2,776.1,1483,482,1001
061030004002,901.8,195.7,662.8,975,338,637
061030004003,1061.1,253.3,761.1,564,182,382
061030002001,682.9,142.3,508.8,1466,535,931
061030002002,1315.8,279.6,973.2,1226,368,858
061030008003,318.5,91.0,209.7,307,113,194
061030011004,484.3,192.1,251.5,350,164,186
061030011001,433.1,113.7,297.5,437,166,271
061030011003,395.0,104.5,272.8,372,129,243
061030011006,400.7,161.9,202.4,362,156,206
061030011002,214.0,79.9,119.2,146,74,72
061030010004,425.6,154.3,242.8,453,189,264
061030011005,167.9,62.7,93.5,217,91,126
061030010003,362.9,130.6,209.2,335,158,177
061030010002,973.1,312.9,622.7,980,357,623
061030008001,349.1,90.4,232.5,376,130,246
061030008002,294.9,80.3,196.1,316,109,207
061030009001,329.1,93.8,225.0,334,100,234
061030007001,612.7,176.5,391.9,639,293,346
061030005001,1056.9,359.8,610.1,517,213,304
061030005003,249.8,82.7,152.9,245,116,129
061030004001,975.7,245.3,690.7,991,339,652
061030002003,1531.5,412.4,1043.6,1373,444,929
061030007002,503.0,177.8,287.3,417,193,224
061030007005,518.6,179.7,301.0,481,194,287
061030007004,461.3,161.3,263.6,423,194,229
061030005004,261.2,93.4,149.9,233,122,111
061030007003,167.6,59.3,98.9,215,95,120
061030006002,715.6,220.7,455.3,815,313,502
061030005002,360.0,116.0,223.5,425,174,251
061030001004,419.8,107.0,285.2,405,150,255
060930011002,280.9,143.9,108.6,338,199,139
060930011001,225.9,119.2,86.9,279,165,114
060930011003,410.9,210.7,158.9,377,249,128
060930010004,1344.8,633.0,571.6,1221,693,528
060930010003,934.8,537.5,305.4,1054,683,371
060930010002,495.1,270.7,161.3,549,351,198
060930012001,675.4,236.5,382.7,730,349,381
060930007011,387.2,80.6,283.3,517,137,380
060930003002,613.6,150.9,423.9,609,190,419
060930003003,577.2,196.4,346.3,551,242,309
060930009004,1773.1,707.0,957.4,1437,684,753
060930007031,225.9,75.0,134.3,281,114,167
060930007032,594.3,206.3,348.9,618,249,369
060930009001,157.4,74.5,70.1,335,198,137
060930009005,281.6,128.7,130.4,289,173,116
060930009006,155.7,73.6,69.3,258,167,91
060890126012,718.6,234.7,395.4,810,323,487
060890126011,880.2,215.1,608.7,1043,426,617
060890127014,293.2,71.5,202.8,256,91,165
060790130001,663.0,329.8,294.9,657,346,311
060790104041,766.0,458.6,267.6,901,529,372
060790104033,721.0,477.1,191.8,791,529,262
060799900000,0.0,0.0,0.0,0,0,0
060790100021,389.5,106.0,264.2,495,162,333
061050001023,627.5,250.9,314.7,642,328,314
061050002001,613.1,308.1,239.0,520,306,214
061050003002,456.6,189.4,220.1,400,225,175
061050001013,370.2,152.3,175.9,949,513,436
061050001012,612.4,236.2,311.6,637,352,285
060890124002,567.6,148.3,385.4,576,236,340
060890124003,955.4,296.5,601.5,951,347,604
060890124001,638.2,221.9,369.3,552,282,270
061050001022,790.9,288.7,422.2,665,326,339
060230101024,296.8,130.8,133.5,276,133,143
061050002002,279.8,106.2,138.9,73,39,34
060930005002,225.1,65.2,137.7,179,79,100
060470003013,596.0,421.0,137.0,402,278,124
060470002011,737.2,316.0,384.4,727,332,395
060470005051,600.8,250.0,322.5,582,241,341
060470002012,219.1,79.1,126.5,201,72,129
060470005031,524.6,169.2,327.7,581,232,349
060470025001,346.8,87.4,240.8,316,113,203
060470006011,382.9,176.2,182.2,367,167,200
060470006014,519.0,208.8,272.3,552,252,300
060470006012,291.8,157.7,119.3,396,219,177
060470005042,253.1,163.4,73.7,339,189,150
060470005052,191.4,120.3,59.2,151,110,41
060470006032,417.6,166.4,233.6,336,150,186
060470006031,555.4,196.2,335.9,537,209,328
060470005053,413.2,267.3,122.1,343,218,125
060470006021,594.2,280.6,273.0,580,286,294
060470005043,439.8,272.6,144.2,292,191,101
060470006022,517.8,212.4,267.0,486,249,237
060470006034,223.4,112.2,100.6,72,43,29
060470006033,296.0,148.7,133.3,358,197,161
060470006035,113.6,57.1,51.2,70,44,26
060470005041,490.4,296.5,173.2,260,156,104
060990038032,390.7,195.8,167.3,209,135,74
060990038021,239.3,139.4,81.4,194,116,78
060990039042,188.7,110.0,64.2,208,127,81
060990039043,319.0,184.9,109.6,318,176,142
060990039081,353.5,169.4,157.2,253,134,119
060990038024,346.7,202.0,118.0,156,123,33
060990038023,390.3,227.6,134.4,375,241,134
060990038031,307.8,176.9,108.0,261,171,90
060990039062,774.4,351.1,361.9,461,257,204
060990039063,432.1,216.7,182.5,287,165,122
060990039041,282.4,156.7,103.6,486,247,239
060990038022,268.2,156.3,91.2,142,106,36
060990037002,286.2,90.0,180.7,283,123,160
060990039044,333.4,137.8,170.4,405,186,219
060990039052,629.1,232.7,353.8,749,317,432
060990039074,969.7,334.8,577.9,1161,434,727
060990039053,709.4,254.2,409.5,677,265,412
060990039061,277.7,123.2,132.6,271,119,152
060990039054,219.1,93.1,107.9,284,133,151
060990039073,604.5,227.5,339.3,687,226,461
060990039072,961.8,391.2,505.8,939,403,536
060990039071,966.1,321.7,592.7,939,354,585
060990036045,1410.0,429.4,902.8,1360,467,893
060990039051,382.7,134.5,224.2,407,177,230
060990036051,1394.0,631.6,680.4,1380,670,710
060990036062,1492.9,676.4,728.6,1207,609,598
060990036043,1040.8,323.0,663.7,730,276,454
060990036044,466.6,151.4,289.9,488,147,341
060990028024,580.4,164.0,391.7,476,156,320
060990001013,614.4,142.6,442.5,579,190,389
060990002035,749.4,248.3,454.4,849,327,522
060990001023,529.6,137.9,368.1,457,129,328
060990001012,577.7,142.2,410.6,493,140,353
060990001014,465.5,121.6,323.0,408,131,277
060990001011,729.9,190.6,506.5,820,231,589
060990002032,498.5,171.8,297.7,322,150,172
060990001022,947.2,247.5,657.2,1208,391,817
060990001021,414.8,109.1,286.6,338,96,242
060990028013,411.4,98.5,290.0,420,123,297
060990002012,623.6,211.0,378.3,656,234,422
060990028032,712.3,290.7,377.1,728,350,378
060990002015,561.8,190.3,340.6,518,219,299
060990002022,1520.1,540.4,888.6,1348,541,807
060990002034,1020.0,355.1,605.0,868,354,514
060990002031,893.6,303.7,534.0,829,295,534
060990028022,825.9,292.0,492.8,668,309,359
060990028012,628.0,229.3,366.0,473,208,265
060990028021,380.4,135.5,227.4,479,206,273
060990028011,775.6,285.6,445.8,792,311,481
060910100003,415.0,139.5,225.5,531,212,319
060910100004,419.4,130.4,246.4,297,135,162
060570009003,317.5,157.5,123.4,323,205,118
060570009001,904.5,600.3,154.4,893,759,134
060570008012,1175.2,630.4,412.5,1171,722,449
060630002012,520.7,198.7,299.4,532,233,299
060630002022,244.4,92.5,129.3,344,135,209
060630002021,285.2,126.9,138.5,322,129,193
061090052011,114.8,29.8,83.0,180,63,117
061090052012,546.5,143.9,382.3,535,193,342
061090051005,422.3,101.5,306.1,385,131,254
061090051001,550.1,186.7,336.3,641,274,367
061099852021,301.9,77.1,204.2,15,3,12
061090051003,872.5,312.5,508.3,580,232,348
061090021006,409.9,153.1,233.4,575,242,333
061090051002,762.4,272.3,437.9,572,294,278
061090041004,484.1,141.0,311.0,482,184,298
061090042001,207.8,90.6,102.7,419,199,220
060855119092,1247.0,845.1,337.3,1222,796,426
060855119093,1470.6,1022.2,370.8,1405,908,497
060855119051,1595.4,1036.7,463.0,1530,951,579
060855119121,1160.1,794.0,296.6,1239,787,452
060855119113,957.7,571.2,318.4,1006,582,424
060855119123,510.0,335.5,149.3,617,389,228
060855119072,1307.1,869.9,359.8,1372,879,493
060855122001,874.8,435.6,371.2,895,449,446
060855122002,1396.0,743.1,570.8,1389,756,633
060855119112,503.9,279.8,194.7,465,264,201
060855119122,835.7,573.7,210.6,829,572,257
060855120301,921.4,595.6,240.2,999,631,368
060855121001,641.3,362.5,244.2,627,360,267
060855120331,583.2,377.5,165.6,608,401,207
060871224005,371.9,208.9,132.9,343,196,147
060871224001,1181.5,751.1,341.1,1227,869,358
060871224004,517.9,335.6,141.5,484,305,179
060871233001,574.0,374.8,160.4,517,304,213
060871225002,609.9,458.9,113.9,414,319,95
060871225001,506.3,407.8,67.3,429,356,73
060855124012,802.0,446.0,311.8,672,414,258
060855125031,3090.8,1816.9,1096.3,2153,1294,859
060855123052,752.4,394.8,309.0,732,398,334
060070026022,784.4,233.4,514.4,870,306,564
060070024003,633.8,185.4,395.8,952,378,574
060070024005,344.0,108.0,211.3,358,135,223
060070023005,567.9,185.2,339.7,537,245,292
060070022002,830.6,284.9,484.7,1016,403,613
060070025004,396.3,135.0,231.1,461,198,263
060070033002,432.5,129.1,271.0,360,166,194
060070033001,743.9,206.3,494.2,741,253,488
060070037002,278.6,81.7,174.7,150,48,102
060070023001,799.2,268.6,482.2,740,290,450
060070022001,731.4,281.7,391.7,672,316,356
060070022003,424.1,160.8,229.4,478,230,248
060070021005,432.6,180.6,220.5,414,226,188
060070021004,617.7,250.9,314.2,673,285,388
060070021003,421.5,157.9,231.0,406,193,213
060070018005,406.8,139.2,239.1,391,162,229
060070018001,819.8,315.7,437.9,939,401,538
060070021001,330.6,142.0,167.7,459,256,203
060070018004,538.0,198.9,294.0,483,238,245
060070018002,358.1,133.1,193.4,390,177,213
060070023004,465.1,181.5,239.8,517,238,279
060070020006,320.9,126.8,168.8,285,137,148
060070020004,446.8,170.6,239.5,424,202,222
060070023003,396.6,154.7,205.3,425,198,227
060070023002,589.8,218.1,331.9,602,250,352
060070019001,292.8,107.5,163.2,299,129,170
060070024001,424.8,151.9,222.3,400,200,200
060070020002,377.1,140.6,210.4,376,180,196
060070020001,558.2,199.7,317.1,542,235,307
060070020005,592.3,223.1,324.4,520,250,270
060070020003,399.1,140.5,228.2,380,162,218
060070019002,478.4,180.2,263.4,617,241,376
060070017023,820.7,297.0,466.8,1022,419,603
060070016003,870.4,399.8,413.4,845,463,382
060070017022,1058.1,411.5,579.3,894,428,466
060070017032,736.6,278.7,405.0,862,390,472
060070017031,474.2,181.0,260.3,542,245,297
060070018003,524.8,196.6,289.8,541,268,273
060070019004,507.5,188.6,280.8,475,203,272
060070019003,365.3,135.8,202.0,415,164,251
060070017021,473.5,188.1,253.5,480,208,272
060070017041,256.1,80.0,166.6,296,136,160
060070017043,625.9,217.2,362.7,614,273,341
060070017042,480.0,152.0,296.3,465,192,273
060070017024,527.9,174.2,315.1,494,226,268
060070024002,483.7,171.7,264.3,406,183,223
060070024004,559.8,196.8,319.5,573,272,301
061150411004,411.8,115.9,262.8,383,137,246
061150411002,707.9,318.2,332.7,635,311,324
061150411003,562.2,188.3,328.3,406,169,237
061150410001,1224.2,385.0,766.6,1187,451,736
061150411001,489.4,202.2,231.0,577,267,310
060610205021,1266.3,499.2,669.3,1318,550,768
060610205011,475.4,145.7,300.0,509,212,297
060610204011,893.1,455.7,360.6,753,421,332
060610203002,662.2,300.1,307.8,762,404,358
060610205023,863.4,324.0,475.7,766,306,460
060990005051,1213.1,599.3,543.1,1102,592,510
060990005052,554.4,279.7,242.0,516,276,240
060990008061,764.8,382.4,337.5,878,450,428
060990005041,2325.3,1061.4,1132.9,2173,1080,1093
060990005063,437.7,197.6,213.9,380,184,196
060990005064,322.4,124.2,180.6,414,176,238
060990005012,506.8,174.2,309.9,539,167,372
060990004042,1375.0,608.4,693.4,1206,598,608
060990005011,579.5,181.3,375.4,808,219,589
060990005062,489.7,221.5,239.0,409,213,196
060990008012,656.4,276.6,339.5,656,334,322
060990008011,596.9,251.1,309.4,623,316,307
060990005061,477.5,203.1,244.1,387,200,187
060990004041,448.0,203.9,216.0,431,204,227
060990009082,853.0,386.4,417.6,620,301,319
060990009072,481.9,210.2,246.3,660,274,386
060990009071,533.5,232.8,272.7,667,312,355
060990009083,735.1,338.0,357.7,624,334,290
060990009081,532.0,252.3,247.5,646,316,330
060990004043,504.0,233.3,247.0,490,238,252
060990004023,2371.2,1094.8,1150.1,2173,1051,1122
060990036034,408.6,126.9,266.8,473,183,290
060990030021,367.3,156.6,193.1,337,142,195
060990030022,465.9,183.5,262.2,422,212,210
060990036033,310.8,114.3,179.9,332,124,208
060990027021,293.8,194.0,88.0,124,89,35
060990027022,287.5,215.0,56.3,329,247,82
060990026021,226.4,118.0,94.6,218,120,98
060990025032,248.9,152.3,82.5,179,100,79
060990026023,326.7,184.4,120.4,259,149,110
060990025041,715.3,436.0,234.9,749,436,313
060990025042,582.4,369.4,179.7,496,302,194
060990025033,386.8,226.4,134.5,282,176,106
060990027025,310.6,194.1,103.4,376,219,157
060990027023,326.4,198.1,113.0,268,171,97
060990027024,314.3,194.3,106.1,356,209,147
060990025031,404.3,227.4,147.9,386,212,174
060990026031,190.4,99.2,79.6,244,128,116
060990026043,431.5,225.0,180.4,298,210,88
060990026032,609.2,300.6,271.3,963,461,502
060990026042,317.7,155.5,142.8,117,73,44
060990026041,380.8,185.8,171.7,314,180,134
060990027012,816.8,432.2,346.3,880,459,421
060990030012,394.5,150.0,220.1,322,137,185
060990026022,590.0,329.9,220.0,573,330,243
060990030011,2279.3,1436.5,716.6,1670,1021,649
060990026052,660.6,381.8,238.6,594,321,273
060990030013,372.1,215.1,134.4,391,206,185
060990026051,595.3,313.5,248.3,595,313,282
060990027011,658.3,366.9,256.7,551,303,248
060990037001,635.2,413.6,185.7,536,355,181
060990037003,379.4,112.4,244.8,381,118,263
060990038042,279.9,148.7,115.3,279,164,115
060990038044,425.0,225.8,175.1,279,172,107
060990038043,647.4,344.0,266.7,803,446,357
060990038041,319.6,169.8,131.7,283,176,107
060990038051,912.0,486.0,354.0,736,429,307
060990039092,513.5,233.8,240.9,527,248,279
060990039093,561.8,255.8,263.6,635,318,317
060990039091,607.8,276.8,285.1,595,297,298
060990039094,416.0,189.4,195.1,290,151,139
060990039082,375.9,171.2,176.4,259,138,121
060990036061,2729.6,1379.2,1189.0,2314,1205,1109
060990036052,1317.4,655.7,597.8,1249,676,573
060990005102,736.3,386.4,302.3,674,382,292
060990040002,495.6,173.3,292.5,490,186,304
060990005013,705.8,362.8,295.7,756,402,354
060990005032,643.6,333.9,276.7,713,381,332
060990005031,594.5,308.4,255.6,462,282,180
060990005033,415.5,215.5,178.6,392,225,167
060990005014,944.8,427.5,439.9,752,400,352
060990006022,615.1,327.6,256.6,521,316,205
060990006013,581.1,302.3,248.7,640,328,312
060990015004,409.5,173.8,213.2,465,239,226
060990015001,553.0,347.0,179.2,459,289,170
060990016012,371.5,266.0,84.0,280,191,89
060990022001,311.8,250.6,44.2,273,217,56
060990016041,232.1,186.6,32.9,162,123,39
060990022004,246.6,186.9,43.8,196,140,56
060990022003,96.6,73.7,16.8,64,38,26
060990023013,107.0,79.0,20.9,57,37,20
060990016042,202.3,162.7,28.7,131,113,18
060990022002,371.1,290.5,58.7,335,272,63
060990016043,197.6,158.8,28.0,127,106,21
060990023012,627.6,473.0,120.5,328,245,83
060990016034,332.5,206.2,105.3,310,216,94
060990016013,264.5,212.0,38.1,171,128,43
060990016032,289.0,220.1,52.6,182,151,31
060990016031,267.7,162.1,88.6,135,96,39
060990016011,240.3,182.8,45.1,222,156,66
060990015002,452.9,299.5,132.6,373,295,78
060990017001,291.2,226.6,42.0,212,170,42
060990015003,526.6,347.4,154.8,465,297,168
060990006021,385.4,186.7,175.3,412,206,206
060990006012,772.4,367.5,365.3,752,391,361
060990006011,383.6,140.3,222.8,322,150,172
060990008032,396.1,224.2,139.3,311,199,112
060990008033,491.3,269.0,189.0,411,247,164
060990008031,308.9,174.9,108.6,304,206,98
060990008053,253.8,143.7,89.2,344,195,149
060990008052,521.9,277.3,215.9,499,282,217
060990014002,393.4,230.6,134.8,351,221,130
060990014003,111.6,65.4,38.2,128,79,49
060990014004,616.8,319.3,258.4,712,402,310
060990014001,676.5,350.2,283.4,714,401,313
060990014005,265.6,137.5,111.3,142,83,59
060990008051,550.5,265.8,241.9,567,309,258
060990008054,530.5,256.2,233.1,503,267,236
060990017002,131.8,104.3,16.7,74,60,14
060990018002,268.5,158.3,87.7,299,203,96
060990018001,169.8,100.1,55.5,204,108,96
060990021001,235.6,173.3,50.4,208,150,58
060990018003,109.7,64.7,35.8,1,1,0
060990013004,657.5,340.2,264.1,717,379,338
060990013003,539.6,277.7,218.5,494,262,232
060990013006,402.5,216.1,152.6,461,272,189
060990013002,300.0,159.3,115.8,317,183,134
060990012003,807.5,433.6,306.1,733,431,302
060990013005,448.8,201.0,221.7,531,276,255
060990013001,482.2,216.0,238.3,410,220,190
060990008015,594.3,277.5,278.6,660,321,339
060990008013,380.5,177.7,178.4,439,210,229
060990008014,738.2,344.8,346.1,653,317,336
060990010022,466.6,241.9,188.3,476,261,215
060990010023,284.8,147.5,115.3,269,139,130
060990012002,425.4,220.6,171.7,424,267,157
060990012001,270.7,138.8,111.1,337,190,147
060990011003,345.9,174.7,145.2,313,176,137
060990011004,309.0,156.1,129.7,333,197,136
060990011002,415.5,209.9,174.4,268,155,113
060990011001,342.1,172.8,143.6,367,193,174
060990010021,337.4,170.4,141.7,384,206,178
060990009092,617.4,275.6,294.7,565,276,289
060990009073,441.7,197.2,210.9,499,260,239
060990009091,616.6,285.6,283.2,739,374,365
060990009093,365.7,172.4,164.7,294,153,141
060990008072,818.0,391.8,374.2,678,363,315
060990008071,393.0,188.2,179.8,467,216,251
060990005042,726.7,337.6,351.7,831,353,478
060990005043,610.7,279.3,295.5,728,306,422
060990008062,740.7,368.9,328.3,718,366,352
060570002002,856.7,323.4,464.6,926,400,526
060570003002,847.0,359.5,407.3,923,427,496
060570003001,340.1,113.8,196.7,526,236,290
060570004022,994.6,369.3,552.8,889,380,509
060570002001,614.3,254.9,302.0,698,300,398
060570005023,652.6,297.7,294.3,809,443,366
060570004012,1002.4,421.4,521.9,985,409,576
060570004014,1134.0,475.2,591.4,1183,510,673
060570004013,1207.3,507.2,632.4,1021,399,622
060570004011,279.6,118.5,139.4,467,220,247
060570004024,578.1,220.7,316.7,786,376,410
060570004023,1129.3,442.0,586.4,1125,508,617
060570009002,1278.4,641.5,457.8,1132,719,413
060570008024,1549.9,826.9,595.0,1408,729,679
060570005024,552.1,253.5,241.8,508,269,239
060570005013,591.1,278.6,255.8,563,298,265
060070033003,635.1,182.5,417.3,629,217,412
060070030021,220.2,73.0,131.4,219,102,117
060070036003,632.8,96.2,505.6,656,172,484
060070032002,544.9,158.4,347.7,465,168,297
060070030022,260.7,86.3,153.2,248,117,131
060070032003,439.1,137.6,275.4,475,188,287
060070032001,399.3,123.0,250.4,296,138,158
060070029001,557.5,195.6,326.5,442,208,234
060070037001,460.2,165.6,262.1,504,217,287
060070037003,412.3,139.4,243.9,444,193,251
060070037004,320.3,109.1,187.2,294,128,166
060070029002,392.8,137.1,222.6,390,155,235
061150402001,554.7,191.9,324.1,603,220,383
061150402004,359.5,132.2,204.3,324,133,191
061150401002,220.7,93.2,112.7,211,114,97
061150401001,210.0,66.5,129.9,437,166,271
061150410004,557.1,103.9,428.1,426,91,335
061150402003,330.1,108.0,195.3,314,139,175
061150407002,641.4,242.2,347.4,552,252,300
061150406004,235.1,89.6,130.7,225,98,127
061150406005,295.7,119.0,149.3,209,97,112
061150406003,398.3,151.7,221.4,422,187,235
061150407003,226.9,81.7,127.3,233,94,139
061150406002,252.8,112.3,125.9,294,130,164
061150405003,232.8,102.3,116.8,208,88,120
061150405002,327.3,130.5,174.4,292,143,149
061150406001,340.0,137.8,179.5,321,167,154
061150404003,421.5,165.5,230.6,391,185,206
061150403021,350.0,149.2,164.4,351,185,166
061150403031,1656.4,719.0,804.2,1265,625,640
061150403032,381.2,170.0,178.2,362,151,211
061150408001,872.3,227.6,579.7,803,309,494
061150409012,459.9,133.9,287.8,440,175,265
061150405001,273.4,106.1,147.9,257,126,131
061150403011,700.8,281.5,362.8,587,296,291
061150409011,604.7,141.4,417.7,608,185,423
061150402002,484.7,171.5,279.7,569,255,314
061150402006,306.3,107.6,170.7,271,122,149
061010507011,751.7,333.8,373.2,821,364,457
061010507022,652.0,286.1,329.3,628,255,373
061150410005,423.6,95.0,304.2,288,76,212
061150410003,712.6,125.1,553.7,692,213,479
061150409021,66.5,24.6,29.9,107,53,54
061150409023,28.0,10.4,12.6,88,46,42
061150409022,5.5,2.0,2.5,33,12,21
061150410002,826.9,173.9,601.3,824,253,571
060610213222,7184.6,3311.4,3469.4,2168,908,1260
060610231002,1498.6,653.0,753.4,542,240,302
060610231003,1178.5,495.6,600.1,746,329,417
060610231001,1042.2,453.9,530.3,1071,501,570
060610230001,1424.0,629.0,688.0,1452,637,815
060610233002,1124.6,405.7,620.3,473,210,263
060610232001,2086.0,816.0,1115.1,1866,877,989
060610234001,1690.5,559.5,1018.0,1255,510,745
060610234002,444.3,152.9,263.5,325,146,179
060610239001,1418.2,465.6,859.9,1367,525,842
060610213221,334.1,62.3,253.5,285,68,217
060770050013,939.5,212.7,676.2,950,221,729
060990040001,420.7,84.4,313.2,380,72,308
060990040003,602.8,170.0,404.5,572,185,387
060770049023,566.0,145.0,388.6,483,149,334
060770050041,1049.8,267.6,725.0,960,279,681
060770050043,767.6,217.6,502.2,748,268,480
060770050042,753.3,243.1,457.7,683,303,380
060770050012,446.6,122.0,291.1,404,134,270
060770050011,1092.6,271.1,757.1,1203,351,852
060770050032,2335.4,644.1,1569.8,1859,613,1246
060470021001,476.7,164.2,292.2,448,204,244
060470021002,211.5,76.1,124.7,120,57,63
060470023024,804.4,421.1,325.0,666,419,247
060470024011,465.0,125.4,317.6,502,222,280
060470023011,1321.0,690.6,562.7,998,614,384
060470021003,370.6,194.9,151.8,143,72,71
060470020002,493.0,194.7,275.2,442,211,231
060470020001,378.6,144.6,204.1,405,182,223
060470022025,922.1,618.9,241.7,610,441,169
060470022014,257.7,151.8,88.9,150,104,46
060470022023,370.4,263.3,90.0,269,185,84
060470023013,530.1,212.6,287.9,427,211,216
060470023012,708.6,250.9,428.4,891,393,498
060470022015,382.8,231.3,128.4,404,232,172
060470022011,145.9,90.5,47.1,228,171,57
060470022013,256.8,155.5,85.7,180,114,66
060190084022,77.9,49.7,28.2,63,43,20
060190083022,51.8,32.5,17.5,36,18,18
060470022012,261.4,160.6,88.1,130,98,32
060470022024,185.9,121.0,55.3,103,77,26
060470022022,375.2,244.3,111.5,378,251,127
060990033002,590.3,300.4,264.5,432,219,213
060990034001,273.4,112.2,150.8,265,112,153
060990034002,172.3,58.1,105.9,148,59,89
060990035002,261.4,133.5,113.0,215,103,112
060990035004,702.7,401.1,255.9,639,394,245
060990035003,498.0,284.0,181.8,448,262,186
060990035001,1605.6,848.8,652.8,1189,672,517
060990032022,1547.9,972.4,487.6,1182,723,459
060990032023,2819.0,1804.2,849.5,1952,1340,612
060990032021,310.4,196.6,92.8,390,219,171
060990032024,321.2,205.5,99.4,268,186,82
060990033003,234.0,85.4,136.0,272,103,169
060990032014,189.4,126.9,51.1,211,129,82
060990032012,458.7,307.3,123.8,318,245,73
060990032011,364.6,235.8,106.9,312,218,94
060990032013,232.0,132.6,88.5,304,174,130
060990033001,244.3,143.7,93.4,270,164,106
060770055021,353.9,155.0,179.4,304,158,146
060770055022,405.3,167.1,215.4,347,124,223
060770055012,292.3,102.0,176.9,269,107,162
060770052022,2394.2,1264.8,1009.0,1941,1045,896
060770055011,388.8,141.5,228.5,384,156,228
060770051062,1703.6,810.3,801.8,1305,644,661
060770051061,618.9,206.4,377.0,455,202,253
060990016033,189.4,114.6,62.7,221,133,88
060770052101,2289.0,1469.2,684.4,1950,1252,698
060770052081,1141.4,673.6,396.0,1013,598,415
060770052102,1129.2,669.1,399.3,1003,606,397
060770052072,3987.1,2622.8,1194.7,2663,1866,797
060770052071,855.6,480.7,342.1,1242,716,526
060770052064,1040.9,641.5,351.7,874,551,323
060770052065,669.8,381.2,250.5,515,313,202
060770053071,412.8,216.5,163.0,355,207,148
060770054034,671.3,407.2,223.3,559,349,210
060770052103,585.5,359.8,190.3,470,292,178
060770052082,563.4,306.8,225.6,570,326,244
060770054032,496.0,274.7,186.1,539,313,226
060770054033,615.8,356.6,220.1,696,395,301
060770054031,455.9,272.4,148.5,355,208,147
060770053083,879.2,562.3,268.1,698,435,263
060770053081,285.4,152.3,118.7,337,178,159
060770053082,196.4,103.9,79.5,262,136,126
060770053033,176.4,103.5,57.9,152,93,59
060770053034,221.3,129.8,72.6,253,153,100
060770053072,561.2,315.4,205.5,442,268,174
060770052093,1331.1,726.8,525.3,1015,596,419
060770052083,518.6,289.3,199.4,429,281,148
060770052092,654.8,376.3,244.9,512,311,201
060770052091,753.0,434.0,266.0,669,387,282
060770054061,644.4,435.5,173.6,495,364,131
060770054051,758.6,467.5,228.4,665,427,238
060770054062,305.0,187.6,94.9,201,140,61
060770053032,201.0,117.9,66.0,231,149,82
060770053035,256.8,150.7,84.2,165,100,65
060770053031,224.3,131.6,73.6,224,129,95
060770054052,231.3,150.5,65.5,142,89,53
060770053025,369.1,208.3,137.3,461,253,208
060770053024,605.1,341.6,225.1,522,348,174
060990024021,369.9,268.1,82.8,253,194,59
060690006002,1342.2,759.3,496.2,1167,688,479
060690007021,422.1,213.2,187.7,366,210,156
060690008011,1055.5,464.5,533.1,1029,517,512
060690008023,533.6,215.9,274.5,471,200,271
060690006001,480.0,247.9,203.7,297,181,116
060690005011,1161.2,616.0,476.7,939,550,389
060690001002,703.6,351.1,310.5,752,461,291
060690005021,509.8,314.3,165.4,402,270,132
060690001001,601.0,251.3,306.9,695,315,380
060690001003,467.3,233.2,197.8,628,344,284
060690001004,298.3,125.2,151.5,300,125,175
060690008022,366.8,159.9,186.7,325,168,157
060690008021,353.1,84.6,241.8,364,128,236
060855135001,378.4,164.2,183.9,378,185,193
060014511013,503.1,167.8,299.6,556,231,325
060855125051,1422.3,1023.7,313.0,1350,1021,329
060855125061,665.5,491.2,130.5,414,343,71
060855124011,1154.7,669.7,405.9,1217,705,512
060855125063,876.0,640.7,177.9,642,492,150
060855126021,367.7,236.8,113.3,366,215,151
060855124022,374.0,233.3,121.6,317,181,136
060855124021,1286.5,702.0,497.9,1258,716,542
060855124023,527.4,278.2,218.5,443,244,199
060855125091,1197.5,827.0,309.6,924,670,254
060855125092,603.5,376.7,190.2,517,338,179
060855126042,358.9,274.0,54.4,236,190,46
060855126033,360.8,266.9,63.7,251,210,41
060855126031,183.7,138.8,28.6,157,134,23
060855125101,1412.5,823.9,508.1,854,519,335
060855126022,599.7,315.4,254.6,514,251,263
060855123073,1357.2,759.2,494.3,1295,819,476
060855123102,359.3,234.9,99.9,247,155,92
060855123091,1861.2,1099.3,623.1,1250,790,460
060855123101,1023.3,690.4,275.1,743,500,243
060855123092,1047.6,627.5,348.8,1203,692,511
060855123082,1335.3,792.1,460.9,1210,714,496
060855123083,1077.6,599.7,399.8,1275,704,571
060855123111,1681.2,1014.0,568.0,1142,704,438
060855123081,1151.5,673.5,404.7,819,477,342
060855123121,1585.1,973.9,504.8,1216,781,435
060690008012,820.0,351.6,421.1,683,286,397
060690006003,687.0,398.9,252.7,600,391,209
060690007022,1034.6,582.1,401.2,905,540,365
060690005013,469.1,269.7,165.4,400,244,156
060690006004,793.6,453.1,280.4,712,445,267
060690005023,643.3,443.1,165.2,459,322,137
060690005024,398.4,279.9,95.0,329,259,70
060855125103,952.0,597.0,296.6,619,421,198
060855125102,892.5,547.0,290.0,744,479,265
060855125032,1397.0,820.9,485.1,1417,862,555
060855125083,786.7,489.7,246.7,772,499,273
060855125081,518.5,356.1,130.4,737,497,240
060855125062,484.8,337.3,114.3,362,278,84
060855080031,564.2,423.7,109.1,394,293,101
060855125052,908.5,649.8,210.2,730,565,165
060855125082,937.7,627.3,255.6,657,424,233
060855125084,583.8,387.6,160.1,522,346,176
060855126043,154.0,107.2,36.3,146,113,33
060855126032,160.4,112.5,37.4,119,89,30
060855126041,515.4,414.3,68.0,402,334,68
060855123071,707.0,411.7,240.3,740,417,323
060530105012,1041.6,501.3,472.2,1327,760,567
060690002005,628.1,408.2,166.4,595,428,167
060690002006,334.6,175.1,137.0,301,174,127
060690002004,779.2,354.4,391.3,455,212,243
060690002003,288.6,176.5,95.7,130,79,51
060690002001,630.8,414.0,179.9,644,454,190
060690002002,123.6,57.0,60.4,203,105,98
060690003002,206.4,152.2,36.6,387,283,104
060690005022,452.6,351.0,75.9,298,257,41
060690003003,489.2,389.6,68.1,402,353,49
060690007012,415.0,338.0,59.0,223,181,42
060690003001,515.7,440.9,47.6,417,369,48
060690007011,509.8,349.9,128.9,298,231,67
060690004004,413.8,282.8,105.8,368,271,97
060690004002,268.9,171.7,76.7,261,197,64
060690004003,246.3,166.1,63.8,178,114,64
060690004005,305.0,214.3,72.7,107,79,28
060690004001,256.2,179.3,58.6,248,197,51
060690004006,376.0,268.6,84.5,275,202,73
060690007023,454.6,334.2,95.0,311,232,79
060690005012,805.9,451.5,316.9,652,414,238
060014336002,418.9,310.5,88.7,409,304,105
060014336001,330.8,245.7,69.2,365,269,96
060014332003,372.1,300.7,51.0,384,320,64
060014335002,310.7,216.5,81.1,363,252,111
060014333001,632.6,461.5,136.4,695,485,210
060014336004,590.5,438.9,123.1,567,421,146
060014336003,644.8,480.2,132.8,691,462,229
060014332004,522.1,390.7,107.3,610,459,151
060014332001,582.3,440.0,114.8,729,546,183
060014332002,784.6,619.4,124.0,614,489,125
060014337003,196.0,159.0,24.0,232,186,46
060014338004,712.3,558.0,115.2,628,472,156
060014331022,636.7,467.0,134.8,776,588,188
060014331031,701.2,582.9,88.2,707,585,122
060014330003,265.6,220.8,33.0,287,233,54
060014331032,297.4,245.9,38.0,241,205,36
060014331042,309.2,259.2,37.0,218,186,32
060014330001,508.3,406.4,81.1,527,400,127
060014330002,539.2,420.7,85.6,515,397,118
060014331041,288.4,245.1,23.5,386,338,48
060014331043,726.9,603.6,75.5,522,438,84
060014328003,485.0,362.0,87.0,448,350,98
060014331021,715.7,562.1,132.3,608,466,142
060014338003,781.9,627.9,110.8,620,490,130
060014338001,227.2,181.4,32.7,172,132,40
060014330004,322.0,231.2,73.2,360,272,88
060014507521,2630.7,1859.4,640.5,1738,1134,604
060014326005,897.8,722.5,121.6,764,640,124
060014322001,395.7,327.6,48.6,524,447,77
060014323003,1021.2,842.5,121.1,1003,809,194
060014322003,886.3,742.2,95.5,978,820,158
060014322002,466.5,386.1,59.1,442,351,91
060014326002,716.4,603.5,76.7,427,369,58
060014326001,423.8,349.8,51.4,391,327,64
060014326003,436.0,364.7,53.5,387,318,69
060014326004,290.5,243.0,35.6,290,234,56
060014327001,505.1,411.6,71.1,507,397,110
060014323002,326.9,279.8,32.5,316,270,46
060014102002,264.5,249.8,8.2,319,310,9
060014102003,299.9,283.2,9.3,289,277,12
060014102001,531.6,502.0,16.5,481,475,6
060014101001,509.3,466.4,17.0,533,516,17
060014101002,564.0,531.0,18.0,614,582,32
060014321001,964.9,817.9,104.3,775,648,127
060014321002,461.9,391.7,49.8,566,483,83
060014321003,652.2,538.3,82.9,593,473,120
060014327002,371.5,287.1,63.1,385,289,96
060014327003,446.5,344.9,75.9,411,299,112
060014328002,927.0,684.8,192.6,989,617,372
060014328001,440.0,320.2,93.4,408,275,133
060014100001,702.0,584.9,80.7,574,457,117
060014100002,1110.4,1015.8,61.0,1244,1167,77
060014100003,3.6,3.2,0.3,0,0,0
060014340002,274.1,221.5,40.3,267,205,62
060014337001,418.9,344.2,51.5,377,303,74
060014337002,282.8,232.4,34.8,229,196,33
060014340003,357.3,288.0,52.0,357,308,49
060014339004,420.3,356.8,46.6,336,294,42
060014339003,202.4,171.9,22.4,213,185,28
060014338002,631.7,509.8,85.8,585,508,77
060014339001,529.3,453.9,55.5,485,426,59
060014305001,1038.9,812.0,164.0,1114,894,220
060014339002,334.0,286.4,35.0,300,263,37
060014340001,506.0,404.0,66.0,474,396,78
060014305003,574.7,436.1,108.0,655,516,139
060014355001,308.3,219.1,58.8,330,244,86
060014356021,326.0,247.5,62.3,303,225,78
060014312003,891.1,641.8,194.4,1042,797,245
060014355003,338.2,263.3,47.3,315,259,56
060014355002,493.0,379.4,78.7,414,339,75
060014306003,1254.0,860.1,305.0,1376,959,417
060014305002,742.1,571.4,125.7,591,471,120
060014306002,440.7,311.5,101.0,452,305,147
060014306001,658.4,449.4,167.0,677,452,225
060014304001,754.8,511.6,191.8,564,381,183
060014304002,568.0,373.9,149.5,709,435,274
060014303001,915.9,571.1,278.9,906,526,380
060014301021,1352.7,864.8,405.1,1477,968,509
060014383003,313.8,263.9,36.0,269,220,49
060014383002,462.4,388.9,53.0,395,313,82
060014383001,375.8,316.1,43.1,289,248,41
060014384002,459.7,350.4,86.9,435,330,105
060014384001,381.3,290.6,72.1,385,283,102
060014382013,362.5,303.0,47.8,375,305,70
060014382012,548.1,425.5,99.5,507,382,125
060014382011,394.1,340.2,43.3,319,265,54
060530111023,1170.5,918.0,187.1,876,713,163
060530111021,631.0,493.7,96.1,582,447,135
060790100022,997.2,262.8,689.2,947,302,645
060790100023,322.6,86.7,220.4,258,78,180
060530114002,684.0,226.5,407.9,593,308,285
060790103004,1378.7,397.0,903.4,1330,406,924
060790100161,1493.7,505.9,903.8,1625,555,1070
060790103002,1455.3,420.4,951.7,1755,593,1162
060530113031,977.7,435.9,462.6,971,492,479
060530114001,628.5,161.3,437.5,781,242,539
060790101011,892.1,352.1,474.1,959,361,598
060790101022,415.7,181.0,210.3,142,91,51
060790100162,800.7,260.7,485.3,565,245,320
060790102011,1635.3,639.1,893.7,2464,1005,1459
060790101021,433.1,188.5,219.2,331,188,143
060790103001,1828.6,563.0,1167.7,1734,623,1111
060530113041,278.9,172.5,86.7,189,106,83
060530001021,683.6,506.9,134.4,515,391,124
060530001022,1168.7,862.7,236.0,907,673,234
060530001041,448.4,300.3,119.3,291,224,67
060530001042,975.3,673.4,242.7,963,666,297
060530106031,1501.3,1085.7,332.6,1324,956,368
060530106061,802.3,485.1,281.1,822,458,364
060530001011,337.4,214.2,105.3,372,248,124
060530106032,1229.5,865.5,291.8,991,714,277
060530105011,569.5,297.6,226.3,497,299,198
060530105014,845.5,422.6,368.3,471,266,205
060530001012,386.0,246.5,118.9,295,186,109
060530107021,1046.3,497.1,473.5,1402,707,695
060530110005,536.6,326.0,172.1,522,363,159
060530107012,1654.4,861.8,685.6,1652,912,740
060530107011,1087.1,489.1,521.1,1039,527,512
060530145001,326.3,205.3,100.4,187,115,72
060530009003,390.1,321.4,49.2,338,289,49
060530008003,418.0,353.8,44.0,176,142,34
060539800001,1.2,1.0,0.2,1,0,1
060530008002,256.7,214.7,32.3,258,215,43
060530008001,342.1,288.4,37.1,316,275,41
060530009002,187.6,161.8,14.9,90,76,14
060530009001,240.4,207.2,19.1,310,265,45
060530005021,412.6,340.9,48.1,355,291,64
060530006001,362.1,299.2,42.2,212,177,35
060530005022,302.9,250.2,37.3,443,321,122
060530006002,157.1,133.3,18.4,147,132,15
060530106081,184.0,148.0,31.0,133,84,49
060530006003,290.7,252.0,29.1,222,196,26
060530007011,233.5,210.5,13.8,183,168,15
060530007023,264.6,241.5,13.3,259,231,28
060530006004,147.6,134.7,7.4,215,195,20
060530007021,209.6,191.3,10.6,168,146,22
060530106071,250.4,220.6,21.3,323,293,30
060530007022,161.5,147.4,10.1,110,104,6
060530106072,181.8,165.9,11.3,86,76,10
060530106082,92.2,84.2,5.7,79,68,11
060530007012,309.0,269.9,28.0,194,171,23
060530106083,65.7,60.0,4.1,40,37,3
060530007013,284.8,251.0,22.0,91,73,18
060530106051,950.8,800.2,110.4,646,546,100
060530106042,805.3,671.2,100.1,685,555,130
060530106041,580.5,483.2,72.8,516,411,105
060530106062,926.6,779.3,103.3,626,546,80
060530108042,421.8,283.2,118.6,417,260,157
060530148003,924.0,722.6,158.7,757,597,160
060530108041,362.0,289.5,53.8,377,305,72
060530108043,496.1,388.3,89.8,360,279,81
060530109001,829.9,652.1,142.1,19,7,12
060530111011,287.0,124.5,145.1,300,141,159
060530111022,367.0,287.8,59.4,839,668,171
060530148001,278.0,167.1,100.0,256,122,134
060530148002,296.1,195.3,92.1,226,191,35
060530112041,237.0,139.3,89.7,202,100,102
060530111012,242.4,205.8,21.7,210,179,31
060530111013,462.9,392.0,42.2,371,311,60
060530112042,397.4,319.0,58.6,325,282,43
060530112032,466.8,382.5,60.5,243,207,36
060530112033,484.1,397.0,62.6,404,343,61
060530112031,328.1,268.9,42.5,243,200,43
060530112022,509.2,405.7,77.0,428,326,102
060530112021,199.2,163.5,25.7,208,172,36
060530113042,546.1,376.2,136.4,318,254,64
060530113023,495.7,340.9,123.4,360,223,137
060530113021,320.2,224.0,79.1,224,166,58
060530113032,231.8,159.4,57.7,202,89,113
060530113043,221.3,159.4,53.9,431,340,91
060530113022,128.0,92.2,31.2,227,141,86
060530112023,609.7,463.3,112.6,421,321,100
060090001222,338.2,129.6,184.2,569,275,294
060090001211,1426.7,516.5,811.0,1531,637,894
060090001212,813.5,291.2,454.1,1185,559,626
060090001223,1152.3,472.3,593.5,883,375,508
060090001201,2259.9,654.5,1478.1,2324,973,1351
060090001221,861.4,399.1,403.0,1112,547,565
060090003005,505.0,200.2,255.6,424,199,225
060090003004,858.8,335.1,442.8,776,338,438
060090004004,252.6,96.9,132.2,174,84,90
060090003001,791.8,296.6,436.7,772,386,386
060090005011,613.9,277.6,296.6,654,332,322
060090005012,1186.6,577.1,523.4,1057,515,542
060090003003,690.1,214.9,423.0,571,255,316
061090021003,311.6,129.4,160.7,324,163,161
061090021004,275.2,104.9,155.2,299,158,141
061090021005,537.9,206.5,297.3,554,279,275
061090021002,314.1,137.9,158.2,374,206,168
061090012001,351.5,153.7,179.4,409,190,219
061090022001,713.7,233.7,423.4,808,302,506
061090022007,587.6,188.4,357.8,589,232,357
061090021001,416.8,146.2,245.8,705,324,381
060090005031,404.4,195.1,180.9,473,237,236
060090005032,417.3,171.1,214.4,422,218,204
060090005033,245.5,114.0,113.9,282,132,150
061090042003,334.3,136.8,175.6,242,117,125
060750218004,664.5,606.0,32.9,655,600,55
060750218003,447.5,414.8,16.9,444,419,25
060750255002,412.1,329.0,59.6,449,361,88
060750255001,592.6,516.8,50.5,496,434,62
060750311001,668.5,605.9,34.4,567,507,60
060750217003,1051.7,945.4,60.1,1033,940,93
060750216002,1301.6,1159.6,103.6,1378,1205,173
060750216001,1222.8,1114.6,65.0,1193,1100,93
060750213002,910.6,840.6,34.7,908,838,70
060750213001,707.7,645.9,34.6,700,656,44
060750214003,811.8,747.1,30.3,815,759,56
060750214002,933.5,865.8,34.5,947,889,58
060750215003,533.4,484.3,28.2,559,516,43
060750215004,673.8,614.4,29.3,685,636,49
060750215005,666.9,609.7,32.9,627,582,45
060750254011,648.6,580.6,27.6,612,561,51
060750254031,870.3,749.4,79.3,828,710,118
060750254013,531.3,474.2,28.0,530,473,57
060750218002,705.0,656.7,24.6,668,615,53
060750218001,777.7,714.0,37.2,767,708,59
060750254032,1172.3,1038.0,79.8,937,845,92
060750215002,746.3,680.4,28.7,802,749,53
060750215001,623.4,576.4,21.7,580,553,27
060750253003,500.3,452.5,19.2,388,364,24
060750253004,907.7,828.0,30.9,833,776,57
060816138004,602.6,437.9,125.8,554,423,131
060816138001,317.4,224.7,75.4,310,231,79
060816138002,367.5,233.6,106.8,714,524,190
060816138003,686.6,511.3,123.9,680,557,123
060816137003,503.1,354.3,120.7,542,403,139
060816137002,482.9,356.7,93.3,43,32,11
060816137001,948.9,712.6,183.1,755,543,212
060816134002,427.0,282.9,106.1,453,290,163
060816097001,1175.4,854.1,258.4,1072,784,288
060816089004,258.9,183.1,63.0,453,276,177
060816132003,871.4,682.9,127.8,704,542,162
060816132004,1060.5,846.3,166.7,1104,842,262
060170314041,892.8,283.0,551.3,852,348,504
060170314051,1339.7,439.3,792.4,1412,619,793
060170313013,720.3,271.4,403.2,704,306,398
060170311002,576.8,265.8,254.9,455,261,194
060170310003,1039.4,452.7,498.9,962,453,509
060170310004,772.1,316.2,403.5,709,338,371
060170311003,911.1,358.2,490.3,989,434,555
060170310002,738.2,286.4,404.6,757,320,437
060170314063,501.3,159.6,303.6,503,199,304
060170314042,474.0,134.0,303.2,493,177,316
060170314062,1161.3,400.7,674.9,1219,529,690
060170314021,926.2,305.1,558.8,1073,461,612
060170315043,662.5,200.8,413.5,701,294,407
060170314061,395.4,120.6,245.4,465,189,276
060170313022,739.2,271.8,418.6,811,340,471
060170313012,571.1,201.0,334.1,537,240,297
060170313011,571.8,205.6,325.1,675,283,392
060170313021,473.0,166.4,269.9,537,228,309
060170313023,956.4,341.3,544.7,807,389,418
060170314064,679.5,238.2,382.3,739,304,435
061010511003,421.9,87.2,307.8,442,114,328
061010511002,298.5,69.9,212.3,342,109,233
061010509002,200.0,57.0,132.0,201,59,142
061010511001,372.5,88.9,263.9,351,88,263
061150407004,1072.7,371.0,621.4,882,428,454
061150407005,1328.3,469.8,746.0,748,373,375
060871225004,396.5,319.3,52.7,343,285,58
060530101012,518.3,383.2,101.2,377,270,107
060530101021,477.2,329.0,118.2,599,399,200
060530101011,207.1,176.2,17.8,152,128,24
060530101022,823.6,471.3,292.3,803,509,294
060530102022,677.5,404.5,226.0,542,370,172
060530102023,677.6,386.7,241.9,602,387,215
060871104002,222.5,202.3,12.4,190,175,15
060871225003,506.7,338.5,133.4,504,348,156
060871102001,553.6,414.9,105.2,490,376,114
060871101004,1282.3,942.9,285.5,1147,861,286
060871105021,621.1,518.6,76.4,443,357,86
060871222013,704.3,522.6,142.7,730,527,203
060871222011,549.1,408.4,111.1,587,431,156
060871222012,463.6,321.5,111.5,457,309,148
060871222031,1321.2,939.9,301.4,1317,953,364
060871220022,757.5,557.2,155.7,825,618,207
060871222016,953.5,673.4,220.8,822,617,205
060871222021,1420.1,1011.0,318.2,1462,1069,393
060871222015,535.2,389.1,106.8,383,290,93
060871220021,1417.1,1009.4,325.6,1515,1106,409
060871220013,402.0,293.2,78.6,415,306,109
060871224006,418.7,276.4,112.7,568,424,144
060871222014,484.9,331.3,129.2,448,331,117
060871224002,527.2,343.3,145.9,530,357,173
060871224003,849.0,537.7,251.9,896,642,254
060871210002,573.3,399.4,124.9,522,359,163
060871210003,693.9,480.2,151.9,714,531,183
060855118003,627.6,413.7,154.8,567,404,163
060855119091,1547.0,1014.3,447.7,1542,972,570
060855119101,611.4,373.6,202.5,686,385,301
060855119103,700.2,428.0,234.0,783,411,372
060855119102,426.2,244.2,156.8,405,210,195
060014420002,565.9,417.4,128.4,483,348,135
060014420001,1135.1,852.1,232.1,1194,814,380
060014411002,868.9,642.3,177.6,953,683,270
060014401001,923.1,681.6,193.0,844,616,228
060014507013,1728.9,970.6,623.3,1946,1042,904
060014351031,1539.5,1115.2,331.9,1307,938,369
060014351021,1005.0,750.7,194.6,909,733,176
060014351041,666.7,506.1,111.6,666,533,133
060014380001,801.4,599.1,148.0,800,556,244
060014351033,269.2,200.6,57.9,274,194,80
060014301013,1005.0,681.2,257.0,1384,942,442
060014506012,1349.8,822.3,453.6,1451,780,671
060014351032,1444.1,1071.8,311.0,1363,982,381
060014505022,1452.6,978.2,373.7,835,532,303
060014505021,1198.6,729.4,371.8,1378,842,536
060133451151,2024.0,1271.7,634.4,1904,1098,806
060133452021,1666.6,1059.3,500.5,1815,1120,695
060014506011,402.0,244.2,126.8,431,277,154
060816032004,516.2,388.6,104.2,415,332,83
060816032001,686.1,512.4,130.1,723,541,182
060816032003,601.9,436.6,133.9,528,401,127
060816033001,926.9,678.7,181.7,942,725,217
060816033002,1656.4,1194.8,369.5,1615,1205,410
060816031001,1214.8,896.8,246.5,1171,888,283
060816135022,684.8,512.3,136.0,526,396,130
060816136004,371.5,276.4,70.5,199,164,35
060819901000,0.0,0.0,0.0,0,0,0
060816135024,785.8,599.5,144.8,750,600,150
060816135021,1036.0,773.8,210.0,1041,756,285
060816135023,984.6,735.9,203.5,793,587,206
060816136002,951.5,722.1,176.6,908,707,201
060816135012,938.2,685.8,195.2,995,685,310
060816033003,1386.0,996.9,310.8,1186,899,287
060816034002,492.9,348.0,115.5,550,378,172
060816034003,936.4,660.6,218.4,744,541,203
060816034004,975.8,696.5,223.9,720,561,159
060816031002,636.9,474.0,124.8,751,553,198
060816034001,637.0,414.9,181.3,988,710,278
060816140003,484.9,341.1,122.6,507,367,140
060816050003,1470.8,1014.1,372.7,1551,997,554
060816038021,1403.0,964.0,365.0,1334,946,388
060816039006,274.9,197.8,57.1,147,112,35
060816039004,227.3,163.6,47.2,330,236,94
060816039005,251.6,181.0,52.2,374,284,90
060816046001,611.1,397.9,181.0,739,483,256
060816039003,415.8,292.0,101.8,449,313,136
060816030003,381.8,284.9,73.4,276,228,48
060816030002,490.7,385.4,73.1,360,304,56
060816030004,556.8,435.0,84.7,561,465,96
060816030001,774.0,606.2,119.9,855,702,153
060816029001,1083.6,842.2,183.3,827,645,182
060816028001,490.7,389.4,79.9,429,342,87
060816010003,839.5,677.6,123.1,813,648,165
060816010001,820.3,670.4,121.7,764,593,171
060816010002,582.8,474.3,86.1,491,379,112
060816015011,754.1,605.2,120.6,626,466,160
060816015012,523.2,411.5,87.7,495,349,146
060750354001,579.2,459.4,85.5,569,476,93
060750354005,541.0,438.3,70.9,505,410,95
060750354004,795.6,628.1,122.2,695,555,140
060750354003,538.1,424.2,85.4,544,440,104
060750313023,1106.3,901.2,143.9,996,863,133
060750604001,649.0,482.0,122.0,655,522,133
060816009001,815.7,572.1,203.4,829,558,271
060816010004,281.8,231.6,42.0,252,201,51
060816011004,576.4,465.3,92.1,511,373,138
060816011005,499.1,400.6,81.3,496,379,117
060816011001,230.8,193.7,29.2,355,259,96
060816011002,224.0,182.8,33.5,264,212,52
060816011003,415.1,338.8,64.6,394,301,93
060770049022,552.5,164.2,359.2,434,127,307
060770049012,1139.6,363.4,707.4,1186,475,711
060770049013,891.3,326.1,514.9,798,305,493
060770049011,950.0,295.9,599.7,1051,403,648
060770049024,399.8,102.3,280.8,398,119,279
060770049021,692.4,175.2,473.5,642,177,465
060770048004,712.2,210.4,471.4,526,184,342
060770048001,442.2,131.9,288.5,437,148,289
060990002014,268.2,91.7,161.7,230,105,125
060990002013,390.9,133.6,235.6,353,152,201
060990002011,724.4,247.5,436.7,720,261,459
060990002033,322.4,109.4,192.2,219,109,110
060770047041,469.5,144.4,298.4,362,131,231
060770048003,454.0,131.3,298.4,365,116,249
060770047042,532.0,124.1,383.9,425,122,303
060770047032,523.2,123.9,373.2,346,96,250
060770047012,676.0,201.2,445.1,716,236,480
060770047031,1092.5,280.1,758.0,958,284,674
060090002202,1739.4,471.9,1172.4,1461,520,941
060610206041,509.5,173.4,302.2,536,211,325
060610206024,1221.4,411.6,721.5,1232,475,757
060610206043,485.4,174.5,286.3,485,146,339
060610206052,1253.0,426.0,735.0,1318,495,823
060610206044,825.4,319.5,461.9,790,339,451
060610206025,1045.3,334.1,639.0,843,287,556
060670082103,662.3,261.8,352.3,631,280,351
060670082092,1215.1,505.8,629.7,1333,565,768
060670084023,1160.8,473.0,579.5,1247,539,708
060670084022,393.8,157.8,196.7,622,282,340
060670084021,823.6,361.5,388.1,872,358,514
060670084043,145.0,63.3,69.3,480,223,257
060670085011,1007.8,492.0,437.2,782,402,380
060679883001,765.3,329.5,369.1,35,16,19
060670082102,1229.4,528.3,621.3,1170,490,680
060670082101,1438.3,555.6,800.7,1510,552,958
060670085062,294.7,152.1,122.7,316,169,147
060670085052,347.4,179.3,144.6,567,261,306
060670085061,601.1,310.2,250.3,435,254,181
060670085051,451.7,206.5,210.5,568,234,334
060670085013,934.9,398.5,461.8,928,411,517
060670085012,1595.0,716.1,745.6,1308,531,777
060670085102,1367.1,614.4,655.6,1091,481,610
060670085101,1314.3,590.8,644.8,1235,539,696
060670085091,1418.3,683.1,634.7,2068,971,1097
060670085092,908.1,437.6,412.8,727,350,377
060610206011,823.0,316.0,455.0,818,353,465
060610206013,1354.1,538.5,737.0,1426,617,809
060610206012,2070.1,805.4,1142.9,2110,781,1329
060610211091,1289.1,517.4,691.4,1414,537,877
060770050031,443.8,105.0,322.5,354,94,260
060670051021,573.7,390.7,156.3,590,387,203
060670051022,899.3,462.3,397.7,996,517,479
060670092011,251.4,114.9,127.6,265,113,152
060670052051,325.7,205.0,101.2,124,76,48
060670030001,410.5,297.4,84.3,415,280,135
060670031011,296.4,209.4,66.6,323,228,95
060670092012,1450.0,834.5,531.7,512,235,277
061130103101,996.4,646.3,271.0,950,599,351
061130103103,300.6,193.7,83.4,321,196,125
061130104012,1083.4,791.0,192.7,1315,888,427
061130101021,425.5,192.5,206.6,485,246,239
061130105051,312.7,211.6,77.1,610,399,211
061130112063,2064.8,1348.9,576.5,702,433,269
061130105052,37.0,21.1,12.5,51,30,21
061130112062,1179.7,469.4,638.6,1224,500,724
061130103102,627.4,385.0,198.7,617,436,181
061130103121,1035.8,615.0,349.0,1105,671,434
061130102034,92.3,53.6,32.0,210,112,98
061130102033,284.2,165.2,98.5,187,117,70
061130102031,265.6,155.0,91.4,172,115,57
061130103123,562.6,294.6,236.4,440,236,204
061130103122,705.2,391.5,262.9,751,461,290
061130103021,529.4,303.4,186.7,462,291,171
061130101024,716.8,464.6,209.0,599,401,198
061130101012,342.4,207.5,116.5,403,291,112
061130101022,355.7,211.4,122.4,303,176,127
061130101023,283.0,185.3,79.1,309,206,103
061130101011,394.3,249.2,116.6,382,268,114
061130101013,892.6,588.3,242.8,629,455,174
061130102032,429.5,288.5,110.2,293,197,96
061130102041,608.3,408.7,156.0,694,454,240
061130103022,999.1,590.0,347.9,751,448,303
061130103023,2167.3,1404.9,630.7,1423,890,533
060670022003,434.2,343.1,66.2,398,325,73
060670022004,523.8,413.9,79.8,578,444,134
060670022001,450.1,392.9,37.5,453,395,58
060670022002,210.9,184.1,17.5,149,133,16
061130102012,540.1,305.5,199.4,559,349,210
061130102043,670.5,383.0,245.1,746,432,314
061130102011,632.4,393.7,199.6,577,374,203
061130102042,310.5,186.0,107.8,284,171,113
060670021001,379.9,293.7,42.8,307,273,34
060670021003,293.3,225.4,35.8,202,167,35
060670023004,402.0,296.9,73.7,428,329,99
060670020003,382.8,303.5,45.0,242,195,47
060670023001,382.7,286.3,63.8,419,330,89
060670020002,503.6,389.7,64.2,354,295,59
061130101014,439.0,312.0,98.8,180,129,51
060670021002,289.9,228.9,31.4,213,173,40
060670008001,267.0,197.7,49.2,232,172,60
060670008002,526.0,389.4,96.8,432,320,112
060670070201,1182.2,790.6,312.9,1165,745,420
060670070161,908.6,644.5,208.2,594,444,150
060670070151,1535.2,1057.3,416.4,948,668,280
060670070171,466.5,285.3,152.5,427,252,175
060770046001,640.7,195.4,412.4,765,289,476
060670094081,802.0,308.6,447.9,562,236,326
060770036012,390.4,142.9,235.7,433,173,260
060770036013,273.7,98.8,162.1,288,113,175
060770035004,486.0,166.0,302.0,490,164,326
060770036011,337.1,121.1,195.1,335,133,202
060770036021,262.0,66.4,185.5,385,115,270
060770036022,463.5,128.2,314.8,338,121,217
060770047044,480.1,163.3,289.1,369,124,245
060770041022,523.5,178.8,319.8,361,154,207
060770041023,2017.3,1305.6,626.9,1261,799,462
060770044021,1154.3,512.0,581.4,1117,509,608
060770041021,559.7,169.8,362.6,491,148,343
060770044041,116.9,77.6,30.5,312,157,155
060770047043,674.8,174.2,470.4,461,133,328
060770046002,895.2,259.2,587.4,684,209,475
060770048002,698.7,181.1,481.7,677,224,453
060670094062,631.2,187.5,408.8,582,183,399
060670094061,483.1,140.8,312.9,484,160,324
060770047011,426.3,127.6,280.0,435,136,299
060670099002,350.6,158.4,174.8,542,233,309
060670099001,494.2,253.0,211.7,351,181,170
060670040121,1384.9,937.2,375.1,1262,841,421
061130104013,592.9,245.5,296.7,620,234,386
060670099004,225.2,97.8,115.1,221,113,108
061130104021,722.9,432.5,243.7,462,267,195
061130104022,1028.3,616.0,345.5,705,458,247
060670096182,1145.0,791.0,283.0,1045,713,332
060670040094,643.1,455.4,158.4,619,457,162
060670040112,943.8,639.8,266.9,845,545,300
060670040111,670.7,473.3,169.5,757,477,280
060770051132,946.0,465.0,434.0,900,502,398
060770051131,1477.6,653.1,745.5,1335,667,668
060770051342,869.9,385.2,419.2,861,408,453
060770051352,1294.2,597.2,617.3,1169,629,540
060770051251,384.9,165.7,190.2,386,192,194
060770051343,359.1,154.6,177.4,328,161,167
060770051252,357.0,153.7,176.4,316,162,154
060770051351,2601.0,1181.0,1322.0,694,299,395
060770051262,924.6,474.2,389.5,830,457,373
060770051261,255.4,142.8,98.5,318,181,137
060770051101,355.1,156.7,178.2,364,182,182
060770051313,628.4,258.2,333.3,493,197,296
060770038033,247.9,119.1,111.9,336,162,174
060770051312,551.0,159.0,365.0,478,167,311
060770051311,295.3,155.4,128.2,259,143,116
060770028001,1104.3,879.5,181.1,737,570,167
060770021002,614.8,499.3,89.3,467,363,104
060770037001,287.6,165.1,111.0,322,180,142
060770037003,185.2,106.3,70.9,211,116,95
060770015002,410.3,270.9,119.8,377,249,128
060770015001,653.7,516.8,116.4,489,370,119
060770017001,190.8,128.3,53.8,166,104,62
060770035003,4440.6,3215.1,1072.3,3171,2167,1004
060770036014,356.3,143.1,194.8,405,163,242
060770017002,249.0,177.0,59.0,211,159,52
060770051142,2494.7,1396.6,961.1,1110,597,513
060770051331,409.7,171.3,216.5,396,193,203
060770051332,601.6,260.1,307.7,601,307,294
060770051323,312.0,165.3,126.6,250,137,113
060770051322,309.0,163.7,125.4,315,165,150
060770051231,1042.0,554.9,429.2,970,546,424
060770051242,315.1,177.4,120.4,329,193,136
060770051083,522.9,279.3,214.9,356,238,118
060770051241,755.9,393.8,323.6,682,365,317
060770051321,230.4,123.0,91.1,207,108,99
060770051333,190.6,101.8,75.4,167,88,79
060770051334,213.9,114.2,84.6,200,98,102
060770051081,425.5,228.5,172.7,552,306,246
060770051082,221.6,119.0,89.9,208,130,78
060770051092,373.1,176.4,159.8,352,198,154
060770051091,473.3,213.5,218.3,411,194,217
060770051105,729.4,318.2,353.5,671,298,373
060770051221,1965.3,1017.8,838.9,1278,689,589
060770051093,210.2,96.6,101.6,154,87,67
060770051104,296.8,136.4,143.4,327,185,142
060770051102,559.3,236.8,281.5,646,358,288
060770051103,177.3,97.8,73.4,208,114,94
060770051341,612.3,299.5,279.5,607,334,273
060770040011,425.5,183.1,221.4,455,219,236
060770040012,284.8,141.2,128.9,348,175,173
060770041062,425.1,109.7,296.6,441,129,312
060670096381,2777.2,1702.9,929.8,521,209,312
060670095011,413.9,158.4,226.0,331,130,201
060770051191,2479.0,1701.0,669.0,850,557,293
060770051192,188.4,110.2,67.1,255,119,136
060770051292,625.3,391.2,196.3,697,425,272
060770051291,351.2,230.4,105.2,309,196,113
060770051301,273.5,166.3,87.4,205,141,64
060770051302,658.2,390.1,222.7,504,291,213
060770051141,1179.3,605.1,524.3,1147,618,529
060770053054,399.7,240.5,141.5,334,195,139
060770053052,418.7,259.4,137.6,342,225,117
060770053053,610.3,371.2,207.9,599,357,242
060770053023,320.1,204.5,98.5,305,185,120
060770053051,470.9,300.8,144.9,368,236,132
060770053022,268.8,169.3,83.6,390,247,143
060770053021,335.5,203.9,107.2,272,168,104
060770031141,2051.6,1143.8,802.3,1828,1014,814
060670098001,712.5,347.6,318.0,815,414,401
060670099003,253.4,115.9,122.4,230,113,117
060770040021,4170.0,2503.0,1462.0,3330,1974,1356
060770032153,373.7,270.9,77.1,403,296,107
060770032151,516.3,310.1,186.9,453,247,206
060770032152,411.0,225.0,158.0,443,247,196
060170306034,57.7,25.0,27.0,114,55,59
060170319001,44.4,19.6,20.6,28,9,19
060170314023,904.4,270.3,570.2,794,314,480
060090005042,141.5,71.9,60.0,107,54,53
060090005041,255.8,125.9,112.8,261,152,109
060050001021,500.8,192.1,288.2,502,241,261
060050001022,322.2,108.9,191.8,487,214,273
060050002003,494.2,196.4,261.1,506,235,271
061090031005,370.8,133.8,211.7,351,160,191
061090032004,243.0,77.5,144.9,789,325,464
060430004001,542.1,410.1,75.7,662,554,108
060030100002,342.8,189.4,123.4,334,218,116
060030100001,257.2,144.6,93.6,334,199,135
060170305051,422.9,245.3,134.8,493,318,175
060170306021,402.9,106.0,260.1,461,171,290
060610202001,1379.9,384.2,887.6,1363,555,808
060610202003,273.1,91.0,160.8,272,114,158
060610220131,362.2,111.0,230.6,406,165,241
060610220141,176.4,127.8,37.2,228,166,62
060170320002,58.8,42.5,14.2,95,51,44
061030001002,835.7,204.0,580.8,977,363,614
061030001001,394.7,110.5,244.8,619,245,374
061030009003,515.8,148.6,332.9,536,190,346
060070016001,650.1,272.9,324.7,792,416,376
061030001003,409.7,106.7,285.3,314,114,200
060890126034,513.5,123.2,361.2,416,138,278
060890122001,755.8,155.5,570.5,717,215,502
060890126042,810.6,183.4,586.3,582,195,387
060890123032,756.6,158.2,559.2,728,244,484
060890122002,345.2,75.1,251.4,367,117,250
060890120004,492.1,133.0,322.5,563,213,350
060890122003,560.6,118.1,415.8,578,178,400
060890121022,411.3,111.7,269.2,348,143,205
060890126013,1085.1,265.4,757.2,895,211,684
060890119003,583.7,131.0,425.0,831,239,592
060890126041,455.5,121.0,308.0,453,181,272
060890126033,531.4,148.8,353.4,431,170,261
060890126032,672.0,181.5,453.5,775,304,471
060890126031,466.9,144.0,295.3,642,257,385
060890118012,496.2,114.1,359.0,572,181,391
060890118011,678.2,156.9,491.1,792,235,557
060890127012,307.3,78.9,210.5,276,86,190
060890127013,511.5,131.3,350.4,580,201,379
060930010005,725.3,326.1,334.2,617,327,290
060890125001,303.5,124.0,160.7,389,212,177
060890125002,414.0,134.1,262.7,388,155,233
060930010001,187.9,102.4,60.1,278,174,104
060930009003,223.0,105.5,99.3,149,91,58
060530105041,614.4,462.6,114.1,478,353,125
060530103061,490.6,257.3,201.4,565,342,223
060530003002,647.9,429.3,176.3,617,428,189
060530003001,668.1,442.7,181.7,573,409,164
060530105042,664.2,496.6,121.1,641,475,166
060530105062,522.2,360.7,126.4,390,280,110
060530105052,526.6,385.6,107.3,642,461,181
060530105061,465.5,340.9,94.9,276,217,59
060530002002,372.0,267.8,84.3,516,359,157
060530002004,412.9,297.3,93.6,342,289,53
060530002001,504.2,363.0,114.2,327,257,70
060530002003,467.9,342.8,99.0,389,311,78
060530001032,600.2,430.6,144.7,495,381,114
060530001031,560.8,402.4,135.3,433,304,129
060530001023,1060.8,798.4,214.7,1072,766,306
060530105051,486.8,347.8,103.4,488,355,133
060530103051,656.3,375.0,236.3,667,429,238
060530105013,494.4,241.5,220.2,593,329,264
060530147002,816.6,497.2,274.5,958,587,371
060530147003,510.3,300.0,175.7,385,251,134
060530102021,365.8,250.1,91.7,516,356,160
060530103052,944.0,532.8,342.9,953,593,360
060530147001,431.2,271.3,129.7,331,223,108
060530103053,389.2,218.6,142.1,370,231,139
060530146012,425.6,299.1,98.8,539,406,133
060530146013,370.1,261.6,85.4,301,230,71
060871223001,205.3,141.2,50.9,288,194,94
060530146011,651.1,455.5,155.5,406,337,69
060871104001,274.2,248.1,17.0,381,340,41
060871103002,300.9,261.6,25.2,179,155,24
060871103003,302.6,260.4,32.7,183,165,18
060871103004,394.2,347.3,34.8,250,229,21
060871102002,363.6,310.8,33.9,402,314,88
060871103001,280.2,239.6,28.3,196,179,17
060871102003,326.9,270.8,37.4,298,259,39
060871105011,691.9,579.9,77.2,599,491,108
060871102004,413.6,328.9,59.6,375,287,88
060871102005,530.0,390.4,111.3,506,384,122
060871105023,345.4,288.4,42.0,304,261,43
060871101001,327.3,289.2,28.5,315,279,36
060871101002,273.0,233.0,25.0,216,174,42
060871101003,567.7,441.6,103.7,455,340,115
060855042022,876.7,603.5,218.5,835,561,274
060855024005,828.1,579.0,179.6,664,510,154
060855025001,541.0,385.5,115.7,493,373,120
060855043081,761.6,517.8,197.6,792,503,289
060855043082,627.2,456.3,139.3,692,424,268
060855120381,1151.6,849.5,252.6,901,617,284
060855120011,1266.4,907.7,275.3,1283,869,414
060855120393,711.3,510.1,162.7,657,434,223
060855120012,349.4,251.8,74.9,412,276,136
060855033341,2225.0,1518.4,616.9,1583,999,584
060855033343,1049.6,708.3,301.5,979,598,381
060855033321,1404.4,888.9,465.5,1226,708,518
060855033324,1216.9,806.0,355.0,1372,847,525
060855033323,640.5,465.3,139.0,482,301,181
060855033312,619.5,462.3,126.8,533,374,159
060855033311,1137.1,765.0,321.6,1371,932,439
060855033303,1347.8,1034.8,267.9,1177,856,321
060855033261,1768.1,1304.1,397.3,1456,1004,452
060855033301,976.1,752.0,184.0,947,688,259
060855033302,700.1,556.6,113.0,469,380,89
060855033122,875.3,587.9,248.4,756,488,268
060855033322,421.5,259.4,145.0,471,263,208
060014507012,436.8,235.7,171.9,495,246,249
060014507011,843.1,530.5,263.1,653,373,280
060530012001,872.3,515.3,298.6,870,521,349
060530012002,483.4,290.3,155.8,488,311,177
060530017001,675.3,449.7,177.1,501,355,146
060530014002,451.4,299.8,116.8,480,303,177
060530013001,622.6,449.8,130.1,344,278,66
060530014001,562.4,373.7,145.7,577,360,217
060530017002,572.9,381.6,150.5,469,345,124
060530018012,930.2,628.1,252.7,883,624,259
060530018011,426.7,320.2,82.7,307,237,70
060530018023,488.0,379.0,83.0,547,435,112
060530004003,335.1,239.8,71.1,269,196,73
060530004001,504.2,360.8,106.9,494,354,140
060530004002,623.4,488.4,101.8,508,395,113
060530018021,397.3,301.9,70.4,399,289,110
060530018022,343.7,261.2,60.9,205,181,24
060530005011,371.0,306.7,51.1,249,220,29
060530005012,268.7,222.1,37.0,164,151,13
060871202001,1729.1,1298.7,267.7,1734,1434,300
060871204003,953.1,675.9,179.4,851,671,180
060871203012,1083.9,784.5,205.1,1100,845,255
060871205003,669.4,492.8,119.4,774,636,138
060816137005,1456.0,993.9,360.6,1165,749,416
060816137004,1096.2,797.2,229.5,1077,807,270
060816135011,923.6,672.8,199.5,793,566,227
060816117001,592.9,529.9,37.9,434,418,16
060816118001,543.0,503.4,24.7,453,433,20
060816117004,0.0,0.0,0.0,2,2,0
060816117003,429.6,383.9,27.6,328,295,33
060816136003,402.5,299.6,76.4,518,405,113
060816136001,1585.2,1217.8,263.2,1515,1201,314
060816032002,395.2,299.3,80.2,397,316,81
060133551171,2603.3,2013.3,487.6,1571,1079,492
060014507442,1568.7,988.1,479.9,1029,643,386
060014507441,1350.8,856.3,402.2,1484,943,541
060014507451,1213.2,836.4,309.8,1102,707,395
060014513003,958.4,502.5,382.5,916,527,389
060014507501,1545.0,1134.0,328.0,1369,999,370
060014507511,2851.4,2136.1,599.7,589,371,218
060014507014,1341.0,788.1,468.9,1203,574,629
060014517031,717.1,398.6,258.7,764,449,315
060014517032,1290.0,731.5,461.5,1209,691,518
060014507423,833.2,483.9,301.7,772,472,300
060014513002,844.7,478.2,300.1,835,520,315
060014511022,1514.3,842.3,582.2,1635,836,799
060014511015,639.5,359.4,238.3,754,373,381
060014511021,789.2,426.2,307.2,753,408,345
060014517042,1157.6,668.7,402.7,1283,716,567
060014517041,750.7,422.8,279.3,791,437,354
060014517043,401.5,224.4,148.8,330,188,142
060014516024,870.4,429.4,367.0,834,420,414
060014517011,417.1,237.4,145.9,418,239,179
060014517012,569.0,324.7,198.8,624,374,250
060014516021,889.3,559.4,260.2,652,438,214
060014517013,401.0,229.8,139.7,339,197,142
060014516023,1012.7,562.9,375.4,961,561,400
060014516022,431.6,266.3,132.1,455,276,179
060014516012,2063.5,1126.8,783.5,1679,865,814
060014516011,704.7,423.5,213.8,705,468,237
060014513001,1260.7,694.1,471.1,1273,760,513
060014512021,1021.3,521.6,411.4,775,401,374
060014514041,723.2,449.8,205.2,747,475,272
060014514032,646.3,356.6,223.0,567,364,203
060014514031,358.5,214.2,108.0,405,254,151
060014514011,501.4,298.0,155.1,476,319,157
060014514042,470.2,268.1,150.0,340,220,120
060014514043,887.6,555.9,250.6,638,436,202
060014514013,829.0,490.2,281.5,629,390,239
060014514012,1452.9,821.6,524.2,1553,891,662
060014515011,514.2,322.8,154.0,626,396,230
060014515033,365.4,210.7,121.8,362,210,152
060014515034,387.1,231.9,123.3,301,189,112
060014515031,1651.0,958.7,571.3,1487,863,624
060014515032,513.5,300.3,169.3,400,229,171
060014515012,1791.0,1029.6,625.9,1412,789,623
060014515062,286.3,204.9,60.8,253,177,76
060014515061,867.4,537.6,261.9,875,519,356
060014515041,731.4,442.7,227.7,738,438,300
060014512011,1298.9,733.3,477.9,1244,740,504
060014512012,1167.5,649.5,415.1,1096,659,437
060014512013,586.4,324.3,211.3,559,358,201
060014512023,472.5,250.7,177.4,392,221,171
060014515052,1308.1,679.9,520.5,1313,731,582
060014515051,563.4,271.4,241.5,583,276,307
060014511012,1018.5,588.1,362.0,823,505,318
060014511011,1075.5,563.6,438.5,1119,630,489
060014511014,0.1,0.1,0.0,1,1,0
060014512022,385.1,205.5,143.7,407,227,180
060450110024,453.2,343.4,52.4,456,401,55
060450110011,1305.5,976.8,176.5,1492,1319,173
060450110022,451.7,329.4,64.6,452,365,87
060450110023,700.8,507.1,116.8,695,561,134
060450110021,429.1,297.3,85.8,578,484,94
060450110025,1050.3,694.4,239.9,1170,918,252
060450103002,874.4,541.9,263.0,964,677,287
060450105004,334.7,214.4,93.7,304,242,62
060450104001,267.2,193.3,57.4,246,184,62
060450105003,462.6,306.6,125.8,481,345,136
060450105001,380.9,253.1,106.7,334,248,86
060450104003,317.4,211.4,72.9,286,234,52
060450104002,309.3,208.9,73.5,347,276,71
060450104004,568.8,375.0,164.9,574,411,163
060450105002,323.9,209.8,89.1,343,273,70
060190062021,396.0,247.1,134.9,337,187,150
060190059062,197.8,49.1,142.7,213,60,153
060190063001,611.8,195.8,389.8,617,231,386
060190063002,368.1,96.3,247.5,392,118,274
060190059061,844.5,202.7,613.1,883,261,622
060190064041,993.8,180.4,760.7,966,272,694
060190064051,1049.3,234.3,762.9,883,234,649
060190064043,1101.4,239.0,797.1,1016,320,696
060190064053,751.5,163.2,549.0,568,166,402
060190064052,728.1,163.5,521.2,458,135,323
060190064021,83.9,19.7,59.5,113,30,83
060390001021,325.6,102.7,213.5,549,194,355
060390001031,641.8,198.7,406.7,801,333,468
060390001044,738.7,228.9,470.1,819,298,521
060390001022,350.0,115.4,215.8,361,135,226
060390001023,936.3,312.5,566.3,921,408,513
060390001081,1164.4,345.9,753.5,1208,408,800
060390001043,380.4,117.7,240.2,416,155,261
060390001024,395.4,111.2,266.7,480,158,322
060170304022,293.2,167.5,104.3,196,134,62
060170305043,365.2,206.8,128.6,445,305,140
060170305042,425.4,242.7,150.4,385,231,154
060170305041,650.5,371.2,230.0,607,387,220
060170302002,259.8,167.5,71.2,296,193,103
060170304013,243.9,134.4,90.5,265,157,108
060170304011,322.7,156.8,143.1,410,201,209
060170304012,345.5,173.6,146.8,366,234,132
060170304015,232.8,127.5,83.0,223,152,71
060170303011,320.8,197.0,96.5,214,167,47
060170303013,274.4,168.5,82.5,190,150,40
060170304014,217.0,128.6,65.2,209,145,64
060170303022,345.9,212.3,104.0,263,199,64
060170303021,341.1,209.4,102.6,249,153,96
060170303023,227.5,144.0,64.0,250,189,61
060170304024,347.8,209.7,109.7,281,199,82
060170303024,277.1,170.1,83.3,147,107,40
060170303012,419.9,257.7,128.2,276,210,66
060170302003,262.6,164.5,79.2,269,171,98
060170302004,177.5,108.7,57.2,130,82,48
060170302001,403.9,247.3,130.1,249,177,72
060170316002,170.8,105.0,52.0,131,83,48
060170316005,224.3,149.3,55.3,99,74,25
060170316004,146.8,92.0,40.7,67,52,15
060170302005,158.2,105.3,39.0,103,74,29
060170316003,27.6,17.0,7.9,85,63,22
060170316001,233.2,144.0,66.4,172,120,52
060610201061,353.6,225.2,104.0,346,237,109
060610201062,387.5,246.8,114.0,492,337,155
060610201052,472.9,329.4,109.8,475,355,120
060610201071,383.2,276.3,76.1,362,281,81
060610201051,218.8,139.4,64.3,277,178,99
060610201072,353.4,260.4,63.8,326,259,67
060610201073,221.0,162.9,39.9,105,82,23
060630005011,298.9,82.0,201.4,331,100,231
060630004002,431.5,174.3,221.8,414,222,192
060630005022,241.4,66.1,166.1,386,121,265
060630005012,661.1,181.1,449.4,665,254,411
060630005023,454.7,129.6,309.5,490,183,307
060630005021,298.0,80.1,203.5,497,181,316
060630001001,467.9,233.8,187.0,440,232,208
060630001006,425.7,189.7,202.7,427,208,219
060790127021,381.1,127.0,226.4,312,134,178
060790127024,558.6,244.0,279.1,591,296,295
060790123023,732.1,256.9,426.2,766,248,518
060790127041,1753.3,767.7,870.2,1691,771,920
060790129001,1458.4,435.2,930.9,1279,456,823
060790130002,244.7,100.4,125.0,589,293,296
060790125031,654.7,247.3,359.9,707,331,376
060790125051,1069.7,401.9,589.0,941,420,521
060790125023,1135.9,510.9,524.4,1017,483,534
060830019051,841.5,421.7,374.5,862,383,479
060830019065,367.8,216.9,123.4,543,269,274
060830018001,358.9,105.5,225.2,542,196,346
060830019053,435.8,204.6,205.9,439,217,222
060830019061,2159.6,873.4,1149.2,1020,479,541
060830019064,375.5,181.0,168.1,389,227,162
060830029321,303.5,167.3,112.7,229,158,71
060830029073,392.5,226.5,140.2,471,249,222
060790116003,769.3,399.7,309.8,815,450,365
060290033031,407.6,53.7,332.0,557,119,438
060290033042,318.6,32.1,270.9,314,81,233
060290045002,198.7,112.1,75.8,129,57,72
060290045001,108.1,95.7,9.2,80,61,19
060530115021,744.3,548.5,100.5,408,353,55
060530110003,845.8,549.0,245.1,1312,946,366
060070016004,763.3,402.6,312.2,841,420,421
060070009041,1592.9,907.0,572.7,1242,738,504
060070009042,1397.3,778.1,523.6,1499,801,698
060070009043,410.1,246.8,132.2,342,231,111
060070022004,742.4,274.2,409.5,549,258,291
060070013003,337.9,172.5,133.1,258,159,99
060070009031,364.9,193.0,129.6,436,253,183
060070009011,1414.9,698.2,609.0,1378,759,619
060070009034,586.6,317.5,216.3,483,308,175
060070011004,286.6,187.3,66.1,219,170,49
060070009033,812.2,439.5,299.5,916,506,410
060070016002,547.7,279.7,205.9,582,361,221
060070021002,406.1,157.8,215.3,269,134,135
060450102002,299.8,185.7,84.0,409,336,73
060450102004,352.3,224.9,87.4,364,299,65
060230116002,634.7,384.0,143.6,553,433,120
060230116003,600.1,345.4,162.5,554,422,132
060230115003,613.3,365.8,139.3,763,653,110
060230116001,408.6,198.8,149.7,410,297,113
060450102001,398.3,258.6,80.5,640,548,92
060230109021,259.6,105.5,111.6,399,221,178
061050004002,159.9,44.1,95.0,138,69,69
061050004001,164.2,40.9,104.9,320,135,185
061050003001,326.1,130.8,164.2,404,186,218
060230012002,527.2,318.4,150.0,842,580,262
060230109022,378.9,144.7,205.5,413,180,233
060855123132,584.1,370.7,168.7,474,307,167
060855123131,708.3,454.2,196.3,582,402,180
060855123072,1262.8,720.4,440.1,1162,713,449
060855123143,658.6,428.7,186.1,558,371,187
060855123142,314.1,194.6,96.1,288,209,79
060855123144,357.3,234.3,99.1,285,198,87
060855117071,1597.5,1138.7,357.5,1748,1127,621
060855077034,588.3,446.7,104.7,483,341,142
060855077023,1175.0,877.4,247.2,1172,852,320
060855077035,529.3,405.2,90.8,532,412,120
060855117043,1117.9,740.8,302.1,1089,650,439
060855117012,1116.7,759.5,270.6,1303,805,498
060855117041,1345.3,935.0,326.2,1497,970,527
060855117021,1133.8,811.9,256.2,1060,676,384
060855117022,448.0,322.1,100.6,475,318,157
060855102003,854.8,626.1,180.1,928,607,321
060855076001,420.5,286.2,109.5,511,295,216
060014324003,594.6,469.6,89.1,1077,821,256
060014324001,473.4,366.4,86.9,509,396,113
060014090004,0.0,0.0,0.0,0,0,0
060014090003,494.6,458.7,17.0,577,563,14
060014090002,1.4,1.3,0.0,6,6,0
060014090001,556.9,504.2,27.8,487,464,23
060014088002,295.4,279.7,8.6,189,184,5
060014095001,218.2,197.4,11.1,204,198,6
060014089001,316.7,295.8,10.9,286,277,9
060014094002,478.0,432.5,24.2,335,323,12
060014073002,342.0,294.6,18.1,300,287,13
060014091001,319.3,288.7,15.0,267,260,7
060014089002,423.6,396.3,15.2,393,382,11
060014334001,407.6,315.7,73.4,356,245,111
060014334002,449.1,347.9,80.9,444,311,133
060014324002,765.0,576.0,153.0,255,196,59
060014334003,354.2,274.4,63.8,415,303,112
060019900000,0.0,0.0,0.0,0,0,0
060014334006,511.2,380.1,109.3,566,383,183
060014334005,367.6,263.6,87.5,352,239,113
060014335004,396.3,274.7,107.2,419,264,155
060014333004,596.6,448.4,109.6,617,456,161
060014333003,414.3,300.4,85.7,439,311,128
060014333002,443.4,326.9,98.1,349,248,101
060014325011,329.9,259.5,49.2,389,302,87
060014325013,795.4,629.9,130.6,747,618,129
060014325012,261.6,205.8,39.0,196,154,42
060014325021,606.1,493.7,78.2,715,584,131
060014325022,228.1,181.5,32.4,321,248,73
060014092001,532.0,493.4,19.0,622,617,5
060014092002,358.0,324.6,17.0,260,243,17
060014091002,297.7,269.3,14.0,321,319,2
060014094003,256.6,235.5,10.7,219,219,0
060014093003,322.2,302.9,8.8,293,287,6
060014095003,194.2,177.7,8.6,180,170,10
060014095002,259.1,236.6,11.7,229,221,8
060014325023,574.8,502.8,50.4,311,269,42
060014093004,229.3,213.8,7.7,194,186,8
060014093002,336.0,313.1,11.5,378,370,8
060014093001,325.5,308.9,6.6,335,328,7
060014323001,434.9,372.2,43.2,372,321,51
060014104002,427.7,394.2,14.7,391,385,6
060014104001,276.1,257.1,7.3,390,379,11
060014104003,642.1,595.1,19.4,538,508,30
060014103001,206.8,191.7,6.6,215,211,4
060014103003,291.7,270.3,9.3,218,210,8
060014103002,242.5,224.7,7.7,240,237,3
060871012003,577.0,446.0,88.5,685,559,126
060871012001,676.0,542.2,89.6,498,433,65
060871005001,676.9,566.7,71.1,746,637,109
060871006002,648.9,551.7,58.3,662,588,74
060871005002,1119.4,943.1,112.8,1029,893,136
060871012002,646.7,523.1,72.8,630,553,77
060871011001,637.6,518.8,68.7,627,564,63
060871011004,1052.3,860.2,116.0,1081,943,138
060871011003,541.8,456.7,42.3,485,441,44
060871011002,539.0,452.8,46.4,581,526,55
060871010005,372.7,312.5,33.9,349,321,28
060871011005,635.8,534.6,53.5,561,506,55
060210105013,309.8,150.2,143.0,247,130,117
060210102003,246.5,66.0,165.0,294,97,197
061030010001,286.6,79.8,193.9,286,86,200
060210105012,271.9,55.6,207.2,295,86,209
060210105011,362.7,264.2,81.8,392,295,97
060210105022,292.3,47.3,232.5,217,57,160
060070004021,1458.4,623.5,714.8,1682,718,964
060070014003,467.1,151.7,283.1,576,213,363
060070014001,1128.2,367.3,680.8,1215,450,765
060070004011,1319.6,546.8,652.2,636,277,359
060070014002,686.7,279.9,355.2,888,401,487
060070005011,500.4,206.4,251.4,466,204,262
060070002012,293.1,138.5,129.0,359,181,178
060070034001,415.7,122.3,269.6,535,166,369
060070034002,546.4,131.5,385.9,512,155,357
060070035021,452.8,121.3,310.6,430,126,304
060070035011,350.8,109.5,224.2,430,129,301
060070015004,401.2,128.5,244.5,387,138,249
060070035013,232.2,109.6,107.7,264,119,145
060070035023,399.9,200.2,174.5,343,187,156
060070035022,372.0,168.3,180.5,297,158,139
060070036002,399.5,137.6,243.3,412,146,266
060070036001,291.1,92.5,184.7,290,113,177
060070035014,225.6,93.7,116.9,236,104,132
060070035012,277.4,116.5,142.4,290,140,150
060070035024,377.5,158.5,193.8,316,155,161
060070015005,309.3,98.6,190.7,245,81,164
060070015001,615.4,213.0,356.9,668,234,434
060070015003,871.1,309.4,503.6,1031,344,687
060070015002,597.8,189.4,358.3,473,176,297
060070012003,258.2,136.0,95.6,326,219,107
060070011003,253.9,161.6,62.0,518,403,115
060070011002,638.2,266.3,325.7,530,313,217
060070005021,426.6,231.9,158.8,402,234,168
060070005023,491.5,349.8,90.7,468,367,101
060070005013,459.6,232.6,191.8,585,300,285
060070005012,715.7,357.4,301.9,510,286,224
060070005014,396.9,285.5,67.9,614,473,141
060070005022,169.9,125.9,24.9,136,111,25
060070006011,434.7,207.5,184.3,522,312,210
060070006013,695.5,354.3,268.3,716,424,292
060070004022,985.3,522.5,388.6,984,551,433
060070004024,531.4,235.2,253.3,513,248,265
060070004023,645.3,343.3,252.6,629,356,273
060070005024,403.7,297.1,63.5,471,373,98
060070011005,144.3,99.8,25.6,189,154,35
060070011001,226.9,157.0,40.2,240,198,42
061010505031,333.4,103.2,215.1,450,138,312
061010505041,714.8,338.7,340.2,777,405,372
061010510002,715.5,185.1,492.6,561,189,372
061010505033,782.4,401.1,344.9,548,305,243
061010505042,369.4,136.8,215.1,387,173,214
061010504022,1088.0,454.6,567.9,930,411,519
061010510001,320.6,108.7,195.3,327,133,194
061010504031,1177.4,504.8,591.6,1151,541,610
061010505043,1330.1,700.6,571.6,1215,608,607
061010505034,352.0,170.5,162.7,353,140,213
061010505032,614.0,290.3,290.8,484,247,237
061010505035,528.5,234.0,260.1,536,234,302
061010505044,371.3,172.1,177.3,354,179,175
061010503011,382.3,126.7,217.3,380,131,249
061010503012,627.2,220.8,346.8,682,246,436
061010504021,564.8,152.7,377.6,601,176,425
061010504011,567.0,203.4,329.3,473,203,270
061010506013,1192.9,482.6,655.6,1074,430,644
061010506012,975.2,331.2,592.8,898,298,600
061010506011,558.9,175.5,353.4,602,228,374
061010505012,245.7,117.8,114.8,277,104,173
061010506032,452.1,145.0,285.0,583,207,376
061010505014,669.5,415.4,218.5,550,320,230
061010502012,382.8,182.3,172.2,364,173,191
061010505011,362.0,110.1,233.8,456,151,305
061010505013,616.0,340.3,247.7,354,204,150
061010506034,828.6,283.0,504.0,704,272,432
061010506033,483.9,172.5,279.8,673,246,427
061010502011,416.5,173.3,207.2,332,169,163
061010501021,515.1,196.7,285.8,480,200,280
061010506041,462.1,162.0,266.0,385,163,222
061010506042,1411.2,529.0,802.8,1510,565,945
061010501013,324.3,114.4,188.6,134,75,59
061010501011,1012.0,352.1,590.0,1079,435,644
060110005001,190.5,66.9,111.5,142,57,85
061010507023,366.3,100.0,249.8,419,119,300
061010508001,1194.0,233.9,894.7,1062,280,782
061010506031,330.9,108.5,205.2,351,137,214
061010507021,884.5,465.3,360.0,637,403,234
061010507012,542.3,261.0,245.1,553,286,267
060110004001,327.1,72.2,240.8,135,37,98
060210103002,414.2,77.4,316.1,396,110,286
060210105021,315.7,63.9,237.6,355,109,246
060210104007,252.6,83.9,154.0,230,87,143
060210102002,720.8,194.7,483.1,691,244,447
060110002003,461.6,199.6,235.8,468,208,260
060110002005,274.0,79.9,175.8,119,44,75
060110002004,327.5,101.6,204.1,457,171,286
060110002001,390.4,159.5,207.5,393,181,212
060110005003,272.6,93.4,161.8,317,92,225
060110005004,200.0,76.5,111.3,184,68,116
060110002002,381.0,106.8,248.4,654,204,450
060110005002,160.3,69.2,81.8,199,89,110
061130114003,459.1,199.6,229.6,348,175,173
061130114002,479.0,240.2,212.9,214,127,87
061130112061,307.0,161.4,122.3,287,135,152
060110001001,147.1,68.0,66.4,154,69,85
061010504012,406.2,146.8,229.7,401,150,251
061010509001,277.4,53.3,209.3,292,78,214
061010508002,392.0,75.8,295.0,543,157,386
061130106023,477.2,402.3,20.7,454,411,43
061130106061,832.2,679.8,86.1,822,707,115
061130106083,254.4,203.4,35.0,327,258,69
061130106081,436.4,362.9,42.8,630,520,110
061130106082,1292.2,1060.2,144.9,896,703,193
061130106062,1109.3,885.6,145.6,872,695,177
061130105053,1828.9,1427.7,273.8,1745,1329,416
061130106064,899.4,687.7,140.8,1118,868,250
061130106072,367.2,295.5,53.2,484,365,119
061130106073,1224.3,909.6,248.1,1167,832,335
061130106071,820.4,642.1,133.2,562,415,147
061130104011,614.1,385.8,195.5,463,206,257
061130106065,543.5,435.9,72.7,375,292,83
061130106051,1247.1,976.3,193.1,1186,894,292
061130106063,516.2,412.0,70.5,625,498,127
061130106052,642.0,493.4,109.4,520,406,114
061130111022,389.0,242.0,125.0,357,240,117
061130112043,372.7,238.7,112.4,449,261,188
061130112042,777.8,397.8,322.8,746,387,359
061130111032,482.0,293.0,148.0,431,257,174
061130112053,514.0,355.0,133.0,431,278,153
061130112055,417.1,278.7,111.7,404,248,156
061130111021,829.1,535.0,228.7,655,422,233
061130111031,548.5,359.5,146.3,581,346,235
061130108003,221.7,154.9,53.2,146,99,47
061130112052,583.1,394.3,149.5,468,305,163
061130112051,984.5,659.7,263.9,599,399,200
061130112054,630.7,421.9,169.0,637,370,267
060330012003,312.7,130.1,159.0,247,157,90
060330009001,1207.3,592.5,506.0,1233,722,511
060330008022,402.4,195.9,170.0,338,236,102
060330012001,366.0,168.5,170.3,375,225,150
060330008012,439.0,219.7,173.3,452,310,142
060330013004,1455.9,691.6,661.7,1242,701,541
060816102021,1182.3,975.5,133.5,431,341,90
060816101001,1122.3,873.2,183.9,1191,899,292
060816102014,409.9,343.9,49.0,314,254,60
060816103021,1017.0,749.0,211.0,651,488,163
060816103041,858.3,632.5,187.6,917,651,266
060816103043,565.1,408.9,127.5,384,293,91
060816103042,826.8,620.7,165.6,819,614,205
060816103031,748.1,575.2,137.3,642,440,202
060816103034,697.9,530.3,133.9,753,538,215
060816103033,816.9,633.2,133.8,755,547,208
060816103032,1084.0,802.1,222.2,853,578,275
060816080011,802.4,586.9,169.4,1019,701,318
060816080131,827.4,603.2,174.5,1052,752,300
060816080012,591.0,430.4,123.7,127,91,36
060816079002,381.7,276.3,91.3,325,239,86
060816079001,517.6,377.3,120.5,577,389,188
060816079003,635.8,480.4,125.2,513,385,128
060816081001,1444.2,1066.4,313.9,1457,1010,447
060816082001,1625.0,1178.0,349.6,1558,1122,436
060816083001,793.4,575.6,185.7,968,681,287
060816083002,618.4,454.0,138.9,472,344,128
060816080041,347.3,271.3,58.8,260,197,63
060816080044,509.8,371.4,113.3,752,552,200
060816080043,752.5,567.1,152.7,438,328,110
060014286001,498.1,406.5,66.3,764,566,198
060014286002,186.4,152.3,24.7,271,231,40
060014285001,1131.0,925.1,140.8,1009,811,198
060014285002,582.0,442.4,104.6,453,319,134
060014286003,599.4,462.6,106.9,489,359,130
060014283021,1485.5,1142.9,258.7,1206,869,337
060014283014,1039.9,789.6,195.3,984,742,242
060014283022,1345.7,1045.2,242.9,1582,1147,435
060014284001,931.2,755.1,114.5,879,735,144
060014283011,1084.9,827.4,198.2,1336,971,365
060014283012,450.7,345.1,81.7,467,344,123
060014283013,716.0,594.0,91.0,480,379,101
060014283023,1502.3,1185.8,250.1,1205,873,332
060014334004,525.3,410.4,94.2,508,373,135
060952533002,599.7,249.4,313.5,398,171,227
060952529031,501.7,248.0,225.1,702,331,371
060952529042,1445.7,721.7,634.6,705,394,311
060952534025,489.9,234.9,220.2,508,281,227
060952534024,836.7,401.5,375.4,628,341,287
060952534021,507.5,307.6,167.8,492,310,182
060952534032,635.8,269.2,331.6,540,261,279
060952534023,250.1,124.5,111.3,248,146,102
060952534022,284.4,144.4,124.5,378,236,142
060952534042,456.2,232.8,198.3,449,236,213
060952534044,984.9,462.8,459.2,850,456,394
060952534043,527.5,270.5,223.3,511,267,244
060952534041,639.7,336.9,264.1,591,343,248
060952533001,433.6,170.9,237.7,577,247,330
061130105104,734.3,574.7,110.3,606,493,113
061130105081,1359.0,1096.4,184.6,1393,1111,282
061130113002,263.2,166.1,77.9,237,139,98
061130105132,823.7,686.5,82.0,513,433,80
061130105011,1158.5,971.2,79.3,879,736,143
061130105012,323.9,268.5,19.9,217,181,36
061130105131,753.0,647.2,63.3,718,621,97
061130105111,505.7,407.6,73.3,553,437,116
061130105122,1040.2,885.2,94.8,868,708,160
061130105121,796.1,648.1,101.8,686,546,140
061130107033,769.3,652.9,63.6,530,429,101
061130105112,834.3,694.2,95.0,1089,861,228
061130112031,843.0,421.0,364.0,906,448,458
061130112032,635.5,277.6,322.7,653,268,385
061130110022,575.5,251.4,292.3,638,291,347
061130110023,528.7,258.1,232.2,665,310,355
061130112041,832.5,376.7,393.8,949,440,509
061130111012,557.5,322.8,191.7,607,373,234
060133031021,2436.7,1394.2,930.0,1550,938,612
060133020082,1477.1,860.2,508.1,1256,781,475
060133020061,566.8,311.2,224.0,493,327,166
060133110002,502.5,415.0,71.8,515,433,82
060133100003,910.7,750.6,106.1,436,374,62
060133110001,251.6,197.2,41.5,247,210,37
060133100002,267.4,216.8,37.6,190,160,30
060133120001,702.0,604.0,70.0,623,564,59
060133090001,1152.6,928.4,176.3,857,686,171
060133090002,317.5,263.7,38.8,488,430,58
060133100001,371.6,301.3,47.1,395,337,58
060133050003,198.0,135.5,50.8,255,168,87
060133050005,309.8,224.3,67.5,291,219,72
060133050004,347.8,258.2,68.2,393,281,112
060133071021,147.6,106.9,32.1,149,114,35
060133050001,301.7,201.5,82.5,269,203,66
060133050002,266.6,187.0,64.2,237,174,63
060133060032,479.9,315.8,134.9,479,324,155
060133060022,661.6,436.8,186.2,597,404,193
060133060042,388.5,244.0,122.0,442,287,155
060952535001,3403.0,2027.9,1248.3,2382,1379,1003
060952527026,378.7,254.6,103.7,268,193,75
060959800001,15.1,6.2,6.2,2,2,0
060952523172,1403.2,874.3,432.7,1443,876,567
060952535004,493.1,194.4,262.0,554,241,313
060133020062,884.4,476.8,335.9,889,557,332
060133010001,425.8,183.1,218.9,524,285,239
060133010002,396.5,170.5,203.9,394,238,156
060952535003,563.9,217.6,302.4,562,277,285
060952535002,731.0,282.0,391.9,660,343,317
060952522012,418.9,172.6,219.2,545,240,305
060952522011,1518.6,927.4,492.3,1370,865,505
060133020091,1067.2,778.6,235.6,1136,834,302
060133080021,1214.1,890.5,264.0,894,639,255
060133060021,504.4,321.6,153.5,548,335,213
060133020101,1362.5,735.7,555.2,1157,685,472
060133020051,611.0,363.4,205.2,404,236,168
060133032031,3879.8,2106.4,1553.2,2902,1553,1349
060133032024,1157.9,568.4,510.5,979,570,409
060133031022,984.8,580.3,341.6,585,398,187
060133032021,348.2,186.8,138.2,204,127,77
060133020104,1155.5,609.1,476.5,899,497,402
060133020071,1552.2,870.8,589.5,1183,741,442
060133020102,1047.8,512.3,459.7,1023,632,391
060133020103,601.8,288.4,268.3,560,309,251
060133020053,619.7,373.5,205.1,636,400,236
060133020054,567.2,337.5,194.3,440,294,146
060133020052,549.8,319.6,189.1,527,338,189
060133020072,822.2,503.3,267.6,323,236,87
060133040011,2626.2,1483.4,1035.4,1465,864,601
060133551121,820.7,339.8,420.9,866,387,479
060133032051,2515.6,1256.8,1164.1,2615,1375,1240
060133032052,1979.8,979.3,851.0,1679,985,694
060133031034,1433.0,721.0,622.0,1074,661,413
060133032042,461.1,234.9,195.9,395,221,174
060133032041,491.8,250.3,209.2,525,313,212
060133551101,831.0,585.6,185.8,921,624,297
060133551112,940.6,681.2,210.5,750,535,215
060133551093,1094.0,774.7,270.2,1086,759,327
060133551091,1485.5,987.5,420.8,1178,783,395
060133080013,636.9,372.2,219.6,658,383,275
060133080012,941.4,585.9,295.6,1161,792,369
060133080011,701.7,421.1,233.8,569,383,186
060133060041,669.0,463.0,178.0,625,397,228
060133060033,571.0,352.2,185.7,591,406,185
060133551111,1398.7,1022.4,314.0,1294,957,337
060133080022,974.7,634.7,289.6,833,547,286
060133032013,1710.0,918.6,709.4,1979,1075,904
060133032043,865.3,418.9,375.9,850,482,368
060133032022,1075.0,550.4,456.0,1151,655,496
060133032023,588.8,315.9,233.7,388,220,168
060133032012,1146.5,825.4,265.1,1361,960,401
060133020092,1181.7,840.4,288.8,922,713,209
060750230031,1037.5,880.6,104.1,977,887,90
060750230032,413.4,358.7,36.5,400,363,37
060750232001,492.0,432.2,41.3,583,535,48
060750234002,624.8,553.5,48.5,592,550,42
060750234001,551.4,479.9,49.4,457,403,54
060750232002,646.6,567.4,45.3,583,554,29
060759806001,250.1,220.7,21.8,185,170,15
060750232003,473.4,435.4,22.1,484,462,22
060750230012,396.1,327.3,50.9,468,405,63
060750257022,547.2,424.7,93.8,437,343,94
060750230011,629.8,526.7,70.7,587,510,77
060759809001,270.1,237.6,12.8,239,216,23
060750612002,811.3,707.1,57.6,689,636,53
060750231022,472.5,435.2,22.6,490,479,11
060750612001,596.5,537.8,37.1,444,415,29
060750610001,797.7,674.9,88.9,597,544,53
060750231021,742.6,675.7,45.5,825,782,43
060750231032,682.2,629.1,29.6,644,627,17
060750231031,473.3,424.0,33.1,402,389,13
060750179021,578.0,489.0,38.0,785,729,56
060816022003,632.7,526.1,76.9,485,426,59
060816022002,355.3,299.3,37.8,237,207,30
060816023001,1429.6,1141.4,223.1,1147,938,209
060816001001,808.3,651.7,122.1,680,536,144
060816001002,995.0,782.8,164.9,734,595,139
060816096011,1660.7,1253.0,329.5,1624,1130,494
060816095002,1620.4,1209.2,325.5,1526,1108,418
060816096021,902.0,662.0,199.0,986,718,268
060816087004,616.2,463.8,115.8,629,473,156
060816087003,422.7,318.2,79.6,355,263,92
060816095001,1200.0,898.9,230.4,1157,835,322
060952527073,339.1,136.1,174.4,308,141,167
060952527072,666.0,407.8,229.3,659,396,263
060952527055,481.8,309.2,142.5,451,318,133
060952527054,745.0,455.6,239.0,756,515,241
060952527053,310.8,190.1,99.7,367,249,118
060952527024,714.2,506.5,167.9,712,510,202
060952527061,1406.5,924.2,393.2,1326,916,410
060952527052,328.4,205.5,101.1,356,243,113
060952527025,467.4,331.5,109.9,522,369,153
060952527051,377.3,267.4,88.1,402,295,107
060952527043,306.2,205.2,83.0,324,223,101
060952528021,111.8,69.6,34.5,17,13,4
060952528022,376.7,234.0,116.5,13,6,7
060133551161,2044.5,1546.7,424.8,726,483,243
060133551142,1821.2,1165.5,573.1,946,549,397
060133551132,1184.4,694.6,416.1,1033,581,452
060133551122,728.3,352.6,339.1,864,363,501
060133551133,663.2,319.6,306.8,788,421,367
060133553061,651.5,327.0,276.2,601,322,279
060133551123,1522.5,725.7,713.1,1637,743,894
060133551131,849.1,478.4,313.6,973,509,464
060133551071,1224.4,771.8,387.0,1343,819,524
060133131031,1883.0,1360.2,424.0,1549,1184,365
060133553044,1114.7,680.4,361.3,1030,646,384
060133131032,560.4,398.1,134.3,732,525,207
060133132041,607.7,466.6,111.6,653,497,156
060133132063,463.6,373.3,70.1,515,411,104
060133132062,638.0,529.0,78.4,591,507,84
060133131013,805.8,597.7,178.8,792,598,194
060133131033,558.9,417.2,111.1,426,313,113
060133131011,703.2,508.3,157.2,736,552,184
060133131012,580.2,427.7,127.4,606,476,130
060133131014,448.9,385.3,46.4,308,266,42
060133131022,557.9,416.1,115.9,600,451,149
060133131021,837.0,666.9,134.3,717,577,140
060133072053,504.4,342.1,133.6,422,272,150
060133072011,479.7,331.4,119.3,610,400,210
060133072012,361.5,253.4,86.7,225,168,57
060133551072,709.3,448.5,227.6,736,447,289
060750264021,310.8,253.3,39.5,359,300,59
060750264023,484.0,396.6,64.7,529,445,84
060759805011,231.3,190.2,30.6,201,162,39
060750264012,558.6,432.2,92.5,515,411,104
060750259003,198.4,165.1,23.2,204,177,27
060750259002,724.0,593.6,92.2,710,608,102
060750258001,376.7,304.0,51.8,350,284,66
060750257013,479.9,373.0,83.3,411,320,91
060750257023,500.0,393.5,81.7,461,348,113
060750259001,848.2,682.3,123.5,755,608,147
060750254012,538.0,495.6,15.8,547,507,40
060750254021,581.2,529.9,21.5,600,551,49
060750254022,502.7,456.4,23.9,429,390,39
060750252004,711.7,655.0,21.4,707,670,37
060750252003,847.6,778.9,30.8,802,740,62
060750253002,508.6,465.6,15.3,467,446,21
060750253001,646.7,596.2,18.7,639,612,27
060750252002,866.2,781.0,30.9,897,864,33
060750252001,725.3,650.3,28.2,641,610,31
060750257012,703.7,572.7,92.0,616,501,115
060750254023,526.0,473.1,33.6,498,466,32
060750251003,442.0,400.9,21.7,452,406,46
060750251002,589.3,542.2,21.9,561,522,39
060750251001,944.7,863.0,33.9,845,800,45
060750264022,538.7,448.1,66.6,476,409,67
060750258002,274.5,229.0,31.8,204,178,26
060750233001,1187.2,968.4,169.0,754,611,143
060750610002,650.0,513.0,111.0,513,407,106
060750257021,408.4,312.2,75.9,356,278,78
060750230013,581.1,463.9,93.9,518,415,103
060470019021,385.9,220.3,138.7,286,174,112
060470019022,321.7,78.1,232.6,293,93,200
060470019011,369.8,209.9,142.4,490,246,244
060470019013,240.1,162.9,66.2,182,136,46
060470019012,183.2,131.0,43.2,165,123,42
060470019014,202.9,159.1,32.8,188,153,35
060430001022,661.6,153.8,478.6,823,232,591
060430001013,489.3,189.1,269.0,533,222,311
060430002001,866.9,254.3,567.9,849,347,502
060430001014,393.0,109.3,264.1,305,90,215
060430002002,310.2,92.8,200.1,353,130,223
060430002003,349.8,108.0,222.1,329,130,199
060190040022,348.8,247.1,83.2,286,205,81
060190040021,587.7,403.4,155.3,565,353,212
060190040023,600.0,420.4,149.3,373,234,139
060190040011,941.8,502.4,390.7,788,394,394
060190041001,548.8,160.4,369.3,581,161,420
060190041002,298.4,190.3,90.5,197,125,72
060190039004,293.4,54.4,231.6,331,73,258
060190039005,256.9,93.7,154.1,279,100,179
060190042071,2198.3,1162.8,951.1,1226,635,591
060390005023,826.6,529.6,240.6,786,512,274
060390005081,495.7,187.6,278.4,554,253,301
060390005022,399.5,255.9,114.9,307,188,119
060390005021,122.3,78.9,34.2,144,99,45
060390008005,204.2,110.8,81.0,159,97,62
060390008004,124.6,67.6,49.4,55,33,22
060390005024,451.1,291.5,123.6,294,181,113
060390009003,456.7,340.0,93.0,254,215,39
060390009002,529.6,396.8,103.6,297,251,46
060390005082,462.0,324.0,110.0,382,258,124
060530127003,438.5,322.6,90.3,508,384,124
060530126001,125.9,69.9,36.9,79,42,37
060530127004,567.8,417.7,117.0,531,427,104
060530127001,360.5,265.2,74.3,294,235,59
060530125022,506.8,360.8,113.3,418,322,96
060530116041,1158.5,763.4,348.2,1313,865,448
060530110004,693.2,480.3,167.2,433,331,102
060530116022,903.0,548.1,303.0,886,513,373
060530116024,1118.2,661.8,380.4,1113,693,420
060530132002,1272.8,795.1,408.5,1320,835,485
060530116023,500.6,300.3,172.4,547,348,199
060530133002,511.2,346.9,127.9,452,331,121
060530131001,48.3,24.3,15.4,189,92,97
060530130002,367.3,254.3,90.1,358,266,92
060530133001,631.6,433.6,144.2,618,444,174
060530125021,639.7,455.5,143.1,612,480,132
060530130003,449.5,311.7,110.1,364,275,89
060530133004,305.9,207.7,76.5,360,286,74
060530133003,796.1,543.8,189.5,565,429,136
060530140001,734.8,523.9,163.4,612,479,133
060530136002,501.7,339.8,134.7,606,426,180
060530136001,625.8,443.4,148.0,455,356,99
060530134001,918.0,593.0,258.0,888,617,271
060530135003,860.1,632.0,178.2,838,706,132
060530135002,489.7,318.3,137.3,606,423,183
060530135001,358.0,268.0,69.8,374,315,59
060530137002,363.5,284.6,58.3,264,221,43
060530137001,270.8,212.0,43.4,239,171,68
060530138002,676.1,541.1,99.7,764,641,123
060530138003,433.5,368.7,45.4,452,401,51
060530139002,382.4,278.1,79.9,387,284,103
060530137003,409.1,294.4,88.3,140,119,21
060530139001,541.5,402.1,104.9,624,475,149
060530141073,558.3,346.4,156.3,311,202,109
060530138001,569.5,431.7,102.7,547,448,99
060530141072,404.6,251.2,113.0,108,71,37
060530141071,727.7,451.7,203.3,918,590,328
060530141041,97.0,82.0,6.0,194,161,33
060390001082,1200.5,334.7,804.3,1192,452,740
060390001092,339.7,79.1,245.5,287,104,183
060390001062,1444.1,435.6,926.6,1543,543,1000
060390001061,1239.2,381.6,785.8,1244,445,799
060430001021,697.9,257.0,394.5,646,279,367
060430001012,489.2,194.3,264.5,717,335,382
060430003012,914.6,236.1,606.0,874,321,553
060430003013,597.0,197.2,366.7,602,239,363
060430003011,470.4,140.8,308.5,551,227,324
060430003022,460.3,125.4,307.1,425,144,281
060430001011,464.2,211.2,216.0,493,282,211
060430003021,416.4,167.4,217.4,491,247,244
060430003023,581.8,189.3,353.7,525,196,329
060390001083,1029.4,289.8,685.4,951,352,599
060390001091,774.2,200.4,537.3,755,239,516
060390001032,552.9,170.8,349.2,638,242,396
060390001034,738.3,221.7,473.8,699,241,458
060390001033,603.3,181.8,386.4,644,235,409
060133462041,1698.7,1016.1,581.2,1929,1086,843
060133462031,1872.5,1088.8,680.3,1666,946,720
060133462012,1224.1,629.6,518.7,1205,625,580
060133462043,1033.1,568.3,402.3,1035,510,525
060133462013,1539.7,823.8,618.8,1626,826,800
060133461023,510.0,250.1,234.7,476,239,237
060133462014,729.7,377.3,309.6,806,380,426
060133461022,1773.6,913.7,735.4,1924,914,1010
060133451111,789.0,487.7,255.0,874,524,350
060133451113,358.7,215.0,120.9,527,272,255
060133451021,604.2,369.7,198.4,654,421,233
060133451022,1018.0,610.8,339.5,862,510,352
060133451023,612.7,368.8,204.5,628,383,245
060133451112,625.7,412.5,171.5,630,435,195
060133451083,479.1,313.4,135.8,653,404,249
060133451081,950.6,564.8,313.8,1243,764,479
060133451084,833.6,548.3,244.0,512,311,201
060133451082,1301.3,866.5,361.4,1283,761,522
060133451033,1154.1,701.5,383.1,1258,783,475
060133451121,1785.9,1219.9,473.3,1587,979,608
060133451122,1360.9,908.4,388.8,1080,709,371
060133451131,923.5,591.1,288.7,1237,695,542
060133451141,826.8,503.2,282.3,855,508,347
060133451142,1011.4,568.1,400.4,908,460,448
060133451143,1436.0,885.9,461.2,1626,888,738
060133451132,1464.7,898.2,483.7,1179,663,516
060133462042,1176.4,640.7,461.4,1243,648,595
060133551151,1860.2,1435.8,346.9,1410,985,425
060133551143,2763.4,1946.0,702.9,2886,1854,1032
060411311003,220.9,182.1,25.0,199,171,28
060411130002,722.4,570.7,87.3,668,587,81
060411191005,611.6,474.7,103.5,704,520,184
060411130001,526.7,433.6,48.1,555,488,67
060411141001,1350.9,1163.9,90.7,1335,1239,96
060411311002,314.7,278.3,18.3,340,315,25
060411330002,307.4,237.7,46.0,376,313,63
060411261005,599.5,528.8,42.5,589,528,61
060411321001,421.0,374.0,26.0,419,386,33
060411282001,414.2,356.8,33.9,364,330,34
060411270003,486.1,425.1,30.9,515,467,48
060411270004,605.5,532.4,40.1,628,565,63
060411270002,344.3,299.2,30.7,388,339,49
060411270005,761.7,669.6,54.0,753,657,96
060411181002,928.1,678.0,179.4,1041,756,285
060411142002,734.5,610.8,65.5,669,558,111
060411142001,1274.1,1076.0,116.8,1265,1126,139
060411141003,1030.3,881.7,84.0,1026,937,89
060411141002,1036.6,881.5,83.6,1033,927,106
060411150002,1066.4,834.8,184.5,1140,821,319
060411160002,873.5,762.3,72.5,804,725,79
060411170003,939.8,795.2,95.7,863,742,121
060411181001,461.2,330.7,97.6,548,387,161
060411170004,735.0,609.0,77.0,680,592,88
060411170002,458.2,391.0,50.7,455,383,72
060411170001,796.8,680.0,88.3,852,756,96
060411160001,1084.3,937.0,92.8,1101,962,139
060411150001,1672.5,1420.6,181.2,1568,1335,233
060411150003,1219.5,1007.6,139.2,1188,1005,183
060411150004,703.6,604.1,66.5,667,579,88
060411081004,1040.1,856.3,141.3,1032,833,199
060411090021,903.1,743.0,110.5,1057,857,200
060411081002,500.6,405.6,75.3,407,323,84
060411082001,1118.3,853.2,200.4,1141,838,303
060750352012,457.0,356.9,65.1,434,358,76
060750352021,819.7,677.8,85.6,677,604,73
060750352022,754.3,626.7,77.4,642,548,94
060750352023,643.1,532.4,64.1,592,486,106
060750352011,480.6,375.3,69.3,440,352,88
060750352015,467.9,375.0,62.5,404,343,61
060750351007,635.6,500.0,106.3,600,470,130
060750352013,512.9,419.1,60.7,469,381,88
060750352014,571.8,462.5,67.0,567,481,86
060750351002,620.9,500.1,86.7,542,432,110
060750351001,582.9,477.7,74.3,531,438,93
060750479015,526.3,423.8,73.1,528,413,115
060750479013,724.2,583.2,98.8,667,535,132
060750479014,625.2,512.0,79.7,567,453,114
060750479011,517.4,414.5,70.5,481,381,100
060750479021,498.0,400.8,65.7,518,433,85
060750479022,669.0,539.0,92.3,610,517,93
060750479023,549.2,445.6,78.3,522,412,110
060750428002,403.7,318.1,64.9,399,283,116
060759802001,153.8,121.2,23.2,101,80,21
060750351005,417.1,311.2,82.7,392,276,116
060750351006,410.5,306.2,81.5,399,305,94
060750351004,357.3,266.6,70.8,355,258,97
060750353006,617.7,488.4,103.4,573,424,149
060750353001,427.6,326.7,78.8,428,330,98
060750354002,675.8,536.3,107.6,653,503,150
060750351003,530.3,415.7,85.9,544,430,114
060750329011,546.5,419.4,100.9,500,382,118
060750329023,557.5,424.6,104.1,551,423,128
060750329012,558.3,429.8,101.0,549,408,141
060750329022,557.5,428.0,101.0,493,379,114
060750329021,528.7,410.2,99.0,458,341,117
060750327005,329.6,253.4,64.2,344,243,101
060750328023,566.4,436.2,101.5,506,374,132
060750327006,380.3,289.9,67.7,380,272,108
060750327004,423.1,310.6,85.1,387,284,103
060750327003,553.6,464.5,62.0,491,385,106
060750327007,395.0,330.6,44.6,357,287,70
060750327002,613.0,500.6,82.3,530,433,97
060750327001,431.4,353.2,57.0,401,321,80
060750478023,677.8,547.9,92.2,630,493,137
060750478022,575.9,465.1,83.7,515,406,109
060750478012,572.9,459.6,78.7,503,397,106
060750478011,601.7,452.4,110.1,561,434,127
060750478013,820.5,641.5,131.8,727,548,179
060750477021,566.8,461.6,75.6,479,386,93
060750477013,641.2,518.8,85.4,535,438,97
060750477023,679.6,554.8,90.3,664,538,126
060750477011,755.8,609.0,108.8,694,530,164
060750478021,516.3,421.6,73.9,511,412,99
060750427003,875.7,691.5,127.0,831,663,168
060750427002,841.9,672.2,113.4,719,569,150
060750428001,654.4,515.6,105.1,694,539,155
060750427001,878.3,712.8,111.2,751,608,143
060411311001,127.5,114.3,7.3,131,123,8
060411290001,480.6,425.7,35.7,507,481,26
060411290002,598.2,528.6,46.2,502,475,27
060411302011,682.8,555.6,93.7,733,571,162
060411302023,986.0,799.2,139.2,1072,887,185
060411281002,1476.7,1275.4,134.0,1108,976,132
060411281001,1213.4,1018.6,121.0,1338,1145,193
060411302021,769.8,656.6,78.7,767,693,74
060411281003,1502.1,1285.4,141.1,1600,1412,188
060411282003,1138.9,968.1,111.0,1184,1023,161
060411262002,1238.8,1058.6,133.5,1197,998,199
060411302024,698.6,579.9,83.5,703,593,110
060411302012,731.2,564.9,121.4,844,690,154
060411302013,682.6,549.4,98.1,731,607,124
060411302022,588.8,498.2,57.4,582,505,77
060750328021,531.8,405.4,95.3,522,406,116
060750328011,697.2,542.7,122.9,640,487,153
060750328022,597.0,457.3,103.6,569,431,138
060750326022,578.9,440.3,100.1,562,425,137
060750326021,852.2,675.6,128.3,754,597,157
060750326023,599.9,456.2,103.7,542,403,139
060750326013,708.6,574.4,88.7,635,500,135
060750326011,777.1,646.0,83.3,752,630,122
060750326012,744.8,619.5,77.2,638,550,88
060750303011,667.4,538.7,97.1,640,499,141
060750303021,679.9,533.7,113.5,615,467,148
060750303023,660.5,530.6,92.1,622,474,148
060750302011,1008.1,864.4,85.1,844,736,108
060750302012,600.4,517.9,46.5,553,461,92
060750302013,674.5,575.3,65.4,629,552,77
060750303014,661.6,548.4,80.2,625,486,139
060750303012,1142.1,990.6,96.5,1083,954,129
060750302021,907.3,808.8,57.8,874,787,87
060750302022,895.5,798.4,57.3,850,766,84
060750477022,629.2,508.1,90.5,611,497,114
060750477012,742.8,606.2,82.0,700,573,127
060750476003,527.1,432.9,65.8,526,432,94
060750476001,701.3,583.0,74.8,600,501,99
060750426011,697.7,569.2,92.1,676,540,136
060750426021,500.3,420.5,54.1,434,357,77
060750476002,669.1,557.8,74.4,598,499,99
060750476004,805.0,657.0,108.0,786,649,137
060750452004,616.8,512.0,75.1,615,497,118
060750452003,534.9,445.7,60.6,531,451,80
060750452005,658.2,538.5,96.5,586,501,85
060750303022,693.5,563.3,88.3,601,477,124
060750303013,922.5,785.1,95.2,862,721,141
060750304001,694.2,564.9,103.7,731,565,166
060750304002,660.9,524.2,105.6,647,495,152
060750304003,763.8,599.7,124.9,706,556,150
060750302023,853.7,758.5,55.1,765,698,67
060750301014,591.9,536.6,23.4,561,519,42
060750301013,568.1,517.0,21.9,541,506,35
060750301022,683.5,569.9,72.9,724,579,145
060750301021,1584.1,1380.2,119.3,1443,1290,153
060750301011,906.5,813.0,39.8,873,806,67
060750301012,765.7,693.5,23.4,771,721,50
060750452001,884.1,741.9,99.9,715,619,96
060750452002,886.3,754.4,81.5,776,681,95
060750451002,727.6,622.4,56.2,649,576,73
060750451003,680.7,600.1,56.0,608,520,88
060750451001,1171.9,1016.3,98.0,990,881,109
060750156003,452.6,389.5,39.4,426,365,61
060750156002,731.2,633.1,59.3,656,583,73
060750157004,872.2,755.4,76.8,780,674,106
060750156001,380.2,314.1,40.9,375,317,58
060750426012,1133.0,948.0,124.8,1062,884,178
060750428003,549.0,455.0,56.0,358,291,67
060750426023,643.7,543.4,67.1,557,472,85
060750426022,606.1,517.7,60.5,557,469,88
060750402002,459.6,387.0,48.5,426,358,68
060750402004,777.1,670.4,64.6,794,664,130
060750402003,659.4,561.2,63.9,586,511,75
060750402001,887.1,764.2,73.2,833,729,104
060750401004,512.9,448.5,35.1,472,421,51
060750401003,730.0,620.4,67.2,614,523,91
060750401002,572.5,487.7,52.5,555,471,84
060750401001,610.7,512.5,68.3,548,460,88
060750133005,433.7,366.4,45.4,437,358,79
060750154005,972.6,836.8,76.7,917,764,153
060750154004,512.6,439.5,42.1,509,421,88
060750154003,832.8,696.8,82.0,700,595,105
060750133004,446.9,382.7,43.6,505,380,125
060750133003,706.8,590.0,82.7,540,439,101
060750133001,423.8,352.4,45.8,435,346,89
060750305002,633.7,514.6,82.8,483,379,104
060750305001,546.0,441.2,70.2,523,396,127
060750305003,257.3,215.2,30.0,380,295,85
060750204021,1489.6,1329.4,104.2,1364,1247,117
060750217001,890.3,755.2,102.0,759,608,151
060750171022,473.1,434.6,13.6,427,412,15
060750171021,923.1,855.6,27.0,911,884,27
060750301023,650.4,608.7,22.3,640,604,36
060750171012,800.3,744.9,31.4,686,638,48
060750204022,1342.4,1223.4,63.7,1145,1068,77
060750212002,756.4,692.7,37.6,772,718,54
060750204012,489.9,446.6,23.8,598,536,62
060750204011,717.4,665.6,20.2,705,671,34
060750212003,548.9,509.1,20.9,560,525,35
060750204013,951.4,884.1,27.2,881,851,30
060750170003,598.8,554.0,25.4,598,558,40
060750170002,1599.9,1498.0,51.6,1490,1415,75
060750205002,692.6,645.6,25.4,603,576,27
060750205001,554.6,512.2,25.2,589,562,27
060750171023,1064.2,978.7,29.5,1101,1053,48
060750166003,893.0,792.0,34.0,768,734,34
060750165004,653.2,609.0,13.6,627,602,25
060750165003,969.8,898.7,23.4,872,832,40
060750171011,828.4,779.5,22.8,893,842,51
060750171013,782.4,721.3,23.7,815,783,32
060750166002,731.9,673.5,19.1,742,715,27
060750166004,847.1,764.6,24.9,824,794,30
060750157003,929.3,774.7,99.8,845,724,121
060750157001,701.7,611.8,65.6,732,608,124
060750165002,733.1,678.7,17.1,740,710,30
060750166001,1108.5,1024.7,25.1,1018,987,31
060750167003,681.2,639.6,14.4,565,553,12
060750170001,686.7,643.7,23.2,689,653,36
060750167004,975.5,913.1,18.4,957,924,33
060750165001,986.4,898.5,38.4,951,883,68
060750157002,1217.4,1112.3,43.7,1184,1129,55
060750158021,919.5,846.6,21.3,861,809,52
060750164002,1072.9,958.6,59.0,1043,972,71
060750158022,1055.5,959.5,42.2,1007,973,34
060750164001,1351.2,1245.9,27.1,1328,1302,26
060750158013,843.9,775.4,28.2,757,729,28
060750158012,946.3,854.7,40.7,926,872,54
060750212001,619.1,568.8,25.3,589,548,41
060750205003,672.0,629.0,19.3,670,636,34
060750211003,705.7,656.8,24.1,669,626,43
060750214001,503.7,463.3,17.8,505,475,30
060750211004,566.4,525.8,20.1,571,530,41
060750211001,803.2,752.8,25.3,797,753,44
060750211002,596.7,550.0,20.4,605,574,31
060750206002,578.4,536.6,20.0,598,559,39
060750206003,671.8,628.0,18.7,673,641,32
060750206004,1089.5,1028.4,27.4,1067,1026,41
060750203002,464.5,435.7,13.5,484,469,15
060750203003,784.5,733.3,18.6,828,799,29
060750206001,1154.5,1072.7,36.5,1158,1101,57
060750207003,592.7,546.5,21.4,633,618,15
060750210004,517.8,469.8,20.6,450,425,25
060750210003,808.1,735.6,31.9,896,843,53
060750210002,636.2,581.2,26.4,655,616,39
060750210001,666.9,608.8,27.9,618,587,31
060750203001,992.0,926.8,25.3,900,870,30
060750207002,1258.5,1173.6,37.0,1402,1349,53
060750169001,1425.4,1338.8,24.7,1372,1323,49
060750207001,1475.1,1352.4,48.1,1481,1394,87
060750202003,1417.6,1272.0,68.0,1381,1278,103
060750167002,474.6,436.3,11.8,458,433,25
060750169002,857.8,803.2,13.3,840,818,22
060750167001,1194.5,1116.0,16.9,1173,1139,34
060750168011,939.8,878.9,19.7,885,866,19
060750168012,941.2,878.0,26.6,771,745,26
060750163003,1435.9,1317.2,27.2,1352,1301,51
060750161002,726.1,569.3,131.6,859,667,192
060750161003,395.5,344.9,36.1,436,382,54
060750161004,650.3,554.8,64.0,708,622,86
060133290002,716.4,472.2,200.5,654,446,208
060133290001,759.6,503.8,211.5,820,566,254
060133300001,536.3,374.3,128.9,471,324,147
060133452031,1403.0,782.7,531.0,1671,871,800
060133452023,1224.5,782.9,365.9,1154,730,424
060133452032,594.4,337.1,220.6,618,356,262
060133452022,792.0,526.3,217.9,695,487,208
060133451152,853.4,519.4,287.3,900,541,359
060133451162,733.2,450.8,226.2,862,522,340
060133451161,772.8,486.2,237.8,723,453,270
060133451051,1381.0,853.9,435.4,1382,833,549
060133451052,679.1,435.6,194.6,792,449,343
060133451054,689.4,414.4,229.4,623,362,261
060133451053,586.4,338.3,207.2,611,330,281
060133451144,535.9,349.8,154.2,593,353,240
060133452033,665.5,359.2,259.6,479,281,198
060133452034,1082.1,630.7,393.3,1095,626,469
060133452042,934.8,445.2,431.3,933,464,469
060133462032,566.3,319.4,218.5,691,381,310
060133462011,815.8,410.4,344.5,918,444,474
060133461011,1424.9,913.7,410.4,1494,914,580
060133461012,713.7,439.4,230.4,698,406,292
060133461021,1050.9,562.8,418.0,1160,598,562
060530141043,0.0,0.0,0.0,0,0,0
060530141042,0.0,0.0,0.0,0,0,0
060530142013,678.5,477.5,143.9,671,447,224
060530142021,386.3,273.4,79.8,332,242,90
060530141022,70.8,51.7,13.4,19,13,6
060530143011,865.5,569.1,226.3,748,526,222
060530143012,622.6,404.5,183.6,649,437,212
060530143022,978.7,645.4,274.9,890,589,301
060530141021,740.1,539.8,140.1,559,433,126
060530142022,1115.5,728.5,313.5,960,645,315
060530141051,1114.0,903.0,125.0,1134,929,205
060530142011,542.9,354.5,152.6,529,365,164
060530142012,551.8,360.1,155.2,563,378,185
060530143021,701.6,455.6,206.5,601,410,191
060530110001,988.5,672.5,246.3,937,676,261
060530110002,602.4,400.7,167.3,706,501,205
060530107022,1471.6,742.9,635.4,1255,611,644
060530107014,406.7,190.2,196.2,415,209,206
060530107013,748.5,350.1,361.0,918,440,478
060530015001,960.3,579.9,307.1,977,626,351
060530015002,716.9,384.3,283.1,703,382,321
060530015003,960.6,541.3,349.6,1031,610,421
060530016002,516.0,288.3,193.2,492,299,193
060530016001,769.0,429.7,287.8,831,450,381
060530145002,843.7,482.0,307.3,791,456,335
060530145003,629.7,351.1,247.7,763,412,351
060750309001,548.9,418.0,107.6,575,423,152
060750310003,919.9,721.4,141.1,825,650,175
060750310001,532.4,428.2,74.2,500,413,87
060750308002,466.7,365.6,83.8,464,339,125
060750306002,459.3,384.4,59.6,422,345,77
060750307003,1442.1,1192.9,186.5,1377,1091,286
060750310002,791.1,632.3,117.5,691,547,144
060750308001,540.5,427.5,77.9,548,412,136
060750306003,477.7,383.2,65.5,469,356,113
060750306001,466.7,385.2,65.5,445,347,98
060816016012,487.3,379.2,88.7,416,324,92
060816004012,443.5,358.7,64.4,404,324,80
060816004023,313.9,257.5,41.5,310,245,65
060816004011,678.5,540.6,106.3,775,612,163
060816004021,382.6,312.9,52.7,368,297,71
060816004022,635.1,518.9,88.5,547,431,116
060750262003,411.1,352.2,45.1,374,301,73
060750262004,506.0,422.2,64.7,439,359,80
060750263032,696.3,559.9,112.2,679,502,177
060750263031,774.5,619.9,120.8,688,523,165
060750262001,668.1,533.1,105.6,590,451,139
060750262002,477.7,377.8,80.3,420,321,99
060750261003,445.6,343.6,80.1,407,316,91
060750261004,470.0,376.9,71.1,402,312,90
060750261002,875.9,699.2,137.6,753,578,175
060750263012,776.1,612.6,136.9,739,576,163
060750263013,318.1,251.6,57.1,302,236,66
060750263022,447.9,365.7,59.2,465,366,99
060816003002,754.9,594.0,130.4,637,498,139
060816003001,751.5,592.6,123.9,536,424,112
060750263021,432.4,352.6,60.8,422,349,73
060750263023,894.3,717.2,144.2,804,644,160
060750605023,379.9,318.1,49.5,340,279,61
060750264041,392.6,330.7,50.0,351,295,56
060750264042,304.6,260.0,36.3,362,327,35
060750312022,673.9,581.3,67.3,620,535,85
060750314002,585.5,493.4,61.2,514,444,70
060750312021,482.1,398.7,58.5,438,370,68
060750312011,845.9,703.9,95.4,688,582,106
060750311005,1097.6,959.9,83.8,959,843,116
060750311003,375.4,320.3,39.0,373,324,49
060750311004,738.9,621.6,86.6,632,544,88
060750311002,841.2,703.0,87.1,767,657,110
060090002104,1127.2,260.2,808.7,975,307,668
060090002103,993.7,265.3,665.8,770,304,466
060090002201,1038.8,288.6,683.2,855,339,516
060090002102,882.6,216.0,622.9,704,249,455
060050003042,973.9,255.4,654.8,1023,389,634
060990002021,563.2,201.5,327.7,322,184,138
060990002023,368.3,131.8,214.3,174,84,90
060090002101,1764.7,525.8,1136.8,2231,850,1381
060090003002,574.6,189.8,340.1,426,184,242
061150407001,666.0,243.0,380.0,470,179,291
060610213093,1083.2,462.5,542.4,469,204,265
060610213094,2853.5,1171.4,1469.4,1910,785,1125
060610226001,1848.5,829.6,877.5,1554,734,820
060610213041,987.0,237.7,697.5,1077,308,769
060610213042,352.4,95.4,242.6,337,120,217
061150408003,555.1,150.8,372.1,576,206,370
061150408002,235.3,65.3,156.3,228,95,133
061010503023,148.4,91.0,48.8,118,80,38
061010504013,464.1,177.3,254.8,333,127,206
061010504014,480.6,222.5,229.6,478,251,227
061150404002,285.1,124.2,142.3,338,162,176
061010501022,330.7,138.3,166.6,393,187,206
061010503024,343.8,132.1,179.1,621,248,373
061010503021,401.9,168.0,198.9,418,198,220
061010502024,259.4,120.9,118.1,210,110,100
061010501023,338.6,154.6,161.9,295,131,164
061010502022,197.6,82.6,97.4,227,122,105
061010502021,179.1,89.2,78.4,194,103,91
061010501012,465.6,164.1,266.9,290,147,143
061010501014,349.3,130.0,186.5,330,144,186
061010502023,204.2,86.0,99.2,99,43,56
061010503022,268.3,164.5,88.2,285,174,111
061150401004,151.8,65.8,74.7,200,117,83
061150401005,282.1,116.2,143.2,212,115,97
061150402005,197.2,80.5,100.9,261,116,145
061150401003,183.9,82.1,88.8,243,132,111
061150404001,400.8,180.5,194.8,285,135,150
061150402007,238.4,83.8,132.9,210,87,123
060133521023,908.8,643.2,204.2,1192,766,426
060133521012,565.4,402.9,128.2,454,298,156
060133521011,1111.5,779.7,250.9,1206,773,433
060133521024,514.0,348.7,126.8,555,333,222
060133500003,966.1,697.0,203.3,1039,690,349
060133512003,1670.1,1214.4,339.4,1553,1103,450
060133500004,925.3,709.4,167.9,851,655,196
060133512001,803.8,599.1,157.8,783,525,258
060133512002,1308.9,980.4,256.1,1468,979,489
060133511022,563.5,411.0,128.7,560,381,179
060133511023,899.5,634.5,232.4,893,626,267
060133410002,950.3,693.1,195.2,1005,701,304
060014302001,1364.8,931.8,358.0,1420,955,465
060133452041,1228.5,705.7,439.9,1232,646,586
060133521021,846.8,584.7,210.8,946,586,360
060133511013,1075.1,777.1,260.8,998,656,342
060133522021,1530.9,1054.7,356.4,1544,972,572
060133511021,1358.4,959.1,344.6,1295,837,458
060133511011,786.2,538.7,223.5,954,578,376
060133511032,980.7,674.9,279.0,959,572,387
060133511012,383.5,262.8,109.0,311,184,127
060133511031,613.5,426.7,169.5,550,350,200
060133342003,1352.9,961.9,306.4,1341,891,450
060133342005,559.8,423.7,106.3,605,443,162
060133342001,902.4,566.0,292.0,1049,588,461
060133342002,696.4,400.4,249.0,654,371,283
060133430032,919.0,626.6,230.7,954,653,301
060133530021,465.2,327.9,111.1,478,302,176
060133500002,499.9,369.3,103.5,532,376,156
060133530022,1012.0,756.7,202.8,906,629,277
060133540021,1789.4,1254.0,409.8,1702,1011,691
060133480002,1167.2,781.6,298.5,1348,845,503
060133480003,1149.6,789.7,282.4,1121,742,379
060133540023,950.4,688.0,209.2,1079,720,359
060133500001,871.7,676.8,136.0,861,674,187
060133470002,1388.1,900.6,390.2,1671,1033,638
060133490003,631.7,468.2,113.9,559,445,114
060133490002,974.4,723.3,185.6,1089,761,328
060133490001,1117.6,806.1,214.4,1074,754,320
060133480001,469.9,329.9,111.2,450,292,158
060552014031,251.8,96.7,140.1,213,98,115
060552014032,158.6,87.0,63.0,295,184,111
060552018002,394.2,147.6,213.0,358,186,172
060552014012,844.7,424.4,381.4,1051,536,515
060552014011,524.0,282.3,204.7,641,384,257
060552018001,412.6,189.8,200.7,491,239,252
060552017004,324.8,182.6,107.5,453,278,175
060552017001,229.4,134.4,74.5,323,175,148
060552019001,289.0,174.6,94.8,396,264,132
060552017006,303.4,189.6,92.7,368,230,138
060014098002,727.3,670.3,26.0,558,539,19
060014098001,424.6,394.3,17.0,476,462,14
060014098003,384.7,358.2,15.3,443,426,17
060014099002,332.0,297.9,27.5,360,341,19
060014081002,1838.9,1610.6,146.4,1504,1302,202
060014081004,413.1,349.4,46.6,492,433,59
060014099001,326.3,289.2,29.1,442,405,37
060014099003,978.3,891.4,60.0,956,876,80
060014081003,718.0,634.0,56.0,639,582,57
060014081001,1060.0,865.0,147.0,973,770,203
060014046004,1067.9,952.3,73.4,947,813,134
060014099004,677.4,621.6,32.4,613,592,21
060133522013,1468.8,1090.8,297.5,1441,1010,431
060133522012,753.0,522.3,181.5,803,475,328
060133530011,846.5,626.9,159.5,853,588,265
060133530012,1420.8,1089.8,246.2,1317,998,319
060133522011,1123.3,791.2,265.2,1082,795,287
060133521022,553.5,378.3,131.5,587,384,203
060411043001,1066.0,715.0,292.0,940,593,347
060411012001,1542.2,1043.0,415.1,1496,1055,441
060411011001,1639.1,1084.1,470.0,1765,1204,561
060411022032,679.9,511.2,133.8,612,446,166
060411041021,1129.9,824.6,236.4,1026,810,216
060411060013,704.7,555.7,120.1,726,568,158
060419901000,0.0,0.0,0.0,0,0,0
060411070005,1299.9,970.9,247.4,824,630,194
060411060023,489.3,385.6,75.7,499,394,105
060411102002,650.6,461.2,154.1,661,443,218
060411060021,1362.7,1094.3,193.4,1132,968,164
060411050001,1304.4,991.7,253.5,1706,1349,357
060411042002,905.2,685.6,179.7,1062,818,244
060411050002,1589.6,1192.4,321.5,1020,730,290
060971506122,751.2,431.0,250.0,635,404,231
060971501002,320.4,181.6,114.3,347,210,137
060971506073,1906.1,1251.6,526.8,1789,1239,550
060971503031,447.2,315.3,104.1,543,380,163
060971503034,1154.2,844.9,263.1,1140,793,347
060971501003,239.5,146.4,75.3,230,149,81
060971501001,739.0,494.9,188.8,842,606,236
060971502032,785.9,542.9,196.1,819,560,259
060971502031,927.5,641.8,230.6,935,710,225
060971502043,714.2,518.3,160.1,737,534,203
060971502033,828.1,628.7,153.0,893,672,221
060750209004,586.2,532.3,18.3,527,489,38
060750209003,327.8,296.5,11.1,320,304,16
060750208004,952.0,840.6,60.7,741,664,77
060750209001,856.7,765.6,38.5,549,514,35
060750228031,959.6,870.2,34.8,1003,930,73
060750209002,491.5,439.7,20.6,380,358,22
060750229013,420.6,365.2,22.7,291,268,23
060750229011,765.4,678.7,30.3,686,632,54
060750229012,602.9,530.6,29.6,575,533,42
060750208003,644.0,584.3,30.4,649,581,68
060750201004,859.5,760.9,48.1,691,615,76
060750201002,539.7,489.4,20.4,413,384,29
060750208001,553.4,482.9,30.8,505,459,46
060750177002,942.3,831.3,57.6,752,695,57
060750228011,699.8,624.1,32.5,573,548,25
060750228013,768.9,704.9,16.3,716,669,47
060750208002,755.3,709.1,16.5,613,576,37
060750228012,922.0,837.4,36.5,819,766,53
060750229021,559.3,503.1,17.9,525,494,31
060750229022,524.6,470.3,21.5,523,489,34
060750229033,399.1,352.7,18.4,416,378,38
060750229031,640.6,566.2,29.0,613,558,55
060750228032,574.7,524.1,18.4,600,565,35
060750228033,625.0,570.2,20.0,553,514,39
060750229032,387.3,348.6,15.4,479,446,33
060750228022,696.7,630.7,27.8,463,433,30
060750177001,286.9,253.8,17.2,195,176,19
060750228021,340.8,301.6,21.3,317,289,28
060750201003,617.4,559.9,22.6,385,348,37
060750201001,623.5,551.1,41.7,652,595,57
060750202001,754.0,701.3,23.0,676,635,41
060750178022,654.1,580.7,37.1,540,498,42
060750124022,786.3,691.9,42.4,320,293,27
060750176013,1462.0,1266.6,120.3,789,699,90
060750176014,508.7,442.3,40.1,118,106,12
060750124021,291.1,249.5,24.3,342,308,34
060750125011,699.1,569.6,90.3,653,527,126
060750180002,696.3,619.0,42.9,482,457,25
060750178021,1606.9,1422.8,92.2,1378,1248,130
060750176012,894.2,764.6,86.3,955,821,134
060750614001,1079.6,961.3,53.2,995,944,51
060750614003,668.3,615.7,23.6,687,647,40
060750227042,1358.9,1239.5,64.3,1284,1182,102
060750614002,1050.9,940.3,60.4,1057,994,63
060750227041,877.3,793.2,44.3,731,666,65
060750227022,690.5,630.0,33.2,648,615,33
060750227021,708.1,652.9,26.7,648,602,46
060750226001,627.9,583.9,13.0,361,341,20
060750607001,4564.4,4075.7,278.4,2295,2023,272
060750607002,179.7,157.7,12.8,122,111,11
060750178012,1078.0,928.8,90.7,1024,839,185
060750180001,852.4,760.6,47.9,1033,940,93
060750615005,434.3,370.9,38.6,374,337,37
060750607003,488.3,416.7,44.6,480,399,81
060750124023,665.1,544.5,86.0,558,463,95
060750124011,589.6,508.4,50.0,561,463,98
060750122021,882.9,753.4,77.8,799,720,79
060014079001,480.3,411.6,44.5,505,452,53
060014068001,422.4,365.2,39.1,408,352,56
060014068002,413.3,364.8,31.2,448,397,51
060014080002,1078.0,954.0,95.0,1086,943,143
060014080001,507.0,448.0,34.0,476,410,66
060014051001,675.3,609.5,35.6,677,582,95
060014261003,860.1,668.1,150.3,817,575,242
060014261006,502.8,397.3,80.4,490,329,161
060014047001,766.1,702.6,36.6,635,569,66
060014261002,505.3,404.7,71.6,536,384,152
060014045011,1149.0,983.0,109.0,1154,975,179
060014045024,1328.5,1175.2,91.1,1205,1049,156
060014045022,967.0,843.9,73.2,910,800,110
060014042003,847.7,743.5,59.9,701,575,126
060014042002,710.5,629.5,60.0,823,704,119
060014042001,572.8,504.1,44.1,684,605,79
060014044002,856.7,749.0,62.8,831,722,109
060014044003,1114.9,975.6,77.4,1078,950,128
060014047002,628.8,568.0,32.8,745,648,97
060014067001,973.0,873.8,54.5,808,716,92
060014046003,741.0,647.1,54.5,838,722,116
060014046001,764.8,673.9,50.8,780,691,89
060014046002,515.7,454.4,34.2,503,434,69
060014045021,660.2,569.5,51.3,643,563,80
060014045023,1092.0,957.7,80.4,1114,971,143
060014001001,1890.9,1623.7,170.2,2004,1682,322
060014044001,1577.6,1361.7,155.6,1389,1189,200
060750113002,468.6,374.2,70.6,503,396,107
060750118001,431.2,351.7,59.3,367,296,71
060750113001,499.2,417.3,57.4,378,300,78
060750611002,440.3,349.8,70.0,354,294,60
060750611003,229.1,191.3,28.6,262,200,62
060750107003,416.7,341.8,55.0,404,318,86
060750611001,243.7,203.0,30.6,228,173,55
060750117001,363.3,303.4,43.6,403,338,65
060750103003,708.9,599.1,70.4,741,620,121
060750109001,713.5,628.5,48.8,683,588,95
060750109002,1060.5,929.2,85.8,1005,882,123
060750102002,1368.3,1199.2,103.8,1332,1137,195
060750102001,849.7,702.9,101.9,924,726,198
060750103002,650.4,556.9,59.1,630,544,86
060750103001,844.9,727.0,75.6,788,691,97
060750101001,369.0,299.7,47.6,383,309,74
060750108001,669.4,554.0,76.7,708,552,156
060750108002,720.2,594.3,82.5,784,653,131
060750107001,405.2,347.3,37.1,429,361,68
060750101002,1396.3,1150.9,166.5,1406,1187,219
060750107002,471.7,398.8,44.4,341,279,62
060750107004,353.3,304.8,33.8,314,269,45
060750104001,339.4,287.5,32.8,317,276,41
060750104002,958.3,809.9,91.1,934,799,135
060750104003,831.9,696.5,81.1,880,724,156
060750106003,581.6,486.4,50.4,507,444,63
060750106001,530.5,441.6,47.8,604,527,77
060750106002,568.4,452.5,76.1,408,352,56
060750105001,436.4,352.3,56.6,429,332,97
060750176011,13.0,10.8,1.5,15,11,4
060750615001,1089.8,930.9,101.7,623,504,119
060750178011,482.6,399.3,65.0,545,404,141
060750615002,839.5,722.1,70.9,591,506,85
060750119022,345.3,288.2,40.8,351,291,60
060750117002,336.9,284.8,38.6,334,270,64
060750119021,879.4,764.8,67.0,800,722,78
060750105002,853.4,669.5,150.4,889,686,203
060750615004,1298.1,1102.5,121.5,790,671,119
060750615006,1634.8,1387.6,170.8,1668,1401,267
060750615003,1343.5,1131.5,142.8,595,488,107
060750104004,429.9,359.7,42.2,452,395,57
060750226002,799.4,739.5,22.9,485,451,34
060750126021,927.6,717.0,160.6,973,695,278
060014287002,348.8,276.3,43.8,211,172,39
060014277003,675.7,543.1,87.5,707,557,150
060014277004,256.6,203.9,33.0,385,329,56
060014276003,244.2,199.1,30.0,310,255,55
060014276002,572.6,465.1,75.2,439,372,67
060014287001,1062.4,876.9,132.0,612,491,121
060019819001,34.0,34.0,0.0,26,22,4
060019820001,46.0,42.1,2.0,82,74,8
060014026001,458.8,406.9,23.5,416,371,45
060014017002,942.0,832.1,23.7,449,442,7
060014018002,360.3,312.2,8.5,325,314,11
060014018001,477.9,418.6,7.0,305,300,5
060014017003,91.1,81.3,2.9,1,1,0
060014022002,347.9,308.0,7.2,269,262,7
060014022001,384.0,346.5,6.1,410,395,15
060014022003,310.0,270.2,6.4,215,210,5
060014105001,809.7,741.1,20.1,717,703,14
060014017001,506.1,428.6,13.4,458,444,14
060014016002,462.1,407.0,6.1,335,325,10
060014220001,795.8,727.7,21.8,524,504,20
060014233002,830.6,747.7,20.6,738,727,11
060014232002,745.5,682.1,19.8,657,634,23
060014233003,716.4,658.6,13.9,647,640,7
060014233001,641.3,578.2,16.9,668,653,15
060014240021,628.3,571.7,16.3,554,539,15
060014232001,587.5,528.9,14.2,570,547,23
060014220002,459.1,411.7,17.7,375,368,7
060014219004,598.0,548.2,19.0,527,501,26
060014221002,972.9,881.2,34.5,905,856,49
060014221001,493.2,451.4,12.0,491,472,19
060014016001,461.8,396.6,12.6,352,350,2
060014015001,584.5,502.3,16.6,427,423,4
060014015002,266.1,227.5,7.2,259,255,4
060014015003,298.5,255.5,8.1,299,289,10
060014251011,193.2,156.3,22.3,609,532,77
060014251012,697.8,564.7,80.7,276,235,41
060014251021,423.3,367.0,31.1,322,286,36
060014251022,568.7,493.0,41.9,495,417,78
060014251032,404.4,368.3,16.8,383,368,15
060014251031,377.5,343.8,15.7,303,279,24
060014251033,506.8,460.2,21.8,496,472,24
060014231003,518.5,478.5,13.0,513,503,10
060014222003,653.8,578.1,18.6,598,577,21
060014222001,739.9,670.7,18.9,808,786,22
060014231001,939.4,836.5,24.1,867,821,46
060014231002,453.5,410.0,11.5,394,372,22
060014219003,673.5,615.8,20.2,632,609,23
060014222002,642.5,574.5,17.5,561,539,22
060014223003,655.9,573.4,30.7,602,565,37
060014219002,737.1,662.7,23.4,662,629,33
060133780001,918.4,786.3,77.5,894,785,109
060133780002,1201.4,986.8,143.8,1082,890,192
060133800003,410.1,372.0,21.0,310,296,14
060133790004,457.7,424.8,13.7,387,378,9
060133800001,1871.2,1606.0,153.4,1660,1478,182
060133790003,359.7,340.6,7.6,371,367,4
060133770004,459.7,410.4,24.8,321,306,15
060133760002,460.6,419.4,20.7,421,397,24
060133770005,379.7,329.2,26.7,428,387,41
060133760003,237.8,220.1,9.6,256,238,18
060133760004,256.2,238.4,8.4,209,194,15
060133770002,227.4,206.9,12.1,150,135,15
060133770003,214.4,197.9,7.5,222,203,19
060014068004,584.9,536.6,29.8,479,442,37
060014069003,814.0,717.0,40.0,741,686,55
060014068003,547.8,473.4,46.1,447,393,54
060014067004,420.6,382.3,18.9,521,450,71
060014067003,916.9,828.4,41.3,770,724,46
060014067002,522.3,460.5,22.6,391,354,37
060014067005,369.0,330.2,20.5,441,394,47
060014086004,302.8,283.7,7.7,268,260,8
060014088003,280.9,264.9,9.5,277,263,14
060014088001,251.3,239.8,5.0,181,178,3
060014087003,351.8,328.7,11.9,383,365,18
060014086002,476.7,442.6,13.9,593,587,6
060014085005,364.3,331.8,14.8,332,327,5
060014086003,372.9,345.9,11.0,287,279,8
060014094001,167.4,154.4,6.5,139,138,1
060014085004,231.6,211.8,9.0,242,241,1
060014085003,245.8,230.3,7.2,244,241,3
060014085002,310.8,291.2,9.2,330,327,3
060014085001,296.5,277.8,8.7,289,286,3
060014087006,362.6,339.3,9.4,326,319,7
060014087002,404.0,376.2,12.1,425,417,8
060014087001,499.7,458.9,22.6,495,480,15
060014077001,855.5,786.6,26.1,756,735,21
060014082003,433.0,389.8,13.6,362,354,8
060014077004,540.3,493.9,16.8,527,512,15
060014078002,392.3,354.7,13.9,598,579,19
060014078001,371.3,335.7,13.1,155,154,1
060014078003,437.4,401.5,14.0,302,286,16
060014086001,470.4,430.9,16.5,480,469,11
060014084001,377.0,345.8,9.5,348,344,4
060014082001,721.0,645.1,30.0,789,756,33
060014096001,244.2,229.5,10.5,206,205,1
060014096005,309.3,290.1,12.6,258,252,6
060014097004,296.4,276.3,10.7,259,252,7
060014096002,260.1,242.4,8.5,291,285,6
060014097002,431.8,400.2,15.6,355,337,18
060014096003,186.6,173.9,6.1,158,156,2
060014096004,201.9,188.1,6.6,185,183,2
060014097003,265.4,245.8,9.7,276,265,11
060014084002,274.6,251.9,6.9,226,222,4
060014084003,414.8,382.7,11.8,450,444,6
060014097001,242.3,223.9,9.1,264,260,4
060014083005,393.1,354.4,16.3,342,334,8
060014083004,309.6,287.4,9.9,350,340,10
060014082002,789.9,713.6,31.8,646,627,19
060014083002,553.3,491.4,26.5,558,533,25
060014083001,382.8,341.0,20.9,360,336,24
060014083003,548.9,487.5,26.3,568,524,44
060014079003,595.0,549.0,24.0,605,549,56
060014069002,702.5,619.3,49.0,689,602,87
060014069001,526.8,468.9,30.8,461,393,68
060014079002,534.4,472.2,33.7,452,412,40
060750331001,511.4,389.2,94.4,351,214,137
060750332011,1132.1,968.7,110.9,1347,1181,166
060750331002,508.9,375.5,109.5,524,360,164
060750309006,380.0,267.0,102.0,341,209,132
060750309007,508.0,391.0,102.0,498,380,118
060750332041,376.8,291.3,53.0,437,356,81
060750313022,646.0,526.5,75.1,528,465,63
060750332031,881.6,703.3,109.6,755,636,119
060750313012,624.1,511.6,79.9,664,569,95
060750313011,443.9,364.4,58.1,427,358,69
060750309004,488.9,369.8,101.1,546,425,121
060750330004,631.2,473.1,138.7,567,432,135
060750330003,799.1,615.5,138.3,787,597,190
060750330006,622.7,485.2,103.8,617,478,139
060750330002,531.7,429.4,80.9,495,382,113
060750330001,636.5,519.4,90.0,654,505,149
060750330005,624.9,487.8,103.8,509,400,109
060750308004,933.1,725.7,160.0,998,736,262
060750329014,572.3,436.8,106.4,504,379,125
060750329013,572.6,437.2,106.8,571,416,155
060750328012,619.6,489.6,100.9,540,412,128
060750328013,521.3,407.9,90.7,520,399,121
060750308003,448.9,340.0,86.0,435,298,137
060750304005,489.4,386.1,73.6,444,359,85
060750308005,979.2,772.1,145.9,882,687,195
060750304004,406.9,317.2,67.7,396,305,91
060750313013,636.3,542.9,63.7,651,580,71
060750312014,518.9,418.2,74.3,487,419,68
060750309003,701.9,555.4,121.4,651,515,136
060750312013,417.2,342.3,57.8,317,267,50
060750309002,753.0,547.9,166.5,791,575,216
060750309005,459.6,332.2,105.3,471,335,136
060750314005,570.0,472.0,70.9,470,424,46
060750314004,476.3,402.1,47.2,442,398,44
060750313021,546.1,459.0,57.6,554,505,49
060750314001,327.8,275.7,37.8,281,246,35
060750312012,589.0,487.5,62.7,607,513,94
060133671001,687.0,624.3,37.5,631,573,58
060133672001,547.1,466.5,56.1,493,419,74
060133671004,379.0,340.3,20.0,496,463,33
060133650031,739.5,677.1,36.7,706,646,60
060133922002,1560.7,1350.5,152.4,1343,1161,182
060133660011,408.9,342.8,48.6,333,275,58
060133660023,693.7,611.4,55.9,618,545,73
060133660012,474.2,409.4,45.2,517,425,92
060133630003,754.9,619.0,94.6,836,693,143
060133650032,107.5,95.5,7.1,139,132,7
060133650033,768.0,682.4,51.0,739,680,59
060133922001,468.3,404.0,46.0,372,304,68
060133922004,446.6,341.8,82.0,410,330,80
060133700001,677.1,576.9,60.8,678,584,94
060133620002,560.5,489.3,42.3,544,500,44
060133620003,621.0,539.6,47.9,593,521,72
060133620001,515.1,444.7,40.8,523,460,63
060133610002,910.7,732.2,129.4,786,659,127
060133690022,401.5,332.6,37.8,409,359,50
060133690023,319.7,270.4,29.9,304,272,32
060133690021,319.1,267.2,35.0,296,246,50
060133630001,738.8,601.4,97.6,733,598,135
060133610003,706.2,534.2,127.0,635,522,113
060133610001,411.8,321.1,65.6,345,289,56
060133602002,540.0,423.4,84.5,475,372,103
060133602003,646.9,500.6,107.6,724,549,175
060133630002,807.7,614.9,141.8,800,644,156
060133602001,885.8,694.7,140.6,817,644,173
060133640022,478.9,376.7,80.8,461,353,108
060133640021,845.6,671.0,139.5,874,685,189
060133630004,501.5,356.8,110.0,485,357,128
060133640023,659.1,487.9,144.1,577,427,150
060133591033,1117.5,870.3,188.9,1061,827,234
060133591022,931.3,707.0,183.0,907,673,234
060133922003,646.5,475.5,135.7,620,468,152
060133591023,726.3,583.1,109.6,638,513,125
060133601013,824.7,625.9,163.4,789,572,217
060133601012,959.0,727.1,179.3,918,722,196
060133591021,353.3,257.1,77.3,558,430,128
060133591031,557.1,424.5,104.0,572,430,142
060133591032,589.4,448.2,113.1,511,355,156
060014277002,1247.2,1017.1,153.9,859,704,155
060014506022,978.3,626.8,292.0,936,573,363
060014506023,1201.5,756.8,360.1,1263,773,490
060014506025,1475.9,892.8,500.6,1391,807,584
060014506024,441.5,275.3,133.4,495,291,204
060014506062,760.8,475.0,243.5,850,507,343
060014506032,393.5,243.8,125.1,382,241,141
060014506061,1200.6,746.6,368.8,1133,765,368
060014506034,593.5,365.3,185.6,682,408,274
060014506033,914.9,557.5,302.0,824,525,299
060014506063,1181.0,752.0,365.0,1243,752,491
060014505012,1172.0,718.4,371.5,1274,815,459
060014505011,322.0,197.9,99.9,399,245,154
060014506021,436.6,308.6,106.8,337,241,96
060014504003,1443.8,901.0,437.2,1090,709,381
060133451014,713.5,452.0,217.0,624,429,195
060133451012,904.4,566.4,278.7,1138,673,465
060133451011,393.2,245.7,120.2,401,255,146
060014504001,876.4,521.7,287.1,842,550,292
060014503001,1009.8,652.4,263.6,959,653,306
060014504002,675.9,419.8,208.0,667,437,230
060133451013,524.8,315.5,183.4,550,339,211
060133451032,597.5,353.0,213.6,653,368,285
060014503002,1140.4,766.8,287.0,1150,787,363
060014506031,359.9,219.6,108.2,470,294,176
060014507431,626.1,456.9,145.4,740,517,223
060014502003,605.2,430.3,135.0,441,316,125
060014501021,151.7,110.6,31.8,100,59,41
060133451031,832.0,541.0,248.3,895,537,358
060014502001,614.6,440.4,140.6,677,465,212
060014028002,967.5,875.0,38.1,352,311,41
060014029001,615.7,509.8,50.1,568,504,64
060014014003,479.4,410.4,17.3,348,335,13
060014027001,215.9,185.1,8.9,170,167,3
060014034001,542.0,487.1,19.6,614,537,77
060014013002,627.8,567.4,17.9,391,370,21
060014013003,461.8,411.1,13.7,296,276,20
060014035011,1069.5,936.1,68.3,829,758,71
060014034002,668.6,590.8,24.1,519,473,46
060014034003,504.0,418.0,53.0,464,420,44
060014034004,575.8,520.4,22.3,408,385,23
060014053021,678.8,585.9,40.5,641,576,65
060014060003,639.7,545.6,55.7,561,511,50
060014053012,531.9,474.7,15.4,480,467,13
060014052004,849.0,755.4,24.8,706,672,34
060014035012,1187.1,1077.3,37.8,971,929,42
060014037011,834.9,755.8,25.4,733,673,60
060014035021,503.6,459.1,12.0,491,457,34
060014037012,1036.1,932.2,28.6,833,801,32
060014284003,611.3,488.5,76.1,622,496,126
060014284002,472.8,384.1,49.6,413,339,74
060014279002,725.2,575.4,101.0,650,508,142
060014280001,274.3,229.4,31.8,217,180,37
060014280002,934.4,777.8,110.3,954,780,174
060014282002,1016.9,815.8,158.0,993,751,242
060014282001,678.9,545.0,111.3,648,492,156
060014282003,623.8,505.8,75.5,591,486,105
060014282005,631.8,515.2,86.1,576,468,108
060014281003,616.7,496.1,74.6,601,494,107
060014282004,707.8,572.0,89.3,576,471,105
060014281004,480.9,384.8,60.5,486,391,95
060014279003,457.5,375.1,57.1,353,285,68
060014279001,520.8,439.3,53.3,454,365,89
060014279005,533.9,443.0,61.0,466,398,68
060014273001,575.8,462.2,79.0,630,523,107
060014273002,782.5,637.6,106.5,688,551,137
060014279004,542.2,431.4,78.2,455,379,76
060014272004,288.5,245.4,27.1,297,249,48
060014272003,427.1,362.9,41.7,425,348,77
060014272002,757.6,627.8,90.2,574,463,111
060014272001,406.0,331.5,51.1,368,305,63
060014281002,760.2,632.7,82.0,687,562,125
060014281001,885.2,727.4,110.6,727,563,164
060014271003,1052.8,850.2,148.5,1111,862,249
060014271002,507.1,408.9,71.4,565,422,143
060014271001,535.2,441.2,67.2,506,421,85
060014272005,49.8,41.9,5.6,0,0,0
060014061001,277.6,244.2,11.5,259,245,14
060014061004,562.4,488.4,34.7,324,297,27
060014061003,495.6,430.4,30.6,434,387,47
060014060001,365.5,303.8,30.5,343,319,24
060014062021,176.0,158.5,8.3,132,119,13
060014062022,299.8,270.0,14.2,208,188,20
060014062023,298.7,266.2,15.8,234,210,24
060816009002,797.3,579.9,181.6,682,476,206
060750331003,377.0,263.0,96.0,379,242,137
060750331004,730.7,532.6,165.9,654,438,216
060750353005,570.4,445.3,85.9,502,408,94
060750353004,411.2,319.7,62.7,358,275,83
060750353003,431.7,330.2,72.9,438,330,108
060750353002,628.9,477.1,115.7,570,415,155
060816029002,1008.2,764.3,181.8,764,596,168
060816027004,775.2,612.2,114.1,600,460,140
060816027003,772.3,614.6,111.9,466,374,92
060816037001,1249.6,921.8,267.2,1079,792,287
060816140001,1252.4,935.4,259.0,913,654,259
060816026002,748.3,599.8,122.2,682,508,174
060816026001,504.4,404.2,82.4,423,305,118
060816026003,918.6,735.7,149.9,664,461,203
060816025002,635.9,496.3,121.7,609,450,159
060816037002,1345.2,998.8,281.3,1274,940,334
060816026004,664.7,532.2,108.5,607,429,178
060816028003,466.0,355.7,92.4,381,285,96
060816028002,860.2,671.1,146.4,826,635,191
060816027002,605.1,493.0,86.1,533,416,117
060816027001,382.1,310.9,57.6,341,255,86
060816015013,526.5,413.4,90.5,456,326,130
060816014003,829.7,659.9,139.8,674,491,183
060816014002,873.2,693.1,149.4,926,648,278
060816015021,838.5,665.0,141.8,504,402,102
060816016054,596.3,466.2,110.3,564,411,153
060816016041,923.0,750.0,142.4,769,591,178
060990004031,1443.3,625.2,720.0,1523,668,855
060990004032,554.2,245.8,278.0,564,247,317
060990009123,5599.5,2659.8,2632.0,4752,2422,2330
060990004022,223.1,100.4,111.0,230,79,151
060990004024,300.8,129.5,153.1,363,158,205
060990003032,529.2,237.8,261.0,462,238,224
060990004025,300.0,133.7,148.9,205,106,99
060990003042,457.7,242.0,190.1,404,231,173
060990003031,739.9,368.9,331.9,725,390,335
060990003022,282.2,139.7,127.3,355,164,191
060990003023,339.3,168.9,152.4,357,151,206
060990020041,395.0,222.9,145.8,423,242,181
060990009063,816.1,364.6,396.3,999,472,527
060990003012,223.5,111.7,100.1,167,94,73
060990003033,741.7,370.6,332.2,570,376,194
060990003011,396.3,197.8,177.1,309,181,128
060990003021,253.0,126.4,113.3,67,42,25
060990004021,558.8,152.2,376.6,487,160,327
060990003043,500.1,298.7,173.1,378,249,129
060990003041,289.5,172.9,100.2,224,146,78
060990020022,259.3,133.2,112.0,246,139,107
060990020021,585.0,297.2,256.4,622,352,270
060990020023,279.4,141.6,119.2,174,103,71
060990028031,633.7,266.8,326.7,534,267,267
060990028023,538.5,152.5,360.8,575,212,363
060990029021,769.0,283.2,449.6,781,312,469
060470004011,428.4,157.1,256.2,407,176,231
060470009011,354.6,96.1,243.0,412,150,262
060470004022,483.8,107.6,361.0,541,160,381
060470003031,267.1,108.2,146.6,281,132,149
060470003032,226.5,96.3,118.4,211,102,109
060470004023,702.2,209.4,451.7,660,260,400
060470004021,431.7,117.2,299.0,438,169,269
060470004024,895.4,218.6,626.9,788,306,482
060470002021,314.8,165.9,132.7,353,198,155
060470002031,330.2,215.5,92.9,311,212,99
060470002034,299.4,218.1,61.8,217,164,53
060470002035,274.2,199.8,56.6,208,137,71
060470002033,359.2,251.1,84.2,142,105,37
060470002032,772.2,522.3,200.3,462,296,166
060470003044,375.6,301.6,57.3,177,151,26
060470003011,248.7,193.5,40.9,257,207,50
060470003045,997.9,797.3,158.1,522,389,133
060470003012,192.6,150.8,30.7,148,125,23
060855069003,1171.0,770.4,325.2,1223,704,519
060871222032,746.9,485.8,208.1,759,564,195
060871223003,1184.9,894.5,212.8,1227,943,284
060871223002,565.6,373.9,152.9,413,288,125
060871106001,669.5,553.2,84.9,541,448,93
060871106002,336.9,278.0,43.5,323,259,64
060871107003,308.2,237.6,51.5,260,204,56
060871104003,275.4,225.4,37.4,175,153,22
060871106005,427.6,358.6,44.8,353,317,36
060871104004,919.5,738.0,140.3,681,551,130
060871105014,376.4,303.5,50.1,314,259,55
060871105022,641.3,521.5,90.3,397,348,49
060871105013,377.9,306.7,53.7,498,384,114
060871105012,356.5,290.6,43.1,253,207,46
060871107001,418.4,323.2,69.8,391,301,90
060871107002,304.6,233.3,52.0,298,234,64
060871106003,350.8,292.3,38.7,250,204,46
060871106004,520.9,394.0,98.2,337,272,65
060871231001,481.9,333.3,115.4,494,357,137
060871231002,407.5,281.8,97.5,454,334,120
060530104003,0.0,0.0,0.0,269,226,43
060530104004,541.3,467.5,55.8,221,200,21
060530104002,199.0,171.8,20.5,342,286,56
060530104001,579.7,500.7,59.7,295,258,37
060530147004,812.4,504.6,256.5,590,440,150
060855027022,721.9,486.3,186.1,768,533,235
060855027023,581.8,376.2,169.6,578,394,184
060855027011,658.7,460.0,153.3,810,542,268
060855027012,849.3,582.5,215.0,755,506,249
060855026042,554.6,417.7,101.3,461,353,108
060855026043,347.7,261.9,63.5,364,279,85
060855027013,654.3,456.8,148.1,507,362,145
060855065023,797.4,584.6,160.9,786,596,190
060855026041,946.5,661.0,216.8,628,462,166
060855026033,467.6,321.1,114.9,627,381,246
060855068044,305.2,207.9,76.6,346,230,116
060855068043,591.6,401.1,152.5,659,440,219
060855068042,590.2,392.9,158.9,614,409,205
060855068023,393.5,265.4,99.8,380,263,117
060855069002,1011.1,657.8,288.4,1050,639,411
060855068032,558.5,381.3,137.7,682,474,208
060855068034,426.3,296.3,100.7,500,315,185
060855068025,470.4,316.0,120.5,511,334,177
060855068024,292.3,194.8,72.4,303,224,79
060855068022,613.5,419.6,144.5,654,435,219
060855028003,567.4,351.2,175.9,556,352,204
060855028001,662.7,408.9,206.8,633,406,227
060855068031,832.2,530.3,243.9,934,607,327
060855068033,1043.6,723.5,249.4,978,687,291
060855028002,724.9,486.8,187.2,723,509,214
060855029081,911.6,626.3,218.4,826,553,273
060855069001,550.5,357.6,166.4,589,375,214
060855119161,820.4,556.8,202.2,729,502,227
060855119162,1255.1,827.1,350.0,1233,773,460
060855029082,1211.7,827.0,296.5,1287,903,384
060855029083,820.5,553.2,204.3,885,571,314
060855029062,807.8,551.0,201.8,867,567,300
060855029063,685.2,458.7,176.4,679,487,192
060855029061,535.7,372.6,126.4,359,276,83
060855029013,488.1,341.9,112.8,494,345,149
060855029012,799.6,565.7,184.1,763,525,238
060855029014,831.1,573.5,193.2,769,534,235
060855029023,1258.5,880.1,292.1,1018,714,304
060855029022,1314.8,939.7,280.0,1299,891,408
060855029021,1401.5,972.3,341.4,1407,904,503
060855029011,673.2,468.9,155.8,654,436,218
060855026012,484.8,317.3,136.9,94,60,34
060855026011,413.1,278.7,105.7,250,168,82
060855026013,744.5,487.3,212.8,666,395,271
060855023011,826.0,560.1,212.5,751,509,242
060855029032,810.5,563.1,194.5,818,545,273
060855074012,743.3,540.4,171.6,642,447,195
060855074015,469.2,327.6,117.3,433,282,151
060855074013,771.7,555.4,177.6,827,527,300
060855075003,791.6,566.7,189.4,703,445,258
060855075002,741.4,530.8,174.2,784,491,293
060855075004,766.5,535.0,190.7,817,498,319
060855074014,647.9,460.0,153.3,645,414,231
060855073011,420.0,287.2,107.1,411,271,140
060855073012,757.5,518.0,195.8,734,434,300
060855074023,708.9,499.1,171.2,595,396,199
060855073016,801.3,523.4,229.4,818,463,355
060855073015,841.9,543.7,245.1,901,519,382
060855074021,751.3,526.1,182.5,670,449,221
060855066042,789.5,548.9,183.3,783,543,240
060855074022,600.0,414.8,149.3,611,392,219
060855066045,731.6,525.0,170.2,671,423,248
060855070012,1764.7,1192.7,476.0,1841,1244,597
060855070011,1050.9,761.4,234.6,1085,751,334
060855071002,936.0,667.3,209.7,838,638,200
060855072062,819.9,548.5,222.4,832,539,293
060855072061,837.5,550.1,233.0,905,525,380
060855071001,568.2,403.3,127.6,544,389,155
060855072054,460.7,305.2,126.3,528,311,217
060855072052,1012.7,661.0,299.5,1097,675,422
060855072032,677.9,466.0,171.2,713,467,246
060855070013,733.6,523.9,177.2,796,549,247
060855069004,1368.4,938.0,343.5,1273,840,433
060855070021,1157.3,817.0,286.3,1086,733,353
060855068011,1039.1,713.5,253.9,903,642,261
060855072053,873.4,581.0,233.5,792,517,275
060855072031,658.2,446.0,171.7,540,372,168
060855066044,727.5,479.0,195.4,734,525,209
060855067013,730.0,489.9,196.9,731,473,258
060855067011,327.1,214.9,88.6,341,232,109
060855067012,820.4,588.0,181.8,790,547,243
060855072051,365.9,247.7,89.1,352,225,127
060855066041,334.7,236.0,81.6,286,211,75
060855066043,778.0,535.9,182.5,848,585,263
060855066032,947.1,640.4,236.1,970,625,345
060855066012,394.4,281.4,92.6,528,373,155
060855066011,681.1,487.4,158.0,714,467,247
060855066033,579.5,407.6,130.4,548,374,174
060855067033,321.6,231.3,69.9,302,224,78
060855067032,353.1,253.9,76.7,427,303,124
060855067031,935.0,631.0,248.0,896,582,314
060855067022,898.3,607.5,234.3,908,653,255
060855091051,783.3,606.6,128.0,622,466,156
060855091052,660.7,524.4,95.0,689,539,150
060855091062,245.2,185.1,44.3,487,363,124
060855091071,538.2,433.0,71.6,455,368,87
060855091072,733.5,556.5,129.7,489,395,94
060855091021,787.8,620.7,121.4,908,698,210
060855086013,440.9,338.2,77.9,562,423,139
060855091061,516.1,395.8,91.1,438,324,114
060855084031,315.9,220.9,68.9,399,292,107
060855084032,575.7,446.2,105.1,578,411,167
060855084033,404.0,308.4,72.9,396,303,93
060855084043,738.9,536.3,155.7,743,494,249
060855084042,663.2,475.6,146.3,736,546,190
060855084041,1049.9,750.3,228.4,1187,842,345
060855086023,364.6,272.9,65.4,238,171,67
060855085031,571.0,417.4,106.6,458,335,123
060855085044,658.7,501.4,115.6,498,370,128
060855085033,800.5,619.8,132.2,796,629,167
060855085032,379.5,293.4,62.8,510,388,122
060855086012,715.0,514.4,160.5,773,548,225
060855086011,283.0,203.6,63.5,241,175,66
060855091022,690.2,547.3,91.6,681,523,158
060855086022,626.3,468.8,112.3,556,404,152
060855086021,637.0,495.0,99.3,656,510,146
060855091084,507.0,405.4,64.4,523,416,107
060855091091,1189.0,989.0,128.8,1144,914,230
060855091082,358.9,281.7,51.7,261,215,46
060855091092,643.2,516.3,79.4,635,511,124
060855097002,506.8,434.1,44.2,296,236,60
060855047001,78.0,45.0,27.0,85,45,40
060855046011,371.3,270.0,76.2,352,251,101
060855046021,704.5,564.7,100.4,594,470,124
060855048032,1304.4,1018.0,221.6,1268,961,307
060855048031,559.1,416.4,106.0,406,301,105
060855048051,1715.7,1200.8,404.4,1532,1065,467
060855073022,568.8,355.2,172.1,529,317,212
060855073021,837.3,537.2,231.2,1019,608,411
060855073013,467.8,308.1,134.4,572,308,264
060855073014,447.6,294.8,128.6,434,252,182
060855075001,969.5,666.9,247.6,917,652,265
060855076003,1033.9,692.4,276.4,975,617,358
060855076002,630.9,438.5,152.5,722,441,281
060855074011,546.3,388.5,128.4,552,368,184
060816134003,850.7,615.4,175.6,795,574,221
060816132002,1009.7,754.9,182.3,961,619,342
060816134001,712.9,515.6,150.9,585,349,236
060816132001,985.7,806.9,123.5,947,734,213
060816133001,992.0,634.0,296.0,949,575,374
060816133002,712.6,504.6,158.2,801,528,273
060816111001,1581.3,1168.8,328.0,1504,1017,487
060816111003,691.2,536.7,118.6,455,326,129
060816097002,1505.9,1048.6,362.9,1495,1043,452
060816096032,962.8,698.6,216.4,871,562,309
060816096031,1026.0,752.7,224.1,888,633,255
060816096034,457.7,327.8,106.9,456,304,152
060816096033,1039.6,764.9,225.3,824,542,282
060816098004,743.8,520.2,171.7,696,484,212
060855120214,610.0,443.0,131.0,539,392,147
060855120421,656.0,478.2,144.5,534,354,180
060855120171,755.2,557.8,150.7,815,547,268
060855120172,740.3,573.9,135.7,690,509,181
060855032181,633.7,518.4,93.3,480,384,96
060855032182,317.3,259.6,46.7,202,154,48
060855032173,303.5,256.8,31.7,249,190,59
060855032172,342.5,289.8,35.8,199,152,47
060855032171,329.0,278.4,34.4,312,227,85
060855120173,882.7,691.4,143.0,736,514,222
060855032082,656.1,521.2,104.8,500,324,176
060855032081,564.5,456.3,83.7,453,378,75
060855032102,603.6,467.8,117.6,565,373,192
060855032071,929.6,684.7,201.8,879,516,363
060855120221,438.6,323.2,89.7,499,357,142
060855120422,421.3,318.3,74.4,371,269,102
060855120432,614.0,469.9,104.8,589,427,162
060855120431,730.9,577.1,110.4,587,437,150
060855120013,703.6,503.9,156.4,770,561,209
060855120332,1630.6,1191.9,344.8,791,535,256
060855120333,557.6,352.0,160.9,597,374,223
060855120334,700.8,444.8,203.1,618,419,199
060855120323,532.7,356.0,133.8,501,338,163
060855120321,551.0,384.4,126.6,545,370,175
060855120322,527.2,352.4,132.2,434,309,125
060855120391,516.4,366.5,120.1,409,273,136
060855120392,507.3,361.5,117.2,573,400,173
060855120342,192.8,135.4,43.8,323,224,99
060855120341,836.5,574.0,207.0,1092,751,341
060855120351,1136.2,773.0,280.8,972,649,323
060855120261,832.9,571.6,214.4,789,570,219
060855120352,1131.8,757.7,302.0,936,626,310
060855033342,766.6,556.3,175.0,748,469,279
060855032101,726.0,584.0,105.0,581,350,231
060855032072,602.9,437.5,137.6,520,299,221
060855032122,803.6,605.0,168.8,753,460,293
060855032121,309.4,234.3,59.8,345,215,130
060855032112,815.3,631.6,141.0,796,502,294
060855032123,445.6,334.6,94.8,342,213,129
060816132005,419.5,303.9,83.1,457,281,176
060816130002,834.9,646.7,143.4,807,566,241
060855117051,545.7,455.2,61.2,515,431,84
060855116081,3.2,2.9,0.1,73,68,5
060855130001,810.3,735.3,23.9,1153,1053,100
060855116082,346.8,316.3,10.9,506,466,40
060855116091,1251.8,1046.0,148.9,1344,1036,308
060855115005,1005.0,940.0,27.0,1022,950,72
060816130001,965.6,739.6,175.8,882,583,299
060816129002,442.2,355.2,64.1,460,315,145
060816129001,961.7,790.8,125.8,936,738,198
060816114002,418.1,282.2,98.8,405,226,179
060816114003,778.0,507.7,199.0,844,475,369
060816128002,832.0,667.1,119.3,841,610,231
060816129004,567.2,453.2,86.7,624,411,213
060816128001,1085.8,827.1,187.2,1091,770,321
060816129003,486.6,411.3,56.6,480,396,84
060816114001,403.3,289.1,84.1,402,253,149
060816113001,675.6,500.7,141.8,626,458,168
060816113004,674.9,514.3,125.7,596,427,169
060816107002,1340.1,1030.6,229.4,1038,763,275
060816107001,789.7,635.6,113.9,689,559,130
060816114004,720.0,425.0,244.0,805,427,378
060816106012,372.9,308.3,46.1,364,302,62
060816106013,470.1,386.9,54.2,193,162,31
060816105002,318.4,259.4,45.9,225,193,32
060816106023,766.4,639.0,80.6,593,491,102
060816106011,270.7,242.3,18.7,213,188,25
060816102031,264.5,222.8,32.1,181,156,25
060816102013,206.2,173.6,25.0,111,86,25
060816102011,166.9,140.5,20.2,95,78,17
060816102012,377.7,319.2,44.0,357,312,45
060816115002,612.9,433.8,148.1,661,408,253
060816105001,233.0,187.2,35.3,194,144,50
060816105003,187.1,152.3,27.1,116,102,14
060816106022,435.7,332.2,80.1,424,324,100
060816106021,384.5,302.8,58.7,344,277,67
060816105004,445.8,357.2,67.5,388,311,77
060816104002,945.9,790.2,105.4,731,602,129
060816104001,750.1,617.8,93.6,614,501,113
060816127002,792.4,595.4,142.5,836,564,272
060816126003,449.3,351.5,80.2,457,310,147
060816126002,660.6,551.9,74.5,473,377,96
060816127001,478.3,401.0,51.9,547,407,140
060816126004,715.3,600.0,77.4,549,442,107
060816126001,475.0,399.4,50.4,488,381,107
060816125003,1008.0,853.0,115.0,790,617,173
060816139003,630.1,538.6,55.8,572,481,91
060855113011,1358.3,1141.5,136.3,1281,1079,202
060855113022,424.8,365.5,40.8,379,309,70
060855113021,744.4,638.0,72.1,687,562,125
060855113012,711.4,598.6,72.4,870,751,119
060855113023,1020.7,873.7,93.8,1036,891,145
060855114001,424.8,348.9,46.6,419,348,71
060816125002,584.0,454.0,102.0,479,334,145
060816125001,599.0,527.0,45.0,556,441,115
060816115003,518.4,353.4,129.3,506,295,211
060816115001,428.3,291.9,106.8,481,268,213
060816116002,668.0,530.5,93.2,643,481,162
060816116001,586.8,490.4,64.8,523,409,114
060816139005,1231.6,1054.0,109.1,955,733,222
060816139004,454.1,378.2,52.2,459,372,87
060816139002,461.8,395.6,40.4,437,372,65
060816117002,637.6,563.4,49.4,473,455,18
060816057003,841.1,519.0,276.0,785,468,317
060816068001,769.9,546.6,184.2,729,474,255
060816069001,544.8,436.3,90.1,515,364,151
060855037073,321.6,267.3,36.3,280,233,47
060855036012,518.4,430.9,58.6,283,234,49
060855037072,614.0,495.9,87.1,449,314,135
060855036022,496.7,392.9,77.5,428,296,132
060855036023,272.4,207.3,50.6,208,130,78
060855037113,320.2,274.1,33.7,222,192,30
060855037111,239.4,204.9,25.2,150,120,30
060855037101,343.4,293.9,36.1,253,202,51
060855031112,442.1,351.7,64.7,376,275,101
060855031111,274.1,218.8,38.6,188,135,53
060855034013,487.0,422.8,46.6,384,323,61
060855034012,427.2,377.9,35.6,325,273,52
060855034011,283.9,251.1,23.6,224,186,38
060855034022,497.6,428.4,50.5,355,295,60
060855034023,565.8,479.2,72.8,375,272,103
060855034021,27.5,23.6,2.9,105,82,23
060855035041,306.3,272.0,21.4,204,176,28
060855035042,355.4,315.6,24.8,340,290,50
060855035044,224.9,195.5,23.6,167,142,25
060855035043,370.5,321.9,39.2,207,173,34
060855037112,378.1,309.9,51.1,289,207,82
060855037102,369.9,303.1,49.9,373,289,84
060855037032,321.5,274.2,35.0,263,218,45
060855037033,397.0,338.6,43.2,290,231,59
060855037031,164.5,140.3,17.9,110,92,18
060855040022,785.7,704.6,65.1,579,500,79
060855120302,612.0,389.3,177.1,552,378,174
060855120371,845.4,564.5,225.0,836,553,283
060855120372,505.2,342.7,129.7,496,337,159
060855120291,876.9,608.6,206.0,798,553,245
060855120292,940.3,644.0,235.6,875,584,291
060855120233,604.4,471.8,96.6,439,333,106
060855120231,528.5,387.1,107.7,631,481,150
060855120232,550.1,414.2,101.8,446,324,122
060855120223,548.4,427.7,90.3,401,296,105
060855120314,508.8,332.2,141.2,525,329,196
060855120312,594.1,411.7,142.2,625,419,206
060855120313,555.2,369.9,147.0,587,365,222
060855120311,355.9,248.3,83.6,326,225,101
060855120361,1054.0,758.0,249.0,1420,1017,403
060855120294,905.9,620.8,217.8,849,580,269
060855120293,393.9,267.7,93.6,394,274,120
060855120222,730.0,508.0,179.0,708,474,234
060855120212,755.9,537.1,171.4,667,472,195
060855120213,583.1,415.5,131.1,532,382,150
060855120211,676.9,492.1,153.4,656,446,210
060855120201,401.5,291.9,91.0,457,297,160
060855120054,750.3,516.6,185.2,748,506,242
060855120051,570.1,395.1,139.1,685,453,232
060855120242,633.4,422.4,164.3,550,368,182
060855120241,1349.2,945.2,311.9,1322,951,371
060855120053,326.3,202.0,98.6,411,254,157
060855120052,285.7,176.9,86.4,403,239,164
060855030021,683.0,488.7,150.9,679,443,236
060855031082,1276.3,918.8,285.6,1421,1029,392
060855031081,707.1,526.9,133.9,447,316,131
060855031232,491.3,382.6,76.1,404,293,111
060855031084,360.0,292.0,53.0,238,183,55
060855031083,308.7,238.2,51.4,129,94,35
060855120533,422.2,259.8,131.9,423,271,152
060855120473,775.9,487.4,236.5,803,521,282
060855119111,925.8,604.3,274.0,983,683,300
060855120522,850.8,585.5,216.8,761,538,223
060855120523,410.0,281.1,105.8,504,325,179
060855120532,570.9,395.6,144.4,668,442,226
060855120531,789.0,575.0,170.9,715,530,185
060855120272,1031.0,734.0,228.0,878,608,270
060855120472,813.5,530.7,235.3,815,535,280
060855120471,937.6,614.5,269.0,835,567,268
060855120454,861.8,558.1,246.5,826,549,277
060855120453,429.9,277.7,121.5,435,274,161
060855120452,540.6,351.6,150.2,485,321,164
060855120451,952.5,634.7,247.3,876,588,288
060855120262,787.3,541.8,201.2,658,463,195
060855120055,983.0,657.0,261.0,1008,698,310
060855120251,1102.7,719.3,321.1,1068,674,394
060855120252,505.4,332.6,145.6,511,323,188
060855120191,440.1,278.6,136.4,414,257,157
060855031161,1228.3,878.5,290.2,1050,736,314
060855031151,2686.2,1914.3,619.4,2421,1739,682
060855031162,652.5,473.2,140.4,707,493,214
060855120192,786.9,583.0,145.4,662,491,171
060855120193,662.0,501.5,111.4,663,457,206
060855120202,701.0,530.0,130.0,682,456,226
060014502002,1012.7,751.5,195.6,916,649,267
060855119133,868.2,577.1,247.2,930,563,367
060855119132,880.7,588.5,245.5,717,422,295
060855119131,676.6,447.4,194.5,711,455,256
060855119152,629.4,444.9,152.3,419,288,131
060855119151,334.1,233.2,83.5,553,373,180
060855119142,1451.5,928.0,440.8,1518,966,552
060855029101,415.9,278.1,107.0,494,335,159
060855029072,933.3,619.7,251.2,978,643,335
060855029091,551.3,372.9,140.4,541,368,173
060855029092,383.4,262.9,96.9,466,323,143
060855029093,737.2,506.2,185.0,619,441,178
060855119143,839.0,522.2,252.9,798,488,310
060855119141,716.0,453.8,215.1,706,445,261
060855119071,680.7,425.8,220.3,653,402,251
060855120521,361.4,245.4,96.1,310,225,85
060855029102,307.6,208.8,76.8,397,260,137
060855029103,265.0,179.9,66.1,186,136,50
060855120271,715.5,499.2,176.4,588,449,139
060855030031,502.8,325.7,142.8,498,335,163
060855029071,988.9,686.8,230.9,1030,689,341
060855030033,747.3,466.3,227.4,739,464,275
060855030034,351.7,221.0,105.6,300,211,89
060855030032,998.2,631.0,305.2,1059,695,364
060855030013,1092.8,763.8,270.1,1053,720,333
060855029031,1290.9,898.4,324.4,1283,823,460
060855030012,555.8,383.9,139.6,548,358,190
060855030022,1104.4,756.5,282.1,1074,691,383
060855030011,716.6,498.3,179.0,680,464,216
060855029094,429.8,321.7,79.6,392,293,99
060855029104,401.2,300.3,74.4,407,299,108
060855114004,562.1,462.9,69.7,700,558,142
060855115002,1001.7,831.5,120.5,841,720,121
060855109001,820.5,681.2,98.7,925,774,151
060855109003,811.8,656.5,105.9,870,706,164
060855109002,1072.7,881.8,131.9,960,781,179
060855110002,694.9,566.3,92.3,656,540,116
060855110005,816.3,658.5,112.1,730,579,151
060855111004,704.3,582.4,91.7,743,605,138
060855111003,714.7,588.6,100.3,693,554,139
060855111002,762.9,623.4,104.1,808,640,168
060855111001,1014.1,861.6,112.9,928,776,152
060816139001,319.9,274.6,27.6,368,315,53
060816121001,469.1,403.0,37.6,456,367,89
060855112001,793.2,663.9,83.1,857,680,177
060855112002,866.0,720.5,90.3,916,747,169
060816121004,107.3,91.5,9.2,49,42,7
060816121005,330.9,282.2,28.3,242,209,33
060816121002,369.6,315.1,31.6,284,249,35
060816121003,413.2,355.2,29.0,239,203,36
060816120001,374.4,339.7,18.8,237,224,13
060816120002,499.1,462.1,24.6,426,395,31
060816120004,380.9,343.0,22.8,285,257,28
060816120003,394.2,361.8,17.7,271,260,11
060816119005,708.3,584.8,76.5,545,458,87
060816118002,524.8,471.4,19.9,538,500,38
060816119006,561.9,499.4,35.6,398,362,36
060816119002,371.5,328.4,23.2,441,415,26
060816119001,241.3,203.4,20.3,165,156,9
060855108031,670.0,548.9,86.2,695,599,96
060855108032,617.0,515.7,76.3,549,447,102
060855108012,1149.7,937.6,153.9,1064,831,233
060855108011,939.0,786.2,109.3,911,771,140
060855110004,640.6,495.5,104.5,517,400,117
060855108013,1017.3,813.2,155.8,759,614,145
060855093041,490.1,403.2,54.1,301,236,65
060816119003,453.0,421.8,16.7,374,370,4
060816119004,364.5,344.5,10.4,283,272,11
060855102002,667.0,509.8,124.3,612,454,158
060855105003,1243.9,915.4,255.7,1329,910,419
060855103002,961.2,718.8,192.9,808,574,234
060855103001,904.8,701.2,142.1,953,687,266
060855102001,1044.6,769.9,204.5,1003,698,305
060855098013,681.7,569.1,73.3,647,512,135
060855105002,938.8,740.6,154.1,1032,737,295
060855105001,588.4,461.0,99.3,510,367,143
060855117011,681.3,493.8,142.7,800,543,257
060855107003,972.2,721.7,179.1,829,648,181
060855107002,820.7,681.8,90.1,685,554,131
060855094012,326.0,251.3,53.6,301,235,66
060855094011,476.7,385.4,62.1,452,375,77
060855094013,307.3,249.3,39.3,225,188,37
060855104003,604.4,476.4,100.3,529,390,139
060855104002,422.7,331.4,72.0,495,353,142
060855104001,892.8,682.5,173.9,749,511,238
060855094044,453.7,373.9,57.9,330,273,57
060855094041,541.3,446.1,69.1,630,515,115
060855093021,1591.3,1258.4,228.8,1548,1232,316
060855094042,297.4,245.9,32.4,303,254,49
060855094043,495.8,412.6,52.3,503,409,94
060855098011,756.1,601.2,108.4,505,415,90
060855098012,363.1,285.6,53.8,449,355,94
060855094031,512.3,415.1,61.7,401,336,65
060855094032,595.5,482.4,71.7,567,487,80
060855093034,339.3,271.8,50.2,290,231,59
060855093032,346.2,277.6,49.8,347,264,83
060855108022,553.2,466.1,61.0,539,430,109
060855108021,486.1,409.6,53.6,523,431,92
060855093031,475.9,382.3,63.0,428,329,99
060855093042,704.9,579.8,77.9,717,608,109
060855115001,582.5,520.0,40.2,564,468,96
060855130002,405.8,365.7,10.9,403,341,62
060855130003,405.5,365.4,10.9,279,243,36
060855114002,597.3,493.9,64.5,655,528,127
060855114003,412.1,340.9,44.4,458,369,89
060855112003,463.4,406.2,39.4,497,419,78
060855112004,573.5,506.0,45.0,602,514,88
060855107001,347.1,300.5,29.8,364,311,53
060855078071,549.4,415.8,102.5,543,381,162
060855078083,516.1,394.8,92.1,307,195,112
060855080014,370.6,274.1,77.6,363,259,104
060855078063,659.8,512.2,119.2,592,455,137
060855077013,596.5,432.5,134.2,603,418,185
060855078053,546.8,408.4,111.0,499,341,158
060855080013,1005.4,732.9,224.4,964,716,248
060855078072,786.9,593.2,158.4,659,495,164
060855078081,443.4,338.0,90.1,328,208,120
060855078062,564.1,424.1,117.4,451,330,121
060855079052,594.7,409.8,151.6,709,480,229
060855079051,611.4,416.6,160.3,459,328,131
060855079061,464.2,324.1,114.7,552,406,146
060855077011,469.8,351.9,93.8,481,348,133
060855078051,1004.2,755.6,194.8,703,504,199
060855078052,566.9,420.5,111.6,515,364,151
060855083013,829.8,626.4,163.3,911,656,255
060855083012,689.1,520.5,135.4,701,493,208
060855078061,405.3,303.1,86.2,547,401,146
060855084014,427.1,333.2,68.2,458,340,118
060855084013,566.3,428.3,96.9,455,344,111
060855100011,493.4,385.5,82.3,522,343,179
060855083032,749.7,574.1,140.3,696,474,222
060855083031,705.2,526.6,141.0,721,499,222
060855083045,541.0,424.1,88.1,579,442,137
060855081013,671.5,523.5,115.9,818,597,221
060855082033,951.5,711.3,187.4,927,667,260
060855083044,290.4,226.1,47.6,441,334,107
060855083043,287.6,225.4,47.8,270,208,62
060855083041,679.9,501.8,138.6,675,475,200
060855083042,535.3,410.2,97.5,400,276,124
060855082032,614.6,458.0,121.2,609,445,164
060855117042,411.5,289.9,94.8,374,245,129
060855117013,593.2,420.3,129.7,545,369,176
060855103003,595.6,430.8,132.7,617,424,193
060855115004,684.0,614.0,38.0,626,570,56
060855115003,1031.0,878.0,92.0,1015,858,157
060855106003,1215.6,946.6,178.8,1044,804,240
060855106001,333.7,283.2,34.2,391,338,53
060855106004,559.9,439.2,91.2,506,398,108
060855106002,939.9,787.2,104.0,1044,869,175
060014370003,514.0,404.3,85.4,362,277,85
060014369003,420.3,330.0,74.2,319,243,76
060014369002,285.9,224.8,49.8,298,217,81
060014369001,329.9,285.1,26.4,302,263,39
060014369004,457.9,382.1,43.6,437,343,94
060014367002,586.8,471.5,91.3,536,419,117
060014362001,289.5,251.6,24.6,229,210,19
060014368002,659.0,508.6,113.1,568,438,130
060014366021,730.0,613.0,88.0,671,580,91
060014368001,555.0,450.4,78.9,479,403,76
060014367001,447.5,355.1,67.5,294,246,48
060014356011,659.1,551.5,78.5,582,506,76
060014356023,471.7,381.4,69.6,402,312,90
060014357001,368.8,283.5,67.6,286,224,62
060014356012,473.1,396.5,52.0,456,374,82
060014363001,760.0,645.2,83.2,369,319,50
060014356022,208.5,173.8,23.8,168,142,26
060014335003,577.1,402.2,150.1,627,446,181
060014335001,365.3,255.5,92.7,399,281,118
060014333005,567.6,398.6,130.3,544,398,146
060855044222,636.0,467.0,137.0,660,470,190
060014433012,979.5,708.5,224.7,1174,819,355
060014415031,1231.4,911.2,261.8,677,521,156
060855044221,723.5,540.4,140.2,583,414,169
060855044211,535.4,395.6,108.4,545,364,181
060014432002,511.0,355.1,130.4,457,270,187
060014432001,1304.0,941.9,309.6,1285,825,460
060014371013,440.7,344.6,71.5,529,419,110
060014371023,305.1,237.7,50.2,397,302,95
060014371011,1292.6,1015.1,225.9,892,628,264
060014371012,826.2,636.7,155.3,703,503,200
060014443022,703.3,537.1,131.8,707,535,172
060014443012,849.8,623.9,184.8,810,589,221
060014443011,727.2,531.1,161.2,621,450,171
060014443021,610.7,477.9,101.2,390,311,79
060014442002,1067.0,794.2,213.5,916,692,224
060014442003,977.4,705.8,221.6,898,667,231
060014441004,590.9,398.3,152.7,648,436,212
060014444003,461.7,349.8,91.2,405,331,74
060014444002,606.3,459.2,119.8,535,426,109
060014445004,669.6,510.6,121.0,446,348,98
060014445003,493.9,374.0,95.9,515,417,98
060014446011,1054.3,768.0,223.0,985,702,283
060014445002,495.6,371.8,105.1,522,368,154
060014446012,1023.0,748.7,221.8,998,711,287
060014442001,563.6,412.9,115.7,562,432,130
060014444001,515.6,379.7,108.0,353,272,81
060014441002,879.3,595.8,220.0,828,522,306
060014441003,657.5,484.9,139.8,664,496,168
060014403321,558.5,450.6,89.4,503,372,131
060014403322,751.7,591.9,129.8,661,483,178
060014403311,576.5,480.3,66.5,479,381,98
060014403041,403.8,330.8,57.4,351,263,88
060014403053,769.5,578.7,151.5,706,526,180
060014403043,604.3,467.4,110.5,585,444,141
060014415012,1140.8,907.6,198.3,1084,815,269
060014415032,537.7,416.5,95.3,468,372,96
060014415213,587.4,438.1,119.6,536,377,159
060014415242,375.8,295.1,61.7,439,347,92
060014403051,443.8,335.8,87.6,392,293,99
060014403052,411.1,312.8,80.1,448,350,98
060014403061,778.9,657.5,93.6,668,526,142
060014403062,449.1,353.5,75.4,371,293,78
060014403042,603.2,479.0,100.9,511,378,133
060014415011,1430.2,1110.4,242.7,1293,970,323
060014403312,430.3,358.4,49.7,353,286,67
060014415223,660.5,499.8,137.9,708,526,182
060014381001,636.2,496.0,106.4,591,452,139
060014381005,431.4,340.1,70.2,319,256,63
060014381006,388.9,312.5,59.7,277,224,53
060014381003,350.7,271.7,60.0,312,243,69
060014381004,490.5,381.7,82.8,535,413,122
060014381002,344.9,268.8,57.8,352,276,76
060014380002,447.7,335.9,83.7,472,350,122
060014372002,342.6,270.7,54.1,326,248,78
060014372004,564.2,440.0,95.1,576,465,111
060014372001,1044.8,797.1,200.2,754,530,224
060014359004,355.1,245.1,89.9,315,223,92
060014359003,579.6,417.5,127.3,548,394,154
060014359001,552.8,389.1,126.6,744,522,222
060014359002,741.2,541.7,154.1,619,433,186
060014360003,862.1,654.0,161.1,779,574,205
060014361001,407.6,304.8,80.2,429,331,98
060014360002,795.5,591.8,157.3,727,546,181
060014360001,430.6,317.3,88.3,381,287,94
060014361003,730.7,539.1,150.2,707,517,190
060014358002,499.5,368.6,102.7,540,402,138
060014358004,469.7,346.2,99.7,417,309,108
060014358003,478.6,354.8,100.5,467,351,116
060014361002,737.2,573.1,136.6,740,560,180
060014371022,415.3,331.5,62.3,416,332,84
060014371021,375.0,299.3,56.2,324,246,78
060014372003,615.5,488.7,94.7,530,367,163
060014370001,418.6,328.9,69.0,530,422,108
060014370002,426.3,335.8,71.6,408,309,99
060014373001,267.2,220.1,35.4,305,238,67
060014362002,529.0,432.0,71.0,479,408,71
060014358001,535.8,391.9,117.4,505,391,114
060014357002,338.9,254.6,71.8,348,250,98
060014357003,443.0,332.8,93.8,469,337,132
060014357004,470.7,353.6,99.7,362,289,73
060014356024,437.0,331.9,83.5,403,312,91
060855076004,1145.8,769.5,301.6,758,481,277
060855081021,1020.5,771.0,193.1,912,666,246
060855082022,709.5,511.4,154.9,710,491,219
060855077021,1005.1,762.7,199.2,1114,830,284
060855077022,1028.4,780.7,197.5,937,663,274
060855077033,981.7,731.7,188.0,921,643,278
060855077032,1061.9,757.4,244.6,1050,743,307
060855077031,486.5,356.7,98.4,490,363,127
060855101001,990.2,728.8,201.2,934,628,306
060855101003,494.7,357.7,109.3,482,314,168
060855100023,607.5,450.4,124.4,678,453,225
060855100012,1001.4,751.8,189.1,1004,681,323
060855100022,679.9,506.9,134.9,645,452,193
060855100013,659.6,491.9,128.7,664,450,214
060855101002,330.6,238.4,73.9,406,266,140
060855100021,755.3,582.1,137.1,792,551,241
060855083011,727.0,541.0,146.0,708,467,241
060855084015,559.3,402.6,119.8,625,445,180
060855077012,779.8,585.1,164.8,774,555,219
060855078084,968.7,721.5,201.7,880,611,269
060855078082,682.0,521.5,138.2,588,424,164
060871216004,827.3,617.1,156.0,875,743,132
060871216002,553.3,418.2,95.4,564,439,125
060871216003,1119.4,865.4,172.8,1031,862,169
060871207003,983.2,709.4,200.0,630,474,156
060871005003,1252.6,1041.9,114.0,1191,1023,168
060871004001,811.4,725.1,29.7,1425,1356,69
060871202002,859.1,644.8,138.5,863,725,138
060871203011,1190.2,841.5,235.5,1334,1006,328
060871203021,395.6,273.3,82.0,408,326,82
060871203023,468.0,322.9,97.3,387,308,79
060871203022,696.6,481.1,150.0,582,439,143
060871206004,946.2,632.2,229.0,917,682,235
060871004003,1476.5,1278.6,51.4,1172,1117,55
060871003002,1132.2,921.8,140.2,1076,870,206
060871006003,487.9,406.2,55.0,498,439,59
060871003001,945.2,732.9,124.3,1157,919,238
060871004002,465.0,401.0,29.0,624,573,51
060871006001,953.2,802.3,93.7,864,795,69
060871010006,894.7,763.1,43.7,846,770,76
060871010003,426.3,368.1,20.4,366,342,24
060871007002,707.9,590.3,47.3,446,424,22
060871007001,560.2,472.0,33.3,570,524,46
060871010002,333.3,284.4,19.5,317,301,16
060871002006,650.9,529.3,64.1,390,360,30
060871208002,1482.8,985.3,379.0,1535,1023,512
060871208003,806.7,493.2,263.2,843,534,309
060871207002,911.6,676.9,162.2,938,750,188
060871206005,555.7,365.4,140.8,473,332,141
060871207001,649.4,371.3,220.4,817,446,371
060871208001,1418.4,927.3,401.7,1173,757,416
060871209004,972.7,652.3,243.2,648,464,184
060871206002,506.9,340.8,110.2,497,385,112
060871206003,399.9,272.9,83.8,409,319,90
060871204001,854.4,615.7,150.2,651,532,119
060871204004,733.4,514.1,137.9,529,413,116
060871203013,683.6,466.9,146.3,984,772,212
060871204002,751.7,505.0,170.5,606,450,156
060871205004,610.5,400.0,128.2,597,483,114
060871205005,295.8,208.6,58.3,413,315,98
060871205001,402.0,284.0,75.9,377,301,76
060871206001,492.1,342.4,93.5,411,330,81
060871209002,619.2,408.6,157.0,356,220,136
060871205002,942.9,653.1,224.4,940,676,264
060871010007,507.4,414.0,41.4,562,506,56
060871010001,565.4,483.8,36.0,463,430,33
060871008003,424.8,347.5,37.9,487,447,40
060871008001,696.4,582.4,57.2,719,660,59
060871008004,642.2,523.5,51.9,671,631,40
060871010004,222.3,180.5,18.5,147,142,5
060871008005,562.4,473.5,43.4,581,535,46
060871009002,1040.1,855.3,106.4,961,833,128
060871002005,670.5,539.5,73.4,594,509,85
060871002007,333.2,269.2,35.1,318,293,25
060871002004,354.9,286.6,37.5,435,379,56
060871212005,740.0,545.6,144.9,616,448,168
060871002003,786.2,626.9,94.4,803,699,104
060871001001,505.1,380.6,90.5,458,371,87
060871212003,1284.6,848.2,320.7,1195,818,377
060871008002,471.6,383.3,54.7,450,413,37
060871009005,258.1,209.4,28.5,267,234,33
060871009004,303.7,246.4,33.6,290,248,42
060871214033,296.4,233.8,40.3,267,218,49
060871009001,611.4,500.6,67.8,695,597,98
060871009003,367.6,306.4,36.6,343,319,24
060871008006,447.0,379.4,35.3,389,360,29
060871215004,472.6,368.3,72.9,440,367,73
060871214012,784.9,601.0,122.7,766,628,138
060871002002,574.7,467.1,62.7,555,483,72
060871214011,480.6,366.7,76.3,469,394,75
060871002001,424.3,344.9,46.3,386,317,69
060871001002,803.5,606.2,142.9,898,704,194
060871212004,728.3,530.4,145.1,635,494,141
060855123051,1496.1,883.7,517.9,1174,686,488
060855123141,880.3,511.1,300.3,831,517,314
060855061022,937.4,674.8,205.9,1027,737,290
060855060003,952.0,708.3,180.5,814,593,221
060855059004,548.8,396.1,118.4,491,359,132
060855060004,381.5,284.3,71.7,306,229,77
060855054021,404.6,280.6,101.5,385,283,102
060855054022,819.7,577.4,194.8,766,576,190
060855055002,732.1,529.0,150.7,671,475,196
060855054031,619.4,446.9,127.5,565,434,131
060855053022,620.9,448.8,130.5,579,405,174
060855055003,550.1,382.0,130.4,647,481,166
060855055001,351.4,256.2,71.5,410,295,115
060855068014,410.1,283.4,105.3,444,287,157
060855068013,862.6,608.9,207.0,895,623,272
060855068012,826.8,560.9,213.0,774,516,258
060855027021,1317.3,888.9,324.5,877,630,247
060855068021,783.3,541.6,183.5,745,526,219
060855068041,337.5,222.6,92.8,353,222,131
060855027025,333.2,241.3,77.4,288,191,97
060855027024,669.9,454.7,174.7,728,479,249
060855067023,565.0,409.0,116.0,489,353,136
060855065032,833.9,600.9,182.8,796,564,232
060855067021,975.2,685.0,219.4,903,609,294
060855066031,548.7,382.7,132.0,469,303,166
060855065033,685.9,502.3,137.7,614,448,166
060871210001,817.8,545.4,197.2,913,645,268
060871220011,660.2,452.6,150.6,540,405,135
060871211001,496.7,358.0,100.8,422,305,117
060855118001,1075.5,707.0,285.6,1154,797,357
060871209001,1509.0,963.9,423.2,1404,862,542
060855118002,675.2,453.1,157.2,582,428,154
060855070022,679.5,482.2,159.8,635,412,223
060855070014,397.1,288.8,85.9,386,293,93
060816013002,495.2,421.3,60.0,273,224,49
060816015022,572.0,452.4,99.4,297,217,80
060816014001,541.2,422.1,98.9,402,272,130
060816016053,825.7,653.4,148.8,778,546,232
060816016051,489.4,381.1,94.2,393,287,106
060816016052,346.7,267.6,69.0,316,228,88
060816016031,852.2,672.9,154.6,757,549,208
060816016033,563.3,429.6,115.4,396,293,103
060816016032,684.0,521.6,140.1,685,485,200
060816017003,681.0,524.0,132.0,633,486,147
060816017002,779.0,603.0,148.5,715,540,175
060816017001,354.6,277.7,58.6,408,325,83
060816140002,762.9,531.9,197.9,756,540,216
060816025001,712.1,555.7,136.3,697,496,201
060816018002,1310.5,968.6,291.1,1149,856,293
060816025003,717.0,569.0,131.0,592,415,177
060816024004,896.9,669.2,187.7,904,643,261
060816024001,477.2,354.2,102.2,354,258,96
060816024002,1045.3,767.4,233.0,934,707,227
060816041021,1177.0,948.0,183.0,731,578,153
060816038022,1089.0,725.0,298.0,1111,782,329
060816038011,859.0,620.0,201.0,801,587,214
060816040003,624.8,476.1,127.5,584,449,135
060816040002,616.4,458.9,129.1,587,439,148
060816024003,597.6,468.2,103.0,549,423,126
060816018001,1534.5,1151.5,323.4,1505,1129,376
060816019022,284.6,230.1,41.7,363,285,78
060816019023,1239.7,984.8,204.2,708,564,144
060816019021,633.9,504.4,98.9,168,131,37
060816016011,460.4,387.1,60.6,406,321,85
060816078001,642.3,479.6,133.7,694,517,177
060816077013,511.0,399.4,87.7,447,340,107
060816077012,291.5,229.6,49.2,387,305,82
060816061001,775.0,595.5,147.8,677,535,142
060816061002,472.3,362.9,90.0,425,333,92
060816061003,336.6,258.6,64.2,274,212,62
060816040001,411.8,303.0,87.4,324,260,64
060816041013,862.3,683.9,132.0,771,634,137
060816039001,343.3,249.8,79.0,290,230,60
060816039002,908.3,647.5,223.3,602,473,129
060816041011,628.7,499.1,102.0,533,423,110
060816042003,649.0,543.0,81.0,519,428,91
060816042002,281.0,227.2,40.8,197,161,36
060816042001,304.0,245.8,44.2,251,210,41
060816022004,532.4,432.4,79.1,481,397,84
060816020003,221.8,171.6,42.4,331,239,92
060816020005,306.7,238.2,57.6,333,252,81
060816020002,405.4,321.8,67.6,354,298,56
060816020004,596.4,461.8,113.6,786,572,214
060816020001,1132.3,887.0,190.1,735,548,187
060816021003,318.2,263.7,42.7,563,462,101
060816021002,305.2,252.9,41.0,180,152,28
060816021001,293.3,243.0,39.4,277,232,45
060816001003,598.5,471.7,93.8,531,431,100
060816002001,563.5,466.4,74.9,434,334,100
060816002002,624.5,507.2,94.6,555,424,131
060750605021,160.4,148.3,7.6,169,159,10
060750605022,197.6,182.7,9.4,171,167,4
060750264011,573.7,473.2,77.8,581,479,102
060750264031,592.8,451.9,113.1,581,429,152
060750264032,601.9,467.4,104.4,459,365,94
060750257011,451.0,372.4,64.3,458,353,105
060750256001,627.0,527.1,71.0,566,456,110
060750256002,399.7,312.0,72.0,397,307,90
060816090001,602.7,457.4,119.8,397,278,119
060816087002,510.4,381.5,97.6,566,404,162
060816090002,653.2,507.7,115.5,961,714,247
060816094001,1979.9,1517.4,364.3,1982,1394,588
060816092021,930.6,716.8,162.8,896,656,240
060816091001,375.1,281.9,72.1,318,231,87
060816091002,399.9,303.1,72.9,351,260,91
060816092022,1006.5,790.5,159.8,764,587,177
060816092012,580.1,457.0,91.1,570,417,153
060816092013,735.2,585.0,114.2,661,510,151
060816087001,1110.7,841.2,216.3,1020,757,263
060816086003,887.4,656.7,171.5,687,539,148
060816086001,437.8,326.9,83.1,447,336,111
060816086002,421.7,320.8,75.8,349,268,81
060816085021,1163.1,869.4,231.9,1092,788,304
060816085013,481.2,354.5,101.8,525,389,136
060816085012,766.4,551.3,176.0,670,494,176
060816084002,604.7,469.0,110.3,491,360,131
060816084003,469.3,364.0,85.7,275,214,61
060816084001,664.0,509.0,116.0,807,618,189
060816080042,973.4,705.3,229.2,823,578,245
060816080232,677.9,481.7,161.3,764,526,238
060816080132,454.9,326.8,104.3,328,233,95
060816080231,355.5,254.2,81.1,459,279,180
060816080022,493.4,368.4,107.7,413,290,123
060816080023,462.1,344.3,100.9,403,269,134
060816080021,845.6,628.9,183.8,906,642,264
060816080133,357.8,267.1,70.3,286,208,78
060816093002,1123.7,864.9,197.0,1179,861,318
060816093001,800.6,616.3,140.4,638,467,171
060816092011,709.4,565.3,110.0,629,443,186
060816100003,608.0,473.9,99.7,165,126,39
060816099001,725.3,544.5,144.9,736,516,220
060816019012,751.3,589.4,136.4,566,427,139
060816019013,365.6,279.9,68.5,365,289,76
060816022001,668.2,519.6,124.5,358,291,67
060816019011,520.1,395.8,98.2,450,356,94
060816008002,655.3,548.7,82.8,438,345,93
060816008001,323.6,271.5,40.9,157,124,33
060816012002,468.2,358.7,85.4,431,327,104
060816012004,634.0,485.8,115.6,598,450,148
060816012001,751.5,602.0,115.6,491,393,98
060816013004,695.6,581.8,91.7,757,606,151
060816012003,524.4,417.5,87.6,433,336,97
060816005003,549.7,448.7,84.6,432,326,106
060816006002,759.5,622.3,105.6,609,487,122
060816013003,513.0,430.5,65.8,380,284,96
060750332032,592.4,481.3,72.4,596,519,77
060816008003,469.8,383.3,60.0,346,274,72
060816007004,336.1,283.1,39.8,349,288,61
060816008004,225.2,183.7,28.8,155,125,30
060816013001,409.6,343.7,52.6,218,173,45
060816006001,808.5,664.4,116.6,566,421,145
060816005002,260.7,214.3,39.1,199,150,49
060816005001,751.0,614.0,114.8,787,571,216
060816005004,328.4,270.6,48.8,344,264,80
060816005005,507.2,414.7,68.5,381,301,80
060816007001,682.8,575.0,80.9,513,394,119
060816007003,331.1,278.9,39.2,262,213,49
060816007002,487.5,394.3,74.2,448,335,113
060750262005,403.7,326.2,60.2,402,318,84
060750314003,505.4,424.8,51.8,449,392,57
060750332042,566.5,440.3,92.4,601,466,135
060750332043,540.6,441.8,62.1,580,486,94
060750261001,583.5,485.8,75.5,474,365,109
060750260041,774.3,635.7,95.7,707,558,149
060750255006,1027.9,862.3,115.1,941,767,174
060750255005,658.6,547.3,78.0,558,455,103
060750255004,393.8,324.4,49.4,330,256,74
060750307001,1724.1,1461.6,187.9,1671,1391,280
060750307002,991.2,877.1,71.0,1004,874,130
060750217002,723.4,648.8,46.0,685,632,53
060750263011,423.8,348.5,54.2,352,270,82
060750260042,674.0,547.8,88.5,581,434,147
060750260012,984.2,806.7,124.3,810,679,131
060750260032,930.1,747.1,130.0,889,732,157
060750260031,883.7,716.1,114.1,760,624,136
060750255003,396.3,326.6,49.6,395,329,66
060750256004,667.2,548.6,79.2,593,482,111
060750260011,995.1,824.4,128.5,834,690,144
060750260021,606.2,489.7,76.4,616,511,105
060750260022,758.7,633.8,75.9,727,613,114
060750256003,437.5,350.2,62.9,426,347,79
060816113002,885.5,654.2,182.3,836,598,238
060816113003,426.0,318.5,91.3,427,298,129
060816098002,1077.2,740.8,270.7,1112,782,330
060816111002,1236.7,931.0,240.8,1208,873,335
060816098003,433.8,315.1,98.5,229,165,64
060816098001,430.5,324.8,82.0,493,380,113
060816099002,1086.0,820.3,214.8,957,715,242
060816100001,1006.7,810.2,133.5,955,755,200
060816100002,625.3,466.1,124.4,652,478,174
060816112001,1578.3,1198.5,306.8,1554,1134,420
060816110004,1069.7,826.3,186.1,729,557,172
060816110001,552.7,421.1,96.3,411,328,83
060816110002,562.9,427.5,101.2,658,506,152
060816110003,455.9,353.0,78.5,598,421,177
060816108002,821.8,652.7,129.1,565,449,116
060816109001,737.2,589.7,101.6,535,415,120
060816109004,458.3,363.3,64.5,510,393,117
060816108001,540.1,446.6,67.8,256,205,51
060816109002,598.1,494.5,75.3,512,415,97
060816102032,482.1,414.8,47.0,165,141,24
060816109003,255.6,219.8,25.0,266,226,40
060816056004,1280.8,802.8,398.5,1317,731,586
060816050004,482.5,321.0,137.9,481,294,187
060816050005,401.9,267.4,114.9,399,243,156
060816050001,984.9,720.5,214.8,563,419,144
060816045003,913.9,642.6,240.6,848,575,273
060816046002,522.8,341.2,154.2,789,472,317
060816047002,480.0,343.1,122.2,484,330,154
060816047001,837.4,583.8,217.4,847,575,272
060816045002,491.7,328.0,133.7,417,286,131
060816045001,352.0,234.8,95.7,259,182,77
060816049001,935.7,626.2,263.1,808,486,322
060816049002,572.3,380.4,163.9,570,354,216
060816048001,857.5,623.2,190.4,712,529,183
060816048002,481.0,351.0,105.2,587,418,169
060816048003,814.5,595.8,176.5,705,505,200
060816044001,501.2,355.2,121.4,407,303,104
060816044002,376.5,279.4,77.0,424,331,93
060816044003,701.2,533.4,128.6,342,267,75
060816041012,654.8,509.2,115.5,485,381,104
060816056002,606.0,374.2,187.7,590,308,282
060816056003,600.0,375.4,186.6,582,330,252
060816056001,530.2,328.6,166.2,553,286,267
060816052003,449.7,343.9,84.1,433,313,120
060816052002,585.1,443.5,114.7,516,340,176
060816053003,571.9,438.9,106.6,494,359,135
060816053002,773.3,596.8,138.2,656,471,185
060816053004,394.2,302.5,73.5,365,261,104
060816050002,397.1,292.2,84.9,437,284,153
060816052001,579.6,436.3,117.6,499,378,121
060816052004,475.5,358.0,96.5,495,358,137
060816051001,384.6,283.3,81.2,393,289,104
060816051002,1080.6,839.6,185.5,881,709,172
060816053001,597.0,470.9,93.7,624,466,158
060816068002,1266.9,915.1,300.3,1064,732,332
060816070002,1180.5,818.8,300.0,1343,837,506
060816069002,849.7,675.8,145.2,787,620,167
060816057004,758.1,497.0,215.0,785,445,340
060816057002,679.0,441.0,206.1,650,382,268
060816057001,664.8,419.0,194.9,716,412,304
060816070001,359.3,252.2,89.3,319,225,94
060816067002,930.3,676.0,211.5,925,643,282
060816066003,539.9,406.0,103.6,473,345,128
060816067001,469.9,349.9,95.5,454,300,154
060816066002,590.5,446.6,109.3,530,385,145
060816065003,520.2,386.4,105.6,561,361,200
060816074001,1010.5,744.4,212.4,823,596,227
060816088005,946.2,694.8,196.7,942,661,281
060816088003,514.6,368.2,112.5,442,302,140
060816088004,627.7,455.9,133.4,625,449,176
060816089003,1593.3,1205.9,305.8,997,763,234
060816089001,539.0,390.0,122.4,755,532,223
060816088002,680.8,506.8,131.8,637,473,164
060816088001,623.0,477.5,113.7,572,439,133
060816087005,947.5,741.6,161.6,842,634,208
060816089002,869.1,679.8,148.4,541,430,111
060816073001,827.5,601.7,188.4,674,472,202
060816073003,388.1,277.9,90.0,380,282,98
060816073002,805.3,608.0,156.4,949,676,273
060816071003,608.2,451.1,130.0,552,385,167
060816071001,377.2,270.1,87.5,377,251,126
060816074002,384.5,288.9,81.9,324,241,83
060816074003,791.6,600.6,159.4,689,491,198
060816071002,703.9,536.7,140.1,665,474,191
060816072002,687.8,537.9,114.5,715,563,152
060816085011,592.1,457.1,103.5,399,315,84
060816072001,1038.8,808.9,176.9,566,445,121
060816075001,1997.0,1620.0,274.0,1210,936,274
060816085014,428.2,330.6,74.9,407,297,110
060816058002,525.8,382.6,119.8,515,325,190
060816058001,539.4,395.5,119.7,545,357,188
060816058003,496.8,349.9,125.5,437,280,157
060816055002,412.3,316.4,77.3,422,278,144
060816055003,839.7,643.7,158.0,683,511,172
060816055001,1364.4,1074.9,220.0,1030,771,259
060816054003,766.5,596.1,127.1,630,466,164
060816065004,625.6,446.1,141.3,599,374,225
060816065001,422.1,314.0,85.3,605,421,184
060816065002,614.1,473.0,111.6,586,418,168
060816064002,385.5,287.3,81.8,413,287,126
060816064004,987.4,744.0,198.4,541,376,165
060816064001,631.1,477.7,123.8,512,351,161
060816063003,574.0,444.6,103.9,478,355,123
060816063002,484.2,365.0,96.6,333,229,104
060816059001,965.9,765.5,144.1,742,580,162
060816059003,721.8,563.8,117.0,615,481,134
060816059002,643.3,509.7,91.9,548,419,129
060816060002,621.0,485.0,99.0,508,401,107
060816062001,308.9,269.8,26.9,304,270,34
060816062002,562.8,491.1,50.4,394,361,33
060816062003,651.1,548.0,73.8,393,336,57
060816060001,1080.0,859.0,180.0,912,708,204
060816054002,464.2,338.7,94.0,497,368,129
060816054004,483.0,369.8,84.9,538,389,149
060816054005,763.1,584.2,134.1,413,317,96
060816054001,340.3,248.3,68.9,334,243,91
060816066001,574.4,438.2,100.6,528,401,127
060816076002,356.6,281.7,58.9,308,255,53
060816064003,565.8,419.8,120.3,500,390,110
060816063001,738.0,573.6,124.2,627,489,138
060816076001,421.7,325.9,79.2,360,273,87
060816076004,412.0,329.0,65.0,461,353,108
060816062004,483.3,397.1,61.9,433,356,77
060816077011,558.5,445.0,92.1,449,351,98
060816076003,464.0,373.2,70.0,315,247,68
060816078002,693.0,511.0,147.0,612,453,159
060816077021,555.1,426.3,102.4,455,341,114
060816077022,541.6,416.0,99.9,425,313,112
060871215001,394.4,298.0,69.0,455,371,84
060871215003,643.1,504.2,99.7,602,523,79
060871215002,533.8,416.9,83.8,648,548,100
060871214031,850.2,657.5,130.8,893,747,146
060871214032,602.6,456.9,104.6,428,356,72
060871215005,335.1,267.6,48.5,269,231,38
060871214022,951.0,712.0,160.0,878,731,147
060871213001,997.7,734.3,202.3,1024,790,234
060871213002,399.4,295.0,86.2,429,307,122
060871213004,386.1,289.5,64.7,212,179,33
060871216001,423.9,327.0,70.2,454,380,74
060871216005,431.5,326.7,73.7,372,309,63
060871217006,357.2,272.2,61.5,367,302,65
060871217005,452.9,328.5,86.4,416,339,77
060871217003,451.7,324.7,87.5,413,345,68
060871217002,374.2,262.9,78.4,368,299,69
060871220035,402.2,287.7,81.3,270,230,40
060871217001,1184.2,883.5,217.9,1128,924,204
060871214023,333.8,251.1,60.5,287,222,65
060871214021,642.2,482.9,116.5,597,481,116
060871213003,458.9,345.1,75.8,499,412,87
060871211002,1200.2,857.2,256.6,1301,951,350
060871220034,550.7,421.6,90.3,463,397,66
060871209003,1476.9,971.2,400.6,1568,1069,499
060871212002,786.0,480.4,223.1,781,507,274
060871212001,501.6,341.2,114.1,536,386,150
060871217004,871.7,650.1,169.1,889,704,185
060871218003,805.3,595.8,160.8,795,628,167
060871218004,273.1,200.8,57.5,292,228,64
060871218001,731.1,536.3,136.3,802,621,181
060871218002,864.9,640.1,167.1,866,692,174
060871220015,1053.9,770.6,209.4,1087,838,249
060871221002,725.0,556.6,120.0,753,599,154
060871220033,1317.0,946.6,268.9,1192,918,274
060871220012,456.3,334.9,73.4,396,325,71
060871220014,300.1,220.2,48.3,236,182,54
060871221003,656.1,493.1,117.1,549,454,95
060871220031,1102.9,787.7,225.4,1062,791,271
060871220032,603.1,429.6,126.5,577,423,154
060871221001,477.9,340.3,100.4,515,415,100
060871222017,379.9,285.0,76.5,326,268,58
060855058004,621.5,462.6,116.2,554,391,163
060855058001,472.0,346.1,93.2,453,360,93
060855058003,435.9,312.2,93.7,502,369,133
060855005005,434.6,297.5,106.2,413,269,144
060855005004,523.2,384.5,106.1,471,304,167
060855056003,348.7,270.3,53.2,481,366,115
060855052031,1169.4,918.3,167.0,810,659,151
060855056001,311.6,235.3,56.3,384,303,81
060855052023,352.7,258.2,71.2,268,210,58
060855057004,725.0,557.7,122.1,605,490,115
060855057003,705.1,536.4,114.3,657,507,150
060855057002,534.7,382.4,114.3,472,359,113
060855052032,442.7,351.0,62.9,363,295,68
060855022021,426.2,328.7,74.1,660,482,178
060855022012,1042.0,805.4,171.2,622,514,108
060855022022,481.2,326.6,126.0,172,126,46
060855026031,395.9,275.8,90.4,321,230,91
060855026032,399.7,286.1,83.1,486,315,171
060855022011,1424.9,1078.9,251.6,1058,823,235
060855022023,305.5,206.5,81.5,5,3,2
060855021023,482.6,349.8,95.9,553,402,151
060855021021,615.4,459.1,105.4,353,277,76
060855020023,705.8,560.7,94.7,505,416,89
060855020021,210.9,170.6,22.9,187,162,25
060855020022,329.0,276.2,32.1,934,661,273
060855021022,727.1,567.5,110.2,724,541,183
060855020014,639.1,501.8,87.1,512,426,86
060855020011,389.9,306.9,52.3,251,203,48
060855020012,315.7,232.7,61.6,200,153,47
060855023012,901.0,662.9,180.0,924,661,263
060855023022,686.9,516.3,119.5,573,437,136
060855023021,688.9,506.1,139.0,665,495,170
060855024001,417.0,314.6,80.8,411,287,124
060855024002,435.2,328.4,84.4,406,301,105
060855024003,412.1,312.6,73.4,407,307,100
060855019002,677.0,541.0,93.0,470,373,97
060855019001,1473.0,1164.0,217.0,676,538,138
060855018001,409.4,319.1,57.6,391,339,52
060855018004,650.0,545.0,78.0,558,448,110
060855008002,640.3,533.0,75.7,540,458,82
060855016001,156.8,128.3,15.3,97,84,13
060855016003,571.3,462.7,60.0,345,301,44
060855016002,234.6,191.0,23.7,249,216,33
060855016005,407.0,326.1,51.6,270,208,62
060855031121,777.7,631.9,93.8,728,595,133
060855031122,332.3,271.0,39.6,302,244,58
060855013003,770.2,647.0,65.6,529,469,60
060855013001,251.4,210.9,21.8,344,287,57
060855013002,241.6,203.5,19.8,337,285,52
060855016004,566.4,455.9,62.0,618,519,99
060855015021,498.8,405.0,64.0,464,398,66
060855015012,396.6,324.8,48.8,183,137,46
060855015011,495.7,410.8,57.4,470,341,129
060855015022,547.8,453.3,63.9,369,302,67
060855031051,647.6,486.5,127.1,569,328,241
060855013004,307.9,254.6,31.8,294,244,50
060855012001,227.0,185.9,23.8,206,178,28
060855012004,427.1,346.3,40.1,399,350,49
060855012003,331.7,269.5,31.9,240,199,41
060855012002,389.8,323.1,45.8,282,237,45
060855011023,491.2,406.7,53.6,485,407,78
060855011021,567.6,466.4,68.9,517,424,93
060855011022,617.5,516.1,59.9,490,412,78
060855014022,474.3,395.6,51.8,354,285,69
060855014021,267.7,223.3,29.2,231,190,41
060855014012,200.6,163.0,28.4,186,143,43
060855014011,413.4,336.0,58.6,331,260,71
060855032142,810.4,636.7,141.2,468,274,194
060855031221,440.3,348.4,71.2,390,241,149
060855031222,331.5,243.2,70.1,278,171,107
060855031181,195.5,157.5,29.4,231,176,55
060855031172,308.1,249.1,49.9,386,224,162
060855032141,1010.6,790.3,194.8,859,494,365
060855032045,472.3,368.3,80.1,368,242,126
060855032041,834.1,651.2,141.9,678,452,226
060855032042,373.4,300.4,55.3,367,273,94
060855032132,921.0,696.7,186.6,729,375,354
060855032131,363.0,279.3,68.4,447,260,187
060855031182,484.2,399.6,64.8,323,247,76
060855031183,519.0,418.0,77.0,373,298,75
060855032111,826.1,643.5,147.6,793,517,276
060855031113,590.9,454.6,116.7,536,352,184
060855031101,318.0,266.7,40.5,274,172,102
060855031171,273.2,220.6,46.0,251,148,103
060855031102,175.7,147.4,22.3,161,105,56
060855031103,178.8,150.0,22.7,95,59,36
060855036021,364.9,313.9,31.9,249,210,39
060855005001,701.6,516.0,142.1,763,543,220
060855005003,447.6,322.4,96.4,326,262,64
060855005002,808.8,628.1,133.4,645,513,132
060855004002,585.2,445.5,105.8,538,390,148
060855006002,572.8,461.8,85.3,589,481,108
060855006003,568.2,458.2,84.7,535,408,127
060855006001,1245.0,1000.0,175.0,1015,832,183
060855051002,35.4,29.3,6.0,26,22,4
060855004001,504.0,386.0,82.0,487,375,112
060855003002,1355.0,1115.0,145.0,1065,897,168
060855003001,134.2,104.0,16.7,109,86,23
060855002004,883.9,736.8,92.5,699,578,121
060855008001,771.2,619.2,92.1,344,271,73
060855002003,392.9,320.5,45.8,455,391,64
060855002002,448.5,363.8,53.8,0,0,0
060855002001,296.7,240.6,35.6,417,362,55
060855085041,405.3,305.0,71.9,250,191,59
060855085042,416.3,317.2,69.9,364,286,78
060855085051,453.4,344.7,79.7,605,415,190
060855085052,436.4,327.5,78.1,527,380,147
060855085043,359.5,276.6,59.0,320,234,86
060855087032,485.8,387.5,71.1,400,306,94
060855087031,309.2,239.4,48.1,366,260,106
060855087033,400.5,306.3,68.2,570,405,165
060855087035,664.4,522.9,97.8,467,321,146
060855087042,936.0,745.6,128.6,598,473,125
060855088002,388.2,304.8,57.4,297,224,73
060855088001,537.8,422.2,79.6,506,402,104
060855087041,560.2,439.2,75.5,485,382,103
060855085053,680.8,506.4,123.3,688,519,169
060855082021,595.1,412.2,145.0,525,373,152
060855085081,374.6,266.3,85.4,432,293,139
060855085084,329.5,236.7,70.7,207,151,56
060855085083,479.1,352.5,87.8,531,393,138
060855085071,290.4,218.4,53.0,450,333,117
060855085072,335.3,252.2,61.2,191,153,38
060855087034,412.2,317.9,68.9,273,215,58
060855085082,488.0,365.1,89.9,363,253,110
060855053014,535.1,397.7,100.6,347,246,101
060855053051,508.1,346.8,126.3,566,383,183
060014431051,858.6,653.4,167.2,851,613,238
060014431043,908.8,667.9,198.2,957,705,252
060014423021,561.4,436.3,94.2,496,381,115
060014422004,760.9,550.3,172.2,356,254,102
060014422001,705.6,521.1,160.4,682,529,153
060014431024,548.3,430.1,94.2,510,349,161
060014431023,537.0,394.0,122.0,542,366,176
060014431052,1223.4,923.8,250.6,1017,726,291
060014423011,614.8,444.2,143.6,616,420,196
060014423012,279.6,204.3,59.8,223,153,70
060014423022,449.6,327.5,98.6,247,192,55
060014423013,531.0,380.0,124.0,523,390,133
060014423023,421.6,327.7,70.8,310,234,76
060014419252,498.8,387.4,79.2,508,402,106
060014421002,1279.2,940.1,277.5,1194,897,297
060014422002,966.2,645.4,273.0,916,630,286
060014421001,1016.5,704.1,255.4,1078,772,306
060014422003,790.4,556.8,186.1,762,523,239
060014431022,452.0,330.0,103.0,420,324,96
060014431021,606.6,452.6,127.1,623,437,186
060014431031,312.6,229.3,69.1,613,431,182
060014431032,1570.7,1242.0,273.9,1410,1061,349
060014431041,800.1,584.2,181.7,716,524,192
060014431042,464.1,337.9,99.4,345,251,94
060014419243,799.2,600.0,144.6,777,546,231
060014419242,549.9,412.6,104.4,550,423,127
060014411001,1212.2,868.4,266.4,1090,792,298
060014419244,364.7,270.2,66.0,322,255,67
060014413023,385.1,273.0,93.9,393,273,120
060014413024,545.9,387.0,133.1,519,351,168
060014413021,664.1,472.3,163.9,796,552,244
060014413022,607.1,403.5,171.1,550,389,161
060014413011,339.3,241.4,83.7,440,314,126
060014403362,703.8,551.2,119.4,944,742,202
060014403084,589.5,449.9,116.7,495,378,117
060014403081,499.6,383.0,98.9,625,456,169
060014403361,669.3,520.0,107.3,504,408,96
060014416022,191.6,142.7,38.8,239,180,59
060014417002,719.7,532.6,143.0,656,499,157
060014416023,775.0,577.0,156.9,695,549,146
060014417001,709.5,523.1,150.3,684,538,146
060014417004,524.9,391.5,99.8,603,438,165
060014418001,855.0,615.7,189.6,768,576,192
060014418002,374.6,260.2,88.8,345,249,96
060014419233,467.9,352.0,85.6,415,324,91
060014419231,259.4,195.2,47.4,241,162,79
060014418004,290.5,214.0,59.4,440,313,127
060014418003,649.7,451.2,151.3,826,546,280
060014413012,703.6,536.7,134.9,642,485,157
060014412003,1687.3,1253.9,341.1,1218,912,306
060014412002,476.4,336.9,107.4,673,438,235
060014412001,913.2,642.8,207.2,821,619,202
060014402002,448.0,383.5,48.6,359,306,53
060014402001,463.6,396.8,50.3,385,344,41
060014402004,399.4,341.7,39.0,278,249,29
060014402003,435.7,372.7,42.1,413,366,47
060014403352,1136.1,912.9,184.6,566,429,137
060014403082,409.7,326.4,69.4,302,260,42
060014403014,555.8,435.3,83.3,479,397,82
060014403351,1098.2,786.4,274.2,825,641,184
060014419232,368.3,250.7,96.7,144,110,34
060014419241,571.0,436.6,92.5,528,417,111
060014430023,946.3,671.3,216.7,866,650,216
060014430022,583.0,415.3,139.2,688,454,234
060014429002,646.1,443.1,153.3,685,476,209
060014429001,782.3,576.0,158.0,751,535,216
060014430021,347.5,248.5,86.0,443,305,138
060014429003,924.9,630.0,228.2,838,567,271
060014430011,989.0,721.0,203.0,924,671,253
060014433212,494.4,366.0,101.9,562,419,143
060014433221,508.6,359.0,121.4,635,463,172
060014433211,142.8,105.7,29.4,176,128,48
060855049011,2469.8,1906.1,422.2,1875,1387,488
060855050013,461.1,353.6,80.5,533,375,158
060855050015,209.7,156.0,41.7,183,137,46
060855050012,592.4,428.3,130.6,676,467,209
060855050072,742.8,485.6,219.4,767,411,356
060855050092,413.0,305.0,93.0,358,255,103
060855050091,809.3,590.7,147.6,711,524,187
060855050093,1304.4,1061.1,149.6,348,282,66
060855050062,1481.5,1111.7,271.6,568,436,132
060855050082,0.0,0.0,0.0,0,0,0
060855050071,577.7,359.8,172.6,595,371,224
060855050081,957.2,740.2,153.8,903,703,200
060855051001,1216.6,957.7,186.9,864,691,173
060855001004,880.0,726.1,100.4,729,611,118
060855001001,366.8,302.7,41.8,187,158,29
060855043181,793.0,622.3,136.6,648,456,192
060855043223,595.3,449.0,110.5,474,355,119
060855043111,761.4,573.9,148.9,798,554,244
060855043113,372.2,276.9,76.9,498,377,121
060855050061,738.5,558.3,134.4,394,301,93
060855045051,132.4,98.2,28.5,271,181,90
060855045041,166.6,122.2,38.0,304,206,98
060855045043,645.4,473.2,147.3,104,72,32
060855045042,0.0,0.0,0.0,0,0,0
060855045053,628.3,466.5,128.9,240,152,88
060855045044,1431.0,1085.3,275.9,950,710,240
060855045052,941.3,703.7,188.3,795,518,277
060855045071,350.3,247.3,82.9,345,231,114
060855045061,317.4,224.1,75.1,286,204,82
060855045074,629.2,450.6,145.1,639,421,218
060855045062,610.2,460.0,121.1,581,417,164
060855045063,482.8,364.0,95.9,559,375,184
060855045072,606.9,447.4,128.9,493,337,156
060855045073,478.1,353.7,97.1,414,298,116
060855044131,735.5,563.7,144.3,652,468,184
060855044141,1078.5,807.3,210.9,1020,696,324
060855044142,545.8,399.2,112.4,488,332,156
060855044213,637.0,454.9,145.7,603,401,202
060014433222,638.6,437.9,164.7,473,323,150
060014433011,459.9,318.1,118.8,449,295,154
060855001002,404.2,329.3,48.7,302,242,60
060855001003,494.9,400.9,61.1,395,282,113
060855043183,447.2,335.4,93.3,340,220,120
060855043182,108.8,81.6,22.7,291,177,114
060855043112,952.4,719.0,185.6,848,579,269
060855036011,256.0,217.0,28.0,224,185,39
060855037091,491.2,404.6,69.6,345,229,116
060855043191,933.8,701.3,188.2,801,520,281
060855043171,901.1,660.7,204.8,930,616,314
060855043172,743.9,536.2,172.8,624,397,227
060855043163,255.0,185.1,57.4,262,169,93
060855043192,714.4,526.0,153.2,780,514,266
060855043162,677.0,520.0,128.0,545,366,179
060855043222,458.4,354.1,79.1,311,230,81
060855043221,341.6,263.9,58.9,355,280,75
060855043232,831.7,627.3,169.6,788,557,231
060855043231,550.2,407.6,120.6,565,341,224
060855043233,291.4,214.2,65.9,227,140,87
060855044102,785.0,606.0,142.0,694,481,213
060855043161,700.0,513.0,155.0,777,519,258
060855043212,434.1,345.4,77.7,368,252,116
060855043211,894.4,653.2,191.7,851,587,264
060855043213,467.2,344.3,104.5,381,259,122
060855043201,783.9,539.1,214.3,732,500,232
060855043202,401.1,275.9,109.7,430,261,169
060855044101,707.0,515.0,158.0,668,405,263
060855044161,742.0,550.0,157.0,725,483,242
060855043154,443.2,313.8,110.3,429,277,152
060855043151,575.1,416.0,129.2,608,416,192
060855043152,340.1,251.1,69.2,303,211,92
060855043153,615.2,450.4,136.7,595,401,194
060855044112,932.0,672.0,189.0,921,635,286
060855037092,346.5,274.9,58.9,331,216,115
060855037093,451.6,353.9,80.3,425,222,203
060855037081,736.6,590.6,114.1,518,317,201
060855037071,300.0,236.3,47.1,299,191,108
060855037121,209.0,164.7,32.9,208,148,60
060855043193,836.3,627.5,164.9,672,454,218
060855038031,824.0,626.2,161.8,836,582,254
060855043072,967.2,721.2,211.1,1040,715,325
060855038043,556.8,418.5,117.7,466,314,152
060855037082,296.2,225.6,59.2,266,187,79
060855038041,845.2,638.2,170.9,794,546,248
060855038032,705.3,511.2,153.7,753,516,237
060855037122,629.0,511.0,100.0,497,342,155
060855040013,450.3,371.2,61.2,291,234,57
060855040021,550.7,453.8,74.8,502,380,122
060855039032,292.1,236.6,43.4,270,211,59
060855039022,313.3,242.1,58.3,222,170,52
060855037131,490.7,397.4,72.9,392,280,112
060855037132,199.2,161.3,29.6,128,89,39
060855039023,298.4,230.2,55.9,324,241,83
060855039021,489.2,380.3,88.0,364,278,86
060855039031,581.6,465.4,88.1,551,398,153
060855039024,463.1,363.5,79.3,265,196,69
060855038022,331.5,264.5,53.6,383,296,87
060855038042,322.9,245.5,62.6,325,222,103
060855038023,323.9,275.2,38.6,247,190,57
060855038024,853.6,666.0,158.9,695,500,195
060855038021,1215.9,908.6,240.3,1187,884,303
060855043141,493.3,370.9,99.3,503,342,161
060855043143,305.2,224.8,66.8,303,205,98
060855043071,1016.9,720.5,252.5,986,626,360
060855043142,422.1,320.2,81.5,425,313,112
060855043144,448.0,331.9,94.8,472,323,149
060855043155,515.9,392.0,97.3,436,308,128
060855044171,137.4,85.3,43.4,180,90,90
060855044111,1078.8,742.5,273.3,1062,691,371
060855042011,1039.5,681.1,297.6,758,521,237
060855043083,678.5,480.9,159.7,667,465,202
060855044143,467.0,339.0,107.0,527,337,190
060855044201,910.5,646.7,211.5,853,554,299
060855044212,697.4,534.0,126.1,666,431,235
060855044122,309.8,227.1,68.2,275,177,98
060855044123,343.7,251.9,75.7,243,158,85
060855044121,276.3,202.5,60.9,360,238,122
060855029033,883.5,630.7,196.1,849,591,258
060855025006,745.3,521.7,173.7,795,498,297
060855025005,452.2,317.4,104.6,370,275,95
060855065012,1015.0,734.7,205.5,804,601,203
060855065031,1005.3,709.7,220.3,926,661,265
060855063022,873.9,627.3,183.8,1069,713,356
060855065011,355.6,276.0,54.2,361,285,76
060855065013,519.1,402.9,79.1,362,293,69
060855064023,816.1,600.0,159.4,739,536,203
060855064024,394.5,276.4,94.1,334,250,84
060855063021,852.2,634.4,165.1,814,601,213
060855063023,947.0,615.0,256.0,862,599,263
060855063014,463.8,322.1,110.8,129,81,48
060855063013,570.2,395.9,136.2,471,342,129
060855065021,764.4,564.1,144.5,752,556,196
060855065022,441.6,325.9,83.5,430,322,108
060855064022,333.6,232.6,81.2,415,290,125
060855064021,525.9,382.0,117.3,501,357,144
060855021013,1076.8,776.5,227.7,1245,850,395
060855021012,394.6,284.5,83.6,424,304,120
060855021011,596.4,430.0,126.3,533,394,139
060855021024,419.2,300.5,93.9,245,182,63
060855064011,1054.0,765.0,225.0,927,656,271
060855064012,675.4,487.4,144.8,500,341,159
060855020013,569.1,418.6,114.6,422,327,95
060855059002,409.8,293.2,96.9,534,377,157
060855059003,512.3,367.2,109.8,443,310,133
060855059005,511.0,374.7,110.8,592,418,174
060855059001,942.6,699.3,202.6,817,649,168
060855060002,369.4,268.4,86.7,363,265,98
060855060001,463.5,330.8,102.4,465,329,136
060855057001,362.4,269.1,71.5,317,239,78
060855056002,344.1,255.5,67.9,305,223,82
060855052022,804.0,596.2,155.4,644,478,166
060855058002,425.7,300.1,96.2,419,298,121
060855082025,683.6,478.8,156.7,756,545,211
060855082024,669.3,473.2,144.8,667,484,183
060855082023,363.3,262.4,76.6,541,380,161
060855082043,602.5,447.4,118.8,670,471,199
060855082041,659.3,512.1,105.7,476,375,101
060855062022,1051.8,751.2,234.3,1002,713,289
060855062023,1068.8,753.7,240.9,1142,813,329
060855066013,597.4,452.5,114.0,544,401,143
060855063053,506.2,360.7,107.8,526,385,141
060855062021,915.0,674.0,185.0,873,602,271
060855062044,629.5,447.5,151.5,606,426,180
060855062041,830.7,597.8,169.2,897,639,258
060855080043,772.9,554.2,176.3,720,501,219
060855062032,619.2,470.8,114.4,702,556,146
060855062031,419.4,318.9,77.5,353,275,78
060855062043,402.6,291.8,89.4,451,315,136
060855062042,433.2,313.8,97.0,421,299,122
060855066052,675.9,487.6,146.9,641,452,189
060855066063,690.6,504.5,142.4,523,387,136
060855066051,859.1,598.6,205.1,839,578,261
060855063054,473.2,340.6,89.8,441,343,98
060855063052,503.4,371.7,88.4,491,388,103
060855066061,285.3,215.8,55.3,263,191,72
060855063051,321.8,218.0,79.9,278,198,80
060855062033,220.0,160.0,40.0,276,232,44
060855063041,856.3,651.9,151.1,699,523,176
060855063042,131.5,98.4,22.7,213,157,56
060855063043,382.2,284.4,65.4,282,217,65
060855063011,316.2,245.1,46.6,333,270,63
060855063012,470.8,364.9,69.4,423,341,82
060855061033,362.3,261.6,82.2,383,265,118
060855061034,488.3,353.6,109.5,431,302,129
060855061032,345.9,248.8,78.0,365,252,113
060855061012,938.1,700.9,180.6,853,601,252
060855061013,656.1,476.9,134.9,708,512,196
060855054033,907.7,643.8,197.0,480,350,130
060855054012,458.6,347.3,82.5,461,377,84
060855054032,829.4,621.9,151.3,607,438,169
060855054013,527.9,403.5,92.2,151,121,30
060855053053,644.5,433.7,162.9,529,382,147
060855054014,225.3,166.8,43.4,396,288,108
060855054015,215.1,153.4,45.8,240,183,57
060855054011,263.7,188.1,56.1,211,145,66
060855053042,411.0,300.2,83.3,401,258,143
060855061031,670.7,476.8,148.6,660,455,205
060855061011,635.2,441.5,153.3,680,456,224
060855061021,829.1,581.5,197.4,744,515,229
060014506071,988.5,676.4,241.8,706,491,215
060014506072,995.7,631.0,289.2,1031,678,353
060014506041,637.6,391.3,210.5,735,412,323
060014506053,657.5,380.7,239.5,659,408,251
060014506044,369.9,236.9,108.5,456,269,187
060014506051,799.1,503.1,236.7,910,553,357
060014506042,1059.6,667.5,318.5,909,560,349
060014506043,444.0,278.0,134.8,538,324,214
060014506052,489.1,305.1,147.7,489,278,211
060014507461,1271.5,789.4,391.8,1136,720,416
060014507413,870.1,558.2,252.3,915,524,391
060014507412,659.3,412.9,194.2,742,466,276
060014507421,806.9,497.6,251.2,850,540,310
060014507452,1504.4,990.3,425.5,1202,719,483
060014507411,596.2,361.7,187.7,456,304,152
060014507462,394.4,254.4,114.4,436,287,149
060014507422,873.9,521.4,300.0,939,513,426
060014507432,854.2,619.7,181.3,828,592,236
060014501023,636.5,474.4,128.5,1121,774,347
060014501011,1503.9,1139.8,282.8,1285,930,355
060014501022,406.8,296.7,85.4,6,5,1
060855120203,855.0,663.0,141.0,682,548,134
060855032044,205.0,166.9,28.4,195,143,52
060855032043,371.2,302.2,51.4,211,154,57
060855025004,629.5,425.9,160.7,660,429,231
060855024004,536.6,408.4,90.5,575,432,143
060855025002,557.0,396.0,121.0,544,381,163
060855025003,601.1,430.4,130.5,608,456,152
060855024006,798.6,626.7,123.4,684,522,162
060855018003,555.5,433.2,85.9,507,402,105
060855024007,431.3,338.3,60.6,421,324,97
060855018002,526.9,427.2,67.9,407,350,57
060855017002,126.3,107.6,11.3,119,107,12
060855017003,296.5,252.7,26.5,226,201,25
060855017004,281.2,239.6,25.2,243,223,20
060855031131,656.0,545.0,72.0,465,419,46
060855031211,980.2,768.1,156.8,951,773,178
060855031212,346.0,244.3,81.2,204,128,76
060855031231,542.6,427.5,83.9,486,367,119
060855031132,515.8,432.6,55.0,329,284,45
060855017001,235.7,197.9,26.7,172,147,25
060855009012,917.2,720.7,109.7,851,688,163
060855009022,539.5,432.7,58.0,574,503,71
060855009021,78.9,64.3,7.2,149,127,22
060855009011,407.4,317.3,55.1,300,251,49
060855011011,777.5,645.8,85.1,588,461,127
060855011012,967.0,793.8,114.5,682,544,138
060855010003,283.2,233.1,31.0,270,227,43
060855010002,281.6,231.8,30.8,269,230,39
060855010001,422.5,343.5,48.4,376,319,57
060855010004,319.1,255.9,38.4,230,187,43
060855010005,302.6,242.7,36.4,192,153,39
060855044202,601.4,431.3,140.9,651,405,246
060855044162,480.0,335.5,117.7,588,389,199
060855044152,608.5,433.3,143.5,627,415,212
060855044183,172.4,126.5,34.7,254,154,100
060855044182,681.7,506.5,140.4,539,367,172
060855044181,487.1,357.5,98.0,258,164,94
060855044231,841.9,593.2,200.2,831,528,303
060855044153,609.5,425.4,150.2,660,412,248
060855044151,904.5,661.1,201.0,746,501,245
060855044124,451.9,338.1,94.4,323,222,101
060855044203,310.7,206.7,84.1,316,168,148
060855041021,653.6,516.8,103.5,673,506,167
060855041011,423.2,322.3,76.0,396,305,91
060855040011,471.6,375.1,73.5,462,368,94
060855041012,941.8,747.5,148.9,686,529,157
060855040012,543.8,453.1,66.1,403,324,79
060855041023,396.7,336.1,48.3,302,250,52
060855041022,381.6,325.6,45.8,298,246,52
060855042013,638.4,467.5,142.5,673,506,167
060855042012,574.4,390.1,153.5,182,124,58
060855042023,694.2,478.8,173.7,672,460,212
060855042021,716.8,454.9,209.0,1302,803,499
060855066062,895.0,664.3,163.1,902,641,261
060855079053,771.0,556.0,183.0,748,535,213
060855079062,520.6,370.3,122.3,502,354,148
060855079064,479.2,343.7,112.2,436,288,148
060855079063,409.3,293.6,95.9,445,320,125
060855080012,554.2,383.2,135.5,502,349,153
060855080011,924.1,684.9,178.8,939,682,257
060855079032,1482.9,1050.1,353.5,1449,1019,430
060855080032,346.7,255.7,66.4,344,255,89
060855081011,815.9,599.4,173.4,797,568,229
060855079031,879.3,659.2,175.9,839,587,252
060855080042,551.4,408.7,113.6,364,275,89
060855079042,773.1,548.1,182.3,827,556,271
060855079041,900.7,671.9,188.8,860,605,255
060855080041,624.3,464.8,125.8,611,453,158
060855081012,899.0,667.0,176.0,818,560,258
060855082031,464.2,351.2,86.6,581,436,145
060855082042,426.9,320.4,80.6,466,346,120
060855089003,412.9,329.1,56.0,321,240,81
060855089002,398.6,302.6,68.5,465,346,119
060855087043,208.0,168.0,22.0,284,209,75
060855090001,628.5,477.9,106.8,472,345,127
060855090004,479.2,372.2,77.6,503,375,128
060855090002,469.7,357.7,79.6,419,311,108
060855090003,711.6,557.2,113.0,610,459,151
060855089001,779.2,581.4,143.4,539,405,134
060855048052,974.9,693.0,227.4,1020,702,318
060855048061,405.0,319.6,61.5,372,276,96
060855048062,574.8,453.7,87.3,528,379,149
060855048021,744.4,530.9,175.7,704,473,231
060855053054,569.5,388.7,141.6,580,410,170
060855053052,356.8,246.8,87.2,388,279,109
060855053043,295.4,215.8,59.9,311,224,87
060855053044,350.9,261.8,67.0,327,234,93
060855053041,378.5,283.9,71.1,401,288,113
060855053013,176.9,131.5,33.3,252,192,60
060855053011,353.7,264.6,65.6,372,287,85
060855053012,308.5,236.4,54.2,307,233,74
060855053021,1161.0,857.0,223.0,1128,810,318
060855053034,480.2,364.7,82.2,255,185,70
060855053033,327.7,237.2,68.6,297,202,95
060855053032,578.4,424.1,115.8,466,342,124
060855053031,443.9,337.1,76.0,608,445,163
060855048022,454.4,358.5,73.5,414,306,108
060855048023,632.9,491.4,92.1,524,370,154
060855050014,296.7,215.5,60.0,251,174,77
060855050011,1213.8,912.2,227.9,1146,830,316
060855052021,456.4,345.7,83.2,454,352,102
060855110003,341.5,271.7,48.1,383,319,64
060855110001,722.5,574.9,101.9,660,562,98
060855100015,485.6,366.8,89.7,516,383,133
060855100014,503.3,380.2,93.0,361,241,120
060855100016,469.6,362.4,78.5,461,323,138
060855099012,495.9,392.5,76.8,465,345,120
060855099011,651.0,514.6,101.5,657,463,194
060855098014,835.8,654.4,128.4,844,638,206
060855096002,499.0,414.8,50.4,388,314,74
060855098022,713.7,577.8,103.2,760,589,171
060855099022,926.7,690.6,178.6,786,531,255
060855099021,956.2,757.9,139.9,1204,877,327
060855098021,674.9,546.1,87.1,615,486,129
060855099023,918.7,669.9,195.7,726,460,266
060855097003,443.4,362.4,54.7,532,433,99
060855097001,467.8,402.5,39.1,509,428,81
060855091054,567.8,446.0,84.5,395,317,78
060855091053,453.2,356.0,67.5,607,458,149
060855095002,619.9,520.6,52.8,492,405,87
060855095001,644.6,541.3,54.9,469,407,62
060855092021,717.3,572.4,103.2,797,614,183
060855095003,689.1,573.8,67.7,680,592,88
060855093033,294.9,236.2,43.6,298,229,69
060855096001,1071.4,905.5,94.3,855,711,144
060855092011,554.0,462.0,57.4,677,585,92
060855092023,447.3,350.6,70.6,374,287,87
060855092022,344.1,273.7,50.5,384,289,95
060855092012,516.3,413.8,66.5,552,439,113
060855092024,444.1,343.5,74.5,399,300,99
060855092013,437.5,358.7,50.1,147,120,27
060855092014,458.5,360.3,66.4,559,435,124
060855091083,370.0,286.4,57.7,329,258,71
060855091081,467.9,362.3,73.0,410,315,95
060855084016,584.5,415.3,129.6,519,370,149
060855084011,346.6,255.2,69.6,355,267,88
060855084012,507.7,375.0,101.0,500,379,121
060855091063,354.0,259.4,71.4,424,318,106
060014403341,742.6,606.6,105.2,660,500,160
060014403342,797.4,628.1,132.0,873,652,221
060014403332,500.0,393.2,87.8,448,345,103
060014403011,582.7,473.6,86.4,479,379,100
060014403071,901.0,658.6,202.8,934,696,238
060014403331,669.0,493.0,136.0,641,464,177
060014415241,751.2,589.9,123.3,658,527,131
060014415232,292.7,234.3,44.8,309,237,72
060014415233,295.8,236.8,45.3,409,327,82
060014415231,358.5,286.9,54.9,312,250,62
060014415214,349.0,260.3,71.1,363,257,106
060014415211,602.4,488.1,87.6,577,428,149
060014415212,556.2,458.6,73.7,533,408,125
060014415221,488.0,362.0,103.0,532,372,160
060014415222,526.5,393.2,106.1,482,353,129
060014414013,480.5,344.8,116.3,291,212,79
060014414021,855.0,640.0,182.0,830,581,249
060014441001,1166.7,846.4,251.7,1231,874,357
060014416013,536.0,393.3,111.8,560,431,129
060014416011,281.1,203.0,61.6,327,241,86
060014416012,957.9,701.8,200.6,972,697,275
060014414014,771.5,605.2,136.7,955,720,235
060014414011,470.6,346.7,94.7,389,285,104
060014414022,703.0,510.0,149.0,802,566,236
060014414012,558.4,411.3,112.3,628,459,169
060014414023,526.0,351.0,144.0,448,320,128
060014403012,743.3,603.4,109.6,792,631,161
060014403073,391.6,309.2,66.6,382,291,91
060014403072,414.4,327.2,70.5,360,287,73
060014382031,734.7,549.7,150.4,726,536,190
060014403013,725.1,570.7,122.5,638,499,139
060014403083,603.9,499.6,83.7,552,460,92
060014301012,1713.8,1211.2,412.2,1212,808,404
060014446021,693.9,529.6,125.3,931,727,204
060014445001,251.9,188.7,54.0,257,189,68
060014417003,302.2,226.5,55.8,256,209,47
060014446022,652.8,476.7,130.8,448,338,110
060014427003,415.3,275.3,114.1,499,330,169
060014427001,615.7,413.9,162.1,542,331,211
060014427002,336.3,221.8,93.9,384,249,135
060014426012,902.2,592.9,254.3,946,608,338
060014426022,934.0,634.7,242.9,1192,793,399
060014425004,614.5,442.6,139.1,570,404,166
060014426021,754.0,532.9,179.2,608,429,179
060014426011,504.5,345.4,130.5,659,442,217
060014428001,1101.5,789.5,252.2,1131,795,336
060014429004,410.9,304.8,81.7,300,230,70
060014425002,484.1,348.7,101.4,616,451,165
060014425001,636.9,465.0,126.7,532,375,157
060014425003,592.5,438.8,125.4,538,401,137
060014424003,530.2,380.8,122.4,553,384,169
060014424004,663.9,480.0,149.7,540,392,148
060014424001,490.8,364.2,100.0,433,327,106
060014424002,539.7,400.5,110.0,475,357,118
060014419212,714.1,550.3,118.3,594,481,113
060014419262,483.2,369.6,86.2,259,200,59
060014419261,370.8,288.6,62.6,484,377,107
060014419272,269.6,212.4,43.6,361,277,84
060014419271,405.3,319.3,65.6,414,330,84
060014419211,353.9,272.7,58.7,409,321,88
060014419251,563.3,436.2,90.2,861,711,150
060014416024,338.9,244.7,76.0,394,296,98
060014416021,785.5,560.6,182.3,785,542,243
060014307003,544.3,352.1,156.9,563,390,173
060014307001,436.5,290.9,118.2,463,293,170
060014306004,375.5,255.4,98.1,444,282,162
060014307002,872.0,573.0,240.9,856,586,270
060014303002,576.2,364.0,171.4,608,374,234
060014312001,771.9,548.5,178.7,766,573,193
060014312002,876.2,668.6,151.0,787,615,172
060014308004,724.9,487.3,185.5,690,480,210
060014309001,798.0,578.3,164.9,735,545,190
060014308001,343.8,221.9,93.1,391,242,149
060014310001,549.6,388.0,130.3,461,346,115
060014308003,949.9,639.2,254.3,853,590,263
060014311001,500.0,341.5,119.7,542,407,135
060014311002,690.6,513.7,124.3,585,453,132
060014353001,453.2,350.4,67.4,388,314,74
060014352001,1064.6,835.1,168.2,1125,937,188
060014302004,695.2,460.8,190.9,762,500,262
060014302003,408.8,282.2,100.8,457,309,148
060014303003,681.2,423.2,214.1,561,357,204
060014308002,447.3,273.2,131.8,439,306,133
060014302002,710.1,476.5,185.9,614,436,178
060014302005,773.8,487.2,241.2,773,440,333
060014353002,599.0,460.7,89.1,517,410,107
060014353003,517.1,383.8,100.0,431,359,72
060014301011,509.2,301.5,180.8,648,391,257
060014373003,296.0,243.9,39.2,248,193,55
060014373002,470.8,387.9,62.4,354,285,69
060014374002,732.8,588.2,106.9,830,672,158
060014374001,315.6,248.1,51.8,304,237,67
060014375001,398.2,329.3,50.0,183,152,31
060014376001,594.4,476.4,84.4,492,391,101
060014376002,365.9,292.5,52.2,303,231,72
060014375002,468.2,384.4,61.3,508,393,115
060014377021,435.0,353.1,60.5,276,230,46
060014382032,691.1,569.4,95.6,600,468,132
060014382043,999.8,771.1,201.6,1022,777,245
060014382041,570.4,464.5,83.9,492,395,97
060014377011,121.2,104.1,10.8,72,59,13
060014377012,315.6,271.1,28.0,347,299,48
060014377013,152.2,130.7,13.5,186,165,21
060014377022,253.4,217.7,22.5,111,91,20
060014378001,1219.3,973.0,197.7,1092,888,204
060014378002,424.7,347.0,62.3,278,231,47
060014363004,344.8,283.1,42.7,187,159,28
060014363002,949.4,770.5,120.6,707,596,111
060014363003,278.8,223.2,36.5,184,152,32
060014366022,444.6,353.0,65.4,368,308,60
060014366011,413.7,328.5,60.8,421,349,72
060014366012,706.4,580.3,82.6,597,501,96
060014354002,396.4,328.2,47.7,490,414,76
060014354003,534.2,441.9,64.6,394,339,55
060014354001,542.4,454.9,58.7,622,520,102
060014364013,679.1,517.5,122.2,769,615,154
060014366013,558.3,462.4,60.9,360,305,55
060014365001,463.9,376.2,59.0,351,308,43
060014365002,805.0,648.5,106.4,756,611,145
060014351022,1255.9,1021.2,182.0,1455,1203,252
060014379002,330.7,259.6,48.6,239,192,47
060014364014,480.9,371.8,75.6,466,376,90
060014364015,322.7,245.4,53.5,309,253,56
060014364012,845.1,645.1,156.7,820,644,176
060014364011,513.5,381.1,99.8,645,483,162
060014382042,519.3,423.6,76.6,498,404,94
060014351042,582.3,496.0,55.0,353,310,43
060014379001,371.8,291.9,54.6,315,259,56
060014351043,266.8,200.5,46.2,268,212,56
060014364022,897.7,651.1,188.0,742,508,234
060014364021,989.9,728.6,226.9,809,561,248
060014352002,863.7,711.9,110.7,821,676,145
060014309002,832.8,606.2,171.9,802,619,183
060014310002,571.8,413.7,118.8,502,381,121
060855033041,505.9,421.2,69.7,252,170,82
060855033042,419.4,345.6,61.7,387,289,98
060855033044,315.0,226.8,75.1,306,189,117
060855033043,526.8,385.4,122.5,551,354,197
060855033371,665.0,515.0,118.0,633,441,192
060855033372,549.0,441.0,85.0,544,379,165
060855033051,540.0,433.0,76.0,433,301,132
060855033052,654.0,561.0,61.0,504,410,94
060855033362,765.6,610.5,135.8,624,436,188
060855033361,382.8,314.1,56.2,328,211,117
060855033153,1195.7,957.3,194.4,1045,731,314
060855033151,744.4,584.7,127.3,594,395,199
060855033062,461.4,397.8,49.8,354,284,70
060855035045,264.6,228.1,28.6,224,174,50
060855033063,294.4,244.2,40.4,235,168,67
060855033061,348.6,292.0,45.3,312,210,102
060855033053,664.0,527.0,113.0,616,360,256
060855035063,325.8,279.1,32.5,344,282,62
060855035062,526.0,452.8,55.0,399,332,67
060855035072,131.3,113.5,14.3,93,71,22
060855035071,394.3,340.9,42.9,305,272,33
060855035061,559.6,478.7,55.3,345,267,78
060855035112,586.8,490.8,71.4,486,405,81
060855035103,461.6,391.1,51.2,358,284,74
060855035102,344.0,295.0,34.6,353,302,51
060855035101,592.1,498.4,67.6,392,308,84
060855033212,1000.0,768.6,197.9,892,598,294
060855033211,736.0,563.4,147.1,771,519,252
060855035111,516.0,432.0,68.0,425,317,108
060855035081,939.7,781.0,113.7,771,635,136
060855035082,599.9,495.7,75.1,421,350,71
060855033222,673.8,535.2,111.0,614,469,145
060855033221,469.3,383.7,69.8,463,332,131
060855035093,403.2,312.9,78.9,364,248,116
060855035091,500.9,418.0,67.8,416,327,89
060855035092,297.1,248.0,40.2,240,196,44
060855033331,748.5,582.8,139.7,713,499,214
060855033271,616.9,494.9,99.0,584,419,165
060855033273,647.0,483.2,135.4,604,423,181
060855033332,1120.5,840.3,231.4,1015,746,269
060855033272,652.5,508.1,117.9,649,459,190
060855033152,462.9,363.0,82.3,410,300,110
060855033252,848.8,683.9,134.3,757,550,207
060855033262,715.7,557.0,130.6,671,451,220
060855033251,817.1,622.2,158.4,852,577,275
060855033292,700.8,532.0,140.7,741,516,225
060855033291,733.7,577.4,131.6,574,428,146
060855033241,744.6,588.1,129.7,750,492,258
060855033232,1022.6,785.7,204.7,997,678,319
060855033231,821.4,643.3,139.3,814,565,249
060855033242,628.4,503.9,106.3,613,422,191
060855033223,450.0,345.1,90.4,421,296,125
060855033123,285.0,236.0,39.0,287,227,60
060855033121,266.0,193.0,54.0,232,167,65
060855033131,662.4,494.6,138.4,741,517,224
060855033132,775.4,571.9,165.5,752,520,232
060855033133,636.1,469.5,134.1,596,441,155
061050003003,309.1,112.9,165.2,164,99,65
060890116001,483.1,145.9,309.1,431,180,251
060890117033,452.4,128.6,293.0,521,218,303
060890117022,550.7,170.4,340.5,499,235,264
060890116002,694.9,173.3,480.2,718,261,457
060890108061,809.6,237.6,533.0,867,341,526
060890117011,247.5,71.7,158.1,262,112,150
060890117012,815.3,231.6,532.0,628,215,413
060890108072,1147.3,269.4,823.8,1149,372,777
060890117023,359.8,113.6,214.1,399,172,227
060890117021,307.0,93.4,187.5,283,126,157
060890117032,395.6,99.6,262.2,355,135,220
060890117031,359.8,102.7,226.6,362,162,200
060890108071,1311.8,308.3,941.6,1320,370,950
060890118032,525.7,129.8,368.5,542,165,377
060890118031,506.4,125.4,351.6,501,182,319
060890118021,513.9,118.2,366.1,532,162,370
060890118033,424.3,115.8,286.5,394,142,252
060890118022,968.6,216.6,706.1,861,280,581
061030010005,295.5,67.3,212.0,298,92,206
061030008004,307.7,124.6,157.2,288,136,152
060070014004,999.0,328.5,602.9,792,285,507
061030009002,527.9,172.2,328.6,443,204,239
061030006003,636.7,165.2,430.1,581,194,387
060450109001,321.5,192.8,80.0,311,241,70
060450113001,581.4,316.9,222.5,568,347,221
060450109003,689.0,368.3,272.9,729,446,283
060450113002,967.2,556.1,332.7,1043,700,343
060450115003,521.8,294.8,181.8,472,308,164
060450114002,296.8,191.6,79.6,408,273,135
060450115002,828.1,522.1,225.6,799,571,228
060450115001,418.7,257.1,115.8,300,237,63
060450108014,779.3,348.8,370.1,852,491,361
060450108011,468.9,239.9,164.6,517,371,146
060450106004,818.6,433.3,293.9,925,650,275
060450108012,616.9,275.2,279.9,656,380,276
060450103004,514.1,306.9,156.8,530,381,149
060450103001,343.6,221.8,97.7,426,313,113
060450106001,624.7,362.3,175.8,702,546,156
060450103003,289.5,189.2,79.7,347,261,86
060450102003,226.7,160.1,34.0,270,232,38
060450102005,420.5,242.7,113.4,345,265,80
060230011013,990.1,718.1,126.9,897,765,132
060230010005,762.3,577.2,53.3,424,401,23
060230010001,622.7,473.8,58.0,1943,1781,162
060230013001,618.1,397.1,145.5,580,445,135
060230011014,604.6,461.0,57.7,715,633,82
060230010004,549.7,423.7,55.6,405,345,60
060230009001,1054.1,808.3,129.0,1106,930,176
060230010003,416.1,327.6,32.3,347,321,26
060230010002,490.0,392.2,37.9,162,143,19
060230011012,837.0,588.7,130.8,719,593,126
060230012001,1036.4,727.7,140.0,1068,888,180
060230009003,1275.0,833.1,307.6,1184,833,351
060230008003,773.0,450.3,235.7,1076,658,418
060230106002,338.1,198.6,106.5,318,203,115
060230106001,698.1,387.3,245.1,645,365,280
060230009002,628.2,458.8,109.8,649,476,173
060230109023,585.8,224.8,309.2,686,280,406
060230109024,652.3,225.5,378.7,639,277,362
060230111004,309.8,103.4,179.4,358,138,220
060230103004,415.3,256.1,112.5,341,233,108
060150002014,28.9,7.2,19.9,94,37,57
060230011011,714.7,465.3,159.1,1009,754,255
060230012003,563.0,367.6,127.6,524,383,141
060230105011,1033.5,603.8,324.4,1124,727,397
060230105012,665.0,374.0,216.0,638,399,239
060330006004,145.1,72.3,60.3,163,95,68
060330007012,701.4,372.2,266.7,706,463,243
060330007011,591.1,310.4,225.3,654,413,241
060330003002,889.7,396.1,423.9,925,496,429
060330004005,387.6,166.5,188.7,351,191,160
060330001002,710.6,269.8,371.4,847,461,386
060330003001,787.2,308.9,411.2,626,307,319
060330005021,504.7,236.8,214.2,452,287,165
060330005022,378.4,180.7,156.7,316,201,115
060330005012,623.2,302.3,266.1,438,271,167
060330004002,724.8,376.4,276.4,648,398,250
060330005013,109.6,44.9,56.1,209,125,84
060330009002,597.7,300.4,253.1,493,238,255
060330006001,310.3,154.2,126.7,388,219,169
060330009003,1145.6,557.6,491.2,1227,737,490
060330010002,296.1,128.9,141.4,303,164,139
060330004004,367.3,154.2,175.6,350,186,164
060330004003,322.4,174.9,119.7,348,216,132
060330005011,361.6,172.9,152.7,614,388,226
060330004001,573.5,252.6,258.6,611,358,253
060330001001,570.2,230.9,279.5,798,476,322
060450108022,573.7,260.7,260.0,357,208,149
060450108021,300.9,138.0,134.0,499,310,189
060450101001,225.5,124.9,65.7,348,261,87
060450101003,278.6,141.1,101.8,270,179,91
060450101002,184.8,98.7,57.8,172,117,55
060411321002,860.3,732.8,44.3,958,908,50
060411130003,581.6,494.3,38.9,615,561,54
060411130004,593.0,496.9,44.7,526,470,56
060230115002,726.3,433.1,171.6,808,657,151
060230115001,528.3,320.0,106.5,771,629,142
060230111003,404.4,146.9,216.3,495,223,272
060230112003,583.7,255.3,246.7,602,334,268
060230108002,511.1,231.7,229.9,775,370,405
060230110003,378.7,141.3,199.2,357,180,177
060230112002,569.5,231.7,293.7,613,304,309
060230110002,811.3,330.2,421.4,641,298,343
060230107002,858.2,407.4,382.1,1153,573,580
060230108003,377.1,161.1,183.1,476,243,233
060230108004,454.2,200.1,214.4,282,146,136
060230109013,884.9,367.9,461.3,759,360,399
060230109012,426.9,205.4,182.2,285,134,151
060230110001,615.6,217.2,357.0,916,380,536
060230109011,381.5,171.2,177.0,562,255,307
060230111002,450.7,174.7,220.5,409,212,197
060230111001,349.5,128.3,192.2,445,201,244
060230108001,490.3,220.6,219.4,453,233,220
060230107004,298.3,149.9,120.5,228,160,68
060230107003,911.7,454.1,375.2,1190,634,556
060230004003,587.8,333.1,200.1,508,318,190
060230107005,443.2,221.2,176.8,314,182,132
060230107001,498.0,239.7,218.3,435,204,231
060230004001,566.4,282.3,244.0,620,290,330
060230004002,525.3,250.8,232.7,540,264,276
060230003004,646.3,361.2,223.7,839,509,330
060230003005,574.5,327.2,197.7,627,389,238
060230007004,484.5,274.4,170.5,503,299,204
060230007003,730.3,368.9,314.4,816,421,395
060230007002,774.0,403.4,296.8,877,462,415
060230112001,490.0,245.6,209.5,494,268,226
060459901000,0.0,0.0,0.0,0,0,0
060971538071,555.1,336.3,177.2,579,372,207
060971538061,472.7,284.8,149.9,441,278,163
060971538072,1317.8,831.8,388.8,1538,1005,533
060971539014,400.3,254.7,115.6,373,249,124
060971539011,599.8,391.1,159.0,706,512,194
060971539021,652.3,486.5,123.7,488,373,115
060971538091,806.5,499.7,245.3,869,544,325
060971538093,484.5,298.6,146.2,435,286,149
060971527011,675.6,414.3,213.8,789,498,291
060971526001,895.5,569.7,260.8,945,602,343
060971541002,695.6,425.1,208.1,648,444,204
060971541003,467.4,291.9,140.5,539,363,176
060971541004,360.6,213.6,121.4,494,318,176
060450111022,572.4,432.9,89.7,540,466,74
060450111021,309.1,197.0,71.0,642,504,138
060450112002,397.5,272.1,83.8,404,320,84
060450112001,566.7,387.8,94.1,647,535,112
060110003001,254.3,64.2,176.4,360,103,257
060110003004,668.1,352.6,271.5,416,210,206
060110001004,427.3,195.1,210.3,415,148,267
060110001002,278.7,105.6,159.4,405,168,237
060110004003,213.8,63.9,138.1,183,60,123
060110004002,344.9,83.4,245.3,279,91,188
060210103001,260.1,47.4,200.5,496,145,351
060210103003,251.1,52.8,185.8,222,52,170
060210102001,441.0,133.9,282.6,379,140,239
060210102004,435.7,116.2,298.0,417,145,272
060210104001,498.8,129.1,343.4,499,175,324
060210104003,326.4,114.2,192.5,221,104,117
060210104002,529.9,167.6,331.8,761,264,497
060210104004,244.3,92.3,140.7,162,77,85
060210104006,230.3,76.5,140.4,298,110,188
060210104005,383.5,120.4,241.6,368,144,224
060210101001,709.9,316.5,340.5,746,383,363
060210101004,396.3,147.5,223.1,392,162,230
060210101002,807.6,317.2,444.5,838,334,504
060210101003,677.9,230.1,402.1,728,284,444
061130115002,349.9,162.4,162.8,126,61,65
060110001003,752.9,343.5,370.4,453,228,225
061130114001,413.3,166.8,220.6,751,333,418
060110003002,259.9,198.9,47.0,300,210,90
060110003003,263.9,160.2,87.5,247,128,119
060230002004,396.8,236.3,106.8,450,295,155
060230003001,283.2,159.6,96.5,286,177,109
060230003002,243.2,132.3,83.4,283,172,111
060230002002,388.5,232.5,116.9,415,275,140
060230003003,278.8,151.7,95.6,244,169,75
060230001001,414.0,276.5,90.6,660,510,150
060230002005,142.3,83.7,35.4,144,113,31
060230002006,342.2,215.5,80.2,302,214,88
060230002003,258.2,155.3,73.1,304,187,117
060230002001,410.1,253.2,112.7,530,335,195
060230001004,246.9,166.0,51.0,256,194,62
060230001002,396.4,261.9,86.8,504,385,119
060230001003,260.1,163.7,67.7,294,201,93
060230006004,640.2,385.2,193.9,564,366,198
060230006003,461.0,267.6,153.5,445,260,185
060230005001,434.4,277.2,96.2,579,426,153
060230005004,371.0,249.2,79.7,307,229,78
060230007001,699.2,399.4,238.0,553,305,248
060230006002,521.1,301.3,172.0,474,275,199
060230006005,617.9,366.1,192.7,529,333,196
060230005002,432.6,256.6,122.1,577,380,197
060230006001,324.0,196.0,97.3,271,167,104
060230008001,583.1,308.9,219.5,399,228,171
060230008002,759.3,407.3,277.2,719,424,295
060230005003,291.7,190.6,67.8,133,103,30
060450112003,343.9,237.7,70.2,210,161,49
060450113003,432.4,214.6,187.8,604,365,239
060450118001,577.1,353.3,178.3,369,259,110
060450114003,393.2,233.4,127.7,491,351,140
060450114001,285.5,183.7,68.2,396,300,96
060450114006,247.7,136.0,87.8,371,212,159
060450114005,384.1,237.8,110.9,361,246,115
060450116004,487.5,289.9,151.4,433,274,159
060450116003,267.0,168.2,74.9,113,84,29
060450116001,593.7,371.7,167.8,495,374,121
060450114004,269.6,173.9,63.5,269,196,73
060450117003,493.7,267.6,181.5,292,191,101
060952529032,545.7,191.8,317.7,461,174,287
060952529033,833.6,306.4,477.8,776,319,457
060952529041,866.3,321.9,489.8,774,358,416
060952529034,576.3,218.6,330.2,513,215,298
061130113003,1273.1,707.6,471.9,1230,727,503
061130113001,357.9,183.7,150.6,481,276,205
061130113004,672.4,390.6,245.1,592,368,224
060952532062,646.1,283.0,321.2,502,220,282
060952519024,709.0,580.1,106.4,642,532,110
061130113005,475.2,304.8,141.2,403,279,124
061130115001,336.9,160.4,153.8,609,284,325
061130115003,930.2,415.6,465.5,568,335,233
061130115004,356.6,158.8,177.9,222,104,118
061130115005,257.2,116.6,123.4,201,95,106
060450118002,349.7,192.0,125.7,280,192,88
060450117005,155.5,75.8,71.4,137,74,63
060971542023,296.4,187.0,86.2,307,218,89
060971542021,2061.4,1310.1,594.5,2047,1386,661
060971542022,473.8,274.8,147.6,509,354,155
060971542012,357.2,221.4,108.3,286,192,94
060971542014,425.3,267.7,123.7,406,307,99
060971542013,256.3,161.8,76.6,277,206,71
060971542011,550.9,354.5,159.9,399,293,106
060450117001,257.6,138.9,93.3,530,324,206
060330010004,374.0,150.0,190.4,379,193,186
060330010001,330.7,154.2,147.4,272,160,112
060450115005,454.0,251.0,166.4,426,287,139
060450117004,352.8,200.4,113.6,265,192,73
060450116002,319.7,192.2,100.7,394,282,112
060450115004,193.4,119.6,62.9,185,124,61
060450117002,472.8,232.0,200.5,430,231,199
060450109004,363.1,176.4,163.1,363,236,127
060450109002,235.4,113.5,105.4,223,133,90
060450108013,737.2,368.6,289.1,933,578,355
060971541001,308.3,198.2,84.6,330,231,99
060330011002,797.3,377.6,344.0,875,593,282
060952529043,537.3,254.2,251.1,431,225,206
060952534033,1036.1,476.1,490.1,942,479,463
060952534031,682.9,349.0,289.7,801,391,410
060330010005,480.1,254.6,177.5,521,302,219
060330010003,304.9,140.4,143.9,272,153,119
060330010006,443.8,223.2,180.2,372,216,156
060330011001,771.8,425.8,283.3,1063,737,326
060330013005,206.1,88.2,98.5,267,165,102
060971512012,463.9,290.8,132.9,527,379,148
060971512041,831.6,578.3,181.2,814,637,177
060971512043,320.2,214.6,77.6,276,224,52
060971512015,691.9,472.4,159.8,548,422,126
060971511002,1113.8,668.5,365.7,1134,757,377
060971511001,675.5,383.0,220.4,637,410,227
060971510001,608.7,380.0,183.3,557,354,203
060971512014,911.6,587.3,254.7,923,686,237
060971512034,862.8,596.2,193.8,764,632,132
060971512042,541.6,359.6,134.9,537,430,107
060971513013,554.9,394.0,110.2,537,458,79
060971513053,531.1,382.0,105.5,556,453,103
060971513012,462.0,315.2,104.0,335,255,80
060971512032,622.8,419.6,153.3,676,486,190
060971512013,548.9,351.5,154.2,505,361,144
060971512033,529.0,357.1,129.8,563,445,118
060971513111,561.1,379.1,140.8,628,482,146
060971513102,511.1,338.2,126.0,553,430,123
060971513011,654.1,431.0,162.4,672,479,193
060971512031,463.8,313.1,113.7,452,349,103
060971513052,265.1,174.1,66.2,269,196,73
060971513054,336.3,238.8,69.3,337,270,67
060971513113,719.8,478.9,185.8,602,435,167
060971513115,493.1,321.6,134.9,454,316,138
060971535013,561.5,375.0,130.6,608,436,172
060971535011,539.3,346.8,140.9,486,324,162
060971533003,458.0,298.0,121.2,562,403,159
060971532002,280.8,196.1,63.1,283,212,71
060971512011,478.6,336.7,102.2,473,351,122
060971532001,281.3,191.9,63.0,306,244,62
060971532003,521.1,355.4,116.7,257,217,40
060971513072,450.9,282.2,136.4,505,350,155
060971513051,591.4,425.3,117.4,566,456,110
060971513085,720.4,458.2,212.8,682,437,245
060971513064,571.1,367.2,159.6,559,459,100
060971513063,490.2,316.2,141.7,470,370,100
060971513084,315.0,201.6,92.2,418,276,142
060971513073,547.4,351.9,150.5,547,398,149
060971513071,812.5,547.7,209.3,918,630,288
060971513074,567.7,367.9,154.1,668,475,193
060971513104,510.1,357.6,106.3,670,487,183
060971513101,257.1,168.2,66.4,331,246,85
060971513103,440.1,287.9,113.6,420,328,92
060971513062,332.7,217.7,85.9,369,291,78
060971513093,608.6,396.1,171.0,559,432,127
060971513061,304.9,201.0,85.2,346,241,105
060971513081,431.0,288.5,115.5,414,281,133
060971513083,241.9,168.1,58.0,326,251,75
060971513082,763.9,530.8,183.1,539,416,123
060971514024,260.1,173.6,63.2,201,149,52
060971514022,534.4,373.8,107.8,387,307,80
060971514023,697.6,476.5,157.1,684,554,130
060971514011,1256.8,906.4,253.8,1054,797,257
060971530052,367.3,227.6,111.9,366,260,106
060971530051,523.1,319.0,157.1,533,346,187
060971533002,368.2,265.0,59.5,317,254,63
060971530053,687.0,451.9,178.1,717,462,255
060971514021,616.1,453.2,119.3,580,436,144
060971520001,476.4,371.9,64.8,460,411,49
060971519004,454.9,355.1,58.1,404,359,45
060971519003,315.3,243.6,44.5,350,316,34
060971519001,311.6,237.1,49.9,293,247,46
060971514013,357.4,262.5,62.3,251,195,56
060971514012,634.0,466.6,119.0,262,220,42
060971519002,343.3,259.8,57.5,285,231,54
060971518004,819.9,618.4,137.8,871,691,180
060971514025,453.6,330.2,86.3,400,317,83
060971520002,387.9,302.2,53.6,386,340,46
060971522033,397.2,310.7,54.5,460,390,70
060971522034,563.9,446.7,68.9,579,499,80
060971522013,553.7,434.0,80.5,545,468,77
060971522014,392.0,309.6,54.8,372,327,45
060971522031,381.4,301.1,54.4,532,431,101
060971522012,659.6,508.6,100.1,489,429,60
060971522032,431.7,341.8,54.9,528,466,62
060971522011,508.9,384.5,86.9,432,355,77
060971523002,613.8,470.5,97.5,645,503,142
060971523001,762.3,564.1,147.3,863,672,191
060971518001,797.0,597.6,144.0,708,568,140
060971518003,430.3,317.5,81.0,471,382,89
060971523003,837.7,617.4,170.0,847,618,229
060971523004,458.5,350.5,79.1,466,349,117
060971515021,739.5,535.7,155.0,845,665,180
060971517005,640.1,459.8,131.2,576,465,111
060971524002,1041.3,711.1,262.0,1247,836,411
060971518005,397.7,286.7,80.5,352,272,80
060971517001,362.8,260.9,80.4,248,194,54
060971522023,663.9,464.2,152.9,834,593,241
060971518002,445.7,316.4,97.3,436,344,92
060971528014,294.3,190.2,77.4,265,188,77
060971528013,695.2,442.9,191.0,601,438,163
060971528012,659.3,426.2,173.4,625,462,163
060971528015,586.4,379.2,154.1,530,396,134
060971528011,489.5,306.8,141.7,586,430,156
060971527022,428.6,294.1,100.0,525,380,145
060971528021,369.9,267.1,71.1,277,228,49
060971521001,671.0,493.0,135.1,399,330,69
060971527023,449.7,292.5,124.7,590,414,176
060971524003,1091.2,652.3,377.3,978,593,385
060971527012,545.1,370.1,132.2,349,249,100
060971527025,382.1,242.8,112.5,297,216,81
060971527013,537.5,351.1,147.9,635,428,207
060971524004,1405.4,946.9,376.2,1513,990,523
060971524001,897.2,656.1,185.0,1205,853,352
060971524005,1120.1,737.7,321.4,1172,787,385
060411322003,200.0,148.2,40.1,181,151,30
060411322001,446.2,392.4,21.5,525,466,59
060411330001,450.0,345.2,70.7,517,390,127
060411200005,884.5,700.8,131.1,690,549,141
060411322002,359.2,283.3,48.5,528,499,29
060411330003,412.9,319.3,61.8,382,265,117
060411031002,1117.1,762.4,284.2,1049,707,342
060411330004,369.8,285.9,55.4,483,423,60
060411031003,1430.1,960.0,385.3,1365,922,443
060971511003,523.5,319.9,169.8,627,397,230
060971510003,768.8,538.6,183.3,719,504,215
060971508004,1292.2,988.7,218.6,1157,875,282
060971509023,532.6,417.7,79.7,476,363,113
060971510002,597.2,376.0,175.1,615,421,194
060971543043,583.1,418.4,116.5,657,519,138
060971543023,636.9,457.1,98.9,466,402,64
060971543024,598.0,414.0,137.5,635,456,179
060971543022,675.7,529.3,96.1,747,653,94
060971537031,676.5,506.3,110.6,621,544,77
060971537035,307.1,233.8,48.5,389,336,53
060971537034,308.5,232.3,45.8,320,280,40
060971537032,396.1,304.0,57.1,411,364,47
060971543021,538.0,404.9,79.3,638,557,81
060971536004,497.9,364.4,86.6,529,443,86
060971536002,582.2,455.7,80.2,558,462,96
060330013003,459.8,197.7,216.5,441,270,171
060330013001,182.5,81.1,82.7,195,101,94
060552019002,311.0,194.3,96.0,267,178,89
060552015001,577.9,376.2,154.2,610,401,209
060552017005,351.7,230.7,95.6,349,229,120
060552017003,324.6,184.1,98.2,363,227,136
060552017002,755.7,428.5,228.6,539,317,222
060330012002,687.7,300.5,328.8,1110,626,484
060330013002,799.9,363.6,379.5,560,321,239
060971502023,408.6,290.3,102.5,438,304,134
060552011021,626.8,385.7,195.2,708,445,263
060552011012,560.3,354.2,177.5,526,336,190
060552012001,270.9,143.2,101.2,285,147,138
060552013003,498.0,286.0,188.0,610,364,246
060552013001,528.7,366.8,134.9,573,424,149
060552013002,587.3,406.2,148.1,609,414,195
060552011011,814.1,482.1,285.9,810,488,322
060552008022,761.2,489.2,224.3,850,532,318
060552008031,346.7,220.9,102.8,414,291,123
060552008032,788.6,498.9,244.3,778,463,315
060552007031,1363.7,781.7,477.7,1512,891,621
060552007032,600.0,346.3,210.6,613,372,241
060552007072,698.2,413.3,239.4,770,444,326
060552012002,465.1,264.7,168.9,467,311,156
060552012003,937.8,557.3,341.1,885,547,338
060552007063,579.0,357.3,185.2,569,368,201
060552007062,691.5,417.2,229.8,699,445,254
060552007061,702.8,437.1,220.5,625,383,242
060552007071,864.5,554.5,255.8,835,560,275
060552006014,415.5,260.9,130.8,406,259,147
060971537041,390.7,298.1,59.4,441,387,54
060971537033,328.8,258.3,42.4,300,278,22
060971537043,420.3,328.9,54.3,266,233,33
060971537042,379.3,285.5,61.8,611,531,80
060971537044,758.9,567.9,127.2,782,696,86
060971537063,845.8,601.5,139.3,867,744,123
060971537051,375.5,272.5,62.8,334,290,44
060971540002,361.2,233.9,100.6,366,259,107
060971540001,323.7,214.6,84.4,361,257,104
060971540003,717.5,460.5,207.0,848,587,261
060971538011,443.9,279.6,130.7,493,313,180
060971535024,770.5,552.5,147.3,813,631,182
060971535023,680.1,513.9,103.5,650,544,106
060971536005,930.3,673.8,179.3,991,797,194
060971535014,860.5,590.0,193.1,835,648,187
060971502041,598.4,432.8,133.4,658,506,152
060971502021,392.8,283.2,87.7,441,335,106
060971502042,875.8,657.5,169.7,658,519,139
060971502024,436.8,322.9,94.2,709,537,172
060971505004,330.7,240.1,76.4,422,326,96
060971503063,529.2,395.3,100.8,1110,909,201
060971502022,566.1,418.7,115.3,547,444,103
060971505002,456.0,333.9,89.5,525,423,102
060971516012,830.7,574.3,226.0,747,509,238
060552016021,576.1,402.8,132.9,694,495,199
060552016023,346.5,241.5,79.0,374,268,106
060552016011,575.0,426.0,126.0,518,374,144
060552016012,487.4,340.1,118.7,437,302,135
060552016022,295.5,205.8,70.6,305,201,104
060552016024,536.5,373.7,130.8,532,384,148
060552015002,450.7,272.4,141.6,460,299,161
060971526005,789.5,520.7,205.1,832,575,257
060552020004,622.6,458.9,128.2,674,512,162
060552020003,541.3,402.6,104.7,464,348,116
060552020002,347.4,257.6,68.1,385,277,108
060552020001,432.8,292.9,112.0,423,296,127
060971526002,1459.5,999.5,368.3,1508,1034,474
060971516023,1003.2,719.1,246.0,1039,708,331
060971503043,668.9,466.9,151.5,581,447,134
060971503044,612.2,427.4,138.7,586,456,130
060971503033,281.1,196.3,63.7,432,319,113
060971503032,824.4,548.9,211.4,859,582,277
060971513091,621.0,377.0,201.0,628,407,221
060971505003,735.1,528.3,159.5,934,683,251
060971503041,379.8,273.8,83.9,414,298,116
060971503042,838.2,604.2,185.1,696,547,149
060971503051,327.5,213.9,87.0,299,201,98
060971505001,432.8,322.3,84.4,168,141,27
060971505006,329.2,246.5,61.5,509,418,91
060971516021,792.2,563.8,186.9,834,581,253
060971505005,338.7,253.6,63.3,338,282,56
060971515031,839.7,587.3,194.7,982,679,303
060971502025,785.9,566.2,175.2,745,561,184
060971503052,553.6,416.7,108.4,434,350,84
060971503061,383.6,292.3,67.2,296,258,38
060971503054,311.9,238.8,52.0,127,105,22
060971503062,441.9,341.8,65.8,340,294,46
060971503053,625.8,484.0,93.2,513,414,99
060330008023,314.0,160.1,123.8,296,201,95
060330008011,332.3,187.3,118.9,314,203,111
060330007021,497.1,264.8,186.2,473,318,155
060330007022,453.7,262.3,160.8,597,395,202
060330008021,345.7,169.0,141.8,267,165,102
060330006002,411.1,193.2,187.6,314,203,111
060330006003,361.6,185.1,154.1,417,246,171
060330007023,11.3,2.2,5.9,80,45,35
060330006005,385.3,157.3,195.4,350,200,150
060971517004,911.1,657.3,193.7,858,676,182
060971515042,507.5,357.2,113.3,687,524,163
060971515041,722.8,512.1,163.4,697,531,166
060971515043,741.1,526.9,160.5,731,547,184
060971522025,564.4,417.1,115.2,491,373,118
060971525022,627.2,432.3,150.8,659,508,151
060971522022,1131.3,801.4,253.4,1066,828,238
060971522024,576.2,392.3,144.0,466,359,107
060971525012,641.5,436.2,151.7,750,538,212
060971525011,901.2,651.2,187.3,761,595,166
060971515033,725.4,521.5,159.0,939,637,302
060971517002,475.5,348.7,97.8,552,414,138
060971517006,527.3,387.8,107.7,540,401,139
060971517003,618.4,453.5,127.2,542,449,93
060971525013,480.8,322.2,112.0,468,380,88
060971526003,618.5,426.4,157.0,550,425,125
060971526004,826.8,568.5,208.3,830,581,249
060971525021,686.0,475.0,169.8,748,547,201
060971522021,408.3,279.6,103.6,477,337,140
060971525023,412.5,277.0,95.7,405,312,93
060971526006,408.0,292.8,94.9,395,301,94
060971516013,906.9,648.6,231.0,905,604,301
060971516011,643.8,441.1,177.7,573,383,190
060971516022,807.0,569.5,210.4,777,486,291
060952522014,1938.6,1104.0,708.9,1711,974,737
060952522013,437.4,189.5,226.7,435,168,267
060971506072,293.1,168.3,98.9,268,171,97
060971506102,1030.3,713.4,250.6,979,709,270
060971513112,661.9,450.5,168.4,554,417,137
060971513114,513.3,349.4,130.6,498,372,126
060971513092,1317.4,835.1,392.5,1317,954,363
060971515023,490.3,320.1,133.3,589,421,168
060971515022,445.2,305.3,106.7,461,327,134
060971515026,1074.5,771.0,233.7,883,695,188
060971515025,528.8,378.9,116.0,503,406,97
060971515024,310.9,224.5,64.8,376,272,104
060971515032,688.9,490.4,156.9,676,476,200
060971539013,1065.4,750.8,249.5,1059,743,316
060971538014,839.3,579.6,199.7,865,646,219
060971538012,2268.6,1455.7,642.6,2115,1450,665
060971538083,743.8,502.4,184.1,763,551,212
060971538013,434.1,297.6,104.6,361,274,87
060971538081,709.0,452.9,204.2,527,389,138
060971539032,455.6,345.2,77.9,432,347,85
060971539023,403.1,300.6,76.4,398,329,69
060971539012,606.3,448.6,112.2,709,543,166
060971539022,359.4,263.9,72.5,259,196,63
060971539033,400.4,301.4,70.2,535,400,135
060971539034,705.5,522.5,136.0,671,540,131
060971539024,564.8,405.8,123.7,318,246,72
060971539031,586.1,427.9,120.5,652,478,174
060971538063,594.3,368.2,188.7,727,490,237
060971538041,964.9,606.6,283.0,859,576,283
060971538042,876.2,549.1,261.6,686,458,228
060971538082,408.8,278.4,95.1,336,258,78
060971538062,470.1,320.1,109.3,430,319,111
060971538092,873.0,555.5,249.7,752,519,233
060971527021,118.3,67.7,39.8,130,80,50
060971535012,631.8,453.2,118.5,725,567,158
060971534031,659.0,480.1,134.9,676,503,173
060971534044,769.9,566.1,127.8,762,621,141
060971534032,745.6,593.1,92.7,572,486,86
060971534043,481.0,365.4,73.7,504,418,86
060971534034,480.2,398.1,49.8,414,363,51
060971529061,1585.6,1017.5,444.8,1216,841,375
060971529062,944.4,592.4,293.8,1009,680,329
060971529052,636.6,426.1,165.3,692,485,207
060971533001,1025.7,735.6,197.3,1015,824,191
060971533004,1644.5,1168.2,341.9,1340,1055,285
060971531031,654.7,479.8,125.1,639,504,135
060971530055,856.0,579.6,208.2,711,529,182
060971530056,460.3,312.7,113.2,418,318,100
060971530062,380.4,262.8,87.4,344,254,90
060971530061,391.2,267.1,97.9,417,309,108
060971530064,916.6,621.6,221.4,731,581,150
060971529042,350.4,238.2,86.5,330,254,76
060971529041,585.8,418.3,121.9,621,482,139
060971529043,650.8,436.0,163.6,709,496,213
060971529044,579.1,390.4,148.3,602,448,154
060971530054,443.1,297.8,105.1,498,379,119
060971530063,707.8,479.4,165.6,610,470,140
060971530066,470.5,325.3,105.5,546,400,146
060971530065,414.3,286.4,92.9,412,302,110
060971529031,378.4,254.4,94.1,390,284,106
060971529032,561.4,422.5,96.9,461,389,72
060971527024,913.7,601.6,241.1,689,498,191
060971527015,550.8,372.2,150.7,572,415,157
060971529053,567.7,379.3,149.5,533,382,151
060971529051,575.4,372.7,172.6,593,431,162
060971535022,435.7,329.2,66.2,469,365,104
060971535021,499.5,377.3,75.9,496,403,93
060971534013,696.4,546.9,90.8,661,541,120
060971534041,577.3,449.1,79.3,527,439,88
060971534042,767.5,622.2,88.3,746,632,114
060971534016,651.1,527.9,71.5,617,547,70
060971534015,518.4,409.1,64.6,484,450,34
060971534033,482.7,406.2,45.5,504,446,58
060971534011,427.9,330.8,59.0,409,362,47
060971537061,394.4,294.4,68.3,444,356,88
060971537064,464.9,331.4,91.0,537,433,104
060971536003,616.6,478.5,90.4,564,466,98
060971536001,522.6,407.6,76.3,557,460,97
060971537054,628.7,451.4,124.1,602,492,110
060971537062,775.8,567.8,145.1,836,665,171
060971537053,603.0,432.1,117.2,732,632,100
060971537052,533.5,382.8,106.7,484,369,115
060971534014,518.8,396.9,73.2,649,536,113
060971534012,811.9,604.1,135.0,815,674,141
060971527014,385.5,263.7,91.4,371,278,93
060971531042,175.5,131.5,30.3,192,148,44
060971530031,350.9,254.1,71.1,419,330,89
060971530033,653.6,477.0,112.2,538,431,107
060971530032,319.2,232.5,59.5,275,231,44
060971530034,644.8,466.9,130.7,663,550,113
060971532004,1218.5,850.1,259.8,1022,789,233
060971531022,327.9,262.7,41.5,233,194,39
060971531023,312.7,237.6,51.6,367,301,66
060971531032,342.6,255.9,60.4,367,292,75
060971530023,279.8,207.5,42.4,302,264,38
060971531041,471.8,371.0,63.1,376,315,61
060971531024,237.3,175.5,43.4,156,138,18
060971531043,300.8,236.4,40.3,135,115,20
060971531033,106.3,78.6,19.4,164,143,21
060971531021,364.0,286.4,48.5,267,234,33
060971530022,483.6,359.8,79.1,464,387,77
060971530021,517.2,378.6,88.7,468,380,88
060971530012,679.5,482.9,138.8,653,501,152
060971530013,948.4,682.1,184.5,867,684,183
060971529034,277.8,211.2,46.1,274,220,54
060971529033,216.5,164.6,35.9,98,86,12
060971528024,447.9,329.7,78.8,385,303,82
060971528023,342.0,247.0,65.7,363,288,75
060971528022,574.5,414.9,110.4,597,486,111
060971530025,237.8,176.4,36.1,259,217,42
060971530024,311.5,231.1,47.3,288,239,49
060971521003,438.3,347.3,52.9,341,300,41
060971521002,314.0,232.3,61.0,285,239,46
060971530011,440.3,331.4,68.9,409,337,72
060971528025,337.4,253.9,52.8,278,230,48
060450107002,623.8,360.8,206.8,589,404,185
060450106002,1343.5,766.5,429.6,1446,1045,401
060450107005,278.3,155.1,91.1,245,171,74
060450106003,552.7,279.2,208.7,586,354,232
060450107006,272.5,150.2,93.3,248,178,70
060450107004,205.5,112.3,73.2,246,178,68
060450107007,260.8,132.4,112.9,267,168,99
060450107003,428.8,260.2,120.3,379,290,89
060450107001,222.7,121.7,74.9,210,148,62
060952523102,566.1,280.6,248.2,496,223,273
060952523101,1309.7,715.9,522.1,1365,705,660
060952523051,845.1,525.3,274.9,701,445,256
060952523052,384.5,216.5,146.1,402,250,152
060952532013,587.3,267.0,279.0,699,358,341
060952523111,676.5,411.0,215.3,720,431,289
060952523121,985.7,550.6,373.4,514,278,236
060952523112,1012.6,644.4,318.3,912,585,327
060952531016,566.0,256.0,262.4,625,331,294
060952523062,929.0,566.8,300.2,1130,641,489
060952523122,335.0,228.0,87.0,497,344,153
060952523113,513.6,307.2,181.6,476,289,187
060952523131,445.9,286.6,132.9,224,142,82
060952523141,426.9,274.4,127.2,497,300,197
060952523143,619.2,398.0,184.6,600,413,187
060952523142,495.1,318.2,147.6,507,327,180
060952523132,670.8,427.4,205.3,856,560,296
060952532041,871.6,380.7,431.3,761,378,383
060952532014,739.8,342.2,350.2,890,436,454
060952523133,1627.6,920.7,633.1,1131,580,551
060952523171,956.6,577.7,330.9,853,499,354
060952523162,731.7,461.3,231.4,642,443,199
060952523151,575.1,362.6,181.9,592,383,209
060952523153,699.7,458.2,203.9,798,489,309
060952523161,741.4,483.9,216.9,669,470,199
060952523152,653.5,428.0,190.5,625,419,206
060952531083,463.2,248.0,181.8,340,194,146
060952531082,465.0,247.9,187.8,427,249,178
060952531081,683.0,356.2,273.9,811,474,337
060952530001,0.0,0.0,0.0,0,0,0
060952531012,323.6,151.2,144.8,287,173,114
060952531015,464.1,213.7,210.8,467,222,245
060952529152,1063.4,558.8,434.9,696,375,321
060952531073,688.6,374.1,267.1,592,389,203
060952531071,424.7,217.1,169.3,464,296,168
060952531072,651.2,346.9,254.9,684,395,289
060952531074,307.4,167.0,119.2,270,186,84
060952529134,589.6,289.8,253.1,599,300,299
060952529132,484.1,238.5,204.2,565,310,255
060952529133,470.8,231.4,202.1,427,229,198
060952529131,529.7,261.2,222.7,625,341,284
060952531014,328.8,149.3,151.4,300,171,129
060952531013,302.6,141.8,135.0,379,213,166
060952532033,342.8,161.2,152.4,315,172,143
060952532031,787.0,357.8,369.3,580,340,240
060952532011,681.4,293.2,334.6,835,380,455
060952532012,512.4,217.0,258.4,545,278,267
060952532032,776.4,345.3,362.1,709,373,336
060952531011,203.6,108.1,83.9,144,80,64
060952531052,522.2,288.8,196.0,249,152,97
060952531054,250.6,143.7,87.7,321,194,127
060952531051,315.9,185.4,108.9,348,233,115
060952531053,435.3,238.6,167.0,594,352,242
060952531055,226.3,129.7,79.2,223,134,89
060952531062,254.5,128.3,103.4,249,148,101
060952531063,602.6,303.7,244.7,601,363,238
060952531061,255.9,129.0,103.9,267,157,110
060952532044,354.8,191.8,144.4,275,171,104
060952532053,268.9,145.4,109.4,168,108,60
060952532043,627.9,288.8,297.3,787,408,379
060952532052,216.4,117.0,88.1,303,162,141
060952532051,515.6,239.2,244.8,624,349,275
060952532045,368.3,199.2,149.9,135,101,34
060952529111,737.8,389.5,307.3,656,386,270
060952532042,455.6,202.9,221.2,593,285,308
060952532061,755.7,331.2,375.7,686,351,335
060952528012,0.0,0.0,0.0,10,9,1
060952528015,88.6,55.2,27.4,82,48,34
060952528011,0.0,0.0,0.0,5,4,1
060952528013,180.9,112.6,55.9,81,43,38
060952528014,274.8,171.0,84.8,137,74,63
060952529142,480.5,237.3,199.5,453,251,202
060952529143,542.6,274.8,222.0,599,346,253
060952529151,730.8,374.7,312.4,713,392,321
060952529141,1349.4,712.6,551.0,951,558,393
060952529082,504.7,264.9,203.6,472,279,193
060952529123,467.3,238.9,199.9,439,235,204
060952529083,397.7,203.3,170.1,400,213,187
060952529121,733.8,310.5,374.2,654,338,316
060952529101,463.6,228.9,199.0,521,298,223
060952529081,391.3,193.2,167.9,483,284,199
060952529102,464.6,229.4,199.4,528,306,222
060952529103,876.6,445.0,378.7,958,481,477
060952529112,610.2,311.5,275.0,640,346,294
060952529104,461.2,234.6,199.3,445,239,206
060952529092,811.1,344.9,399.7,850,462,388
060952529091,712.6,302.5,352.3,723,360,363
060952529122,434.2,199.1,205.0,450,237,213
060952529124,675.8,309.9,319.0,696,338,358
060952529125,568.2,240.5,289.8,608,263,345
060952529114,855.5,436.7,385.6,807,451,356
060952529113,401.6,205.0,181.0,528,287,241
060952522023,988.7,640.0,285.4,842,570,272
060952522022,1254.8,843.5,337.4,1009,646,363
060952524022,747.5,511.6,191.5,801,579,222
060952524021,256.5,184.8,56.7,379,250,129
060952523053,997.8,569.1,368.6,1019,587,432
060952524013,325.4,196.8,117.8,301,187,114
060952523061,740.0,443.0,257.0,774,444,330
060952527023,275.7,163.8,87.5,298,205,93
060952527021,396.1,235.3,125.6,405,264,141
060952527022,296.2,175.9,93.9,280,180,100
060952527031,367.6,259.8,79.4,378,274,104
060952524023,327.0,236.7,71.2,223,157,66
060952524011,261.7,183.0,62.5,313,220,93
060952525021,168.6,115.0,43.0,224,165,59
060952524012,224.7,157.2,53.7,218,152,66
060952526053,312.8,214.2,79.0,240,166,74
060952525012,462.6,321.3,112.7,535,378,157
060952524014,269.0,188.2,64.2,266,187,79
060952526043,305.0,209.7,73.5,232,150,82
060952526041,244.4,167.0,59.0,249,184,65
060952526042,390.4,266.8,94.3,441,340,101
060952526052,497.8,350.3,122.2,525,353,172
060952526063,329.9,222.5,86.6,388,275,113
060952526062,265.5,179.1,69.7,259,190,69
060952525022,365.6,246.6,96.0,180,116,64
060952525011,133.0,89.7,34.9,177,122,55
060952526072,450.0,300.6,116.4,405,297,108
060952527032,573.2,416.6,120.1,527,403,124
060952526071,273.0,182.4,70.6,305,224,81
060952526051,408.0,311.0,79.0,533,427,106
060952526061,588.0,401.0,149.0,633,442,191
060133150001,362.0,207.0,126.0,385,240,145
060133552001,713.6,531.8,150.8,165,110,55
060133270001,773.8,511.0,204.0,811,594,217
060133200041,1654.6,1016.9,518.9,1437,923,514
060133150002,1033.8,741.4,246.7,981,704,277
060133552002,2806.2,2084.6,601.9,1807,1331,476
060133553011,1795.5,1114.6,564.1,2373,1495,878
060133553041,1199.9,702.9,430.6,1211,686,525
060133553014,719.8,385.6,293.1,787,458,329
060133553023,875.0,588.2,242.9,927,538,389
060133553063,703.2,394.4,268.9,1118,601,517
060133553062,561.6,302.3,218.3,617,341,276
060133553065,434.1,225.4,179.5,406,212,194
060133553045,696.9,331.2,318.2,659,351,308
060133553064,686.0,383.5,262.0,311,184,127
060133553042,742.9,433.8,272.6,707,411,296
060133553013,785.0,506.4,211.7,780,548,232
060133331022,420.4,267.0,124.7,431,251,180
060133331023,755.7,480.0,224.1,667,480,187
060133553043,579.5,304.5,226.8,587,346,241
060133331021,685.3,380.0,266.5,706,418,288
060133553012,684.9,427.8,216.1,686,456,230
060133132042,636.1,420.8,178.5,865,580,285
060133132031,502.1,368.8,104.1,680,497,183
060133132032,85.8,62.0,17.6,166,116,50
060133132043,545.7,399.6,118.4,527,403,124
060952501061,926.3,646.2,244.5,688,441,247
060952521021,1130.7,753.2,294.5,993,725,268
060952521022,688.4,438.2,193.8,919,624,295
060952520004,778.9,532.6,197.6,749,504,245
060952522024,1771.4,1158.3,498.8,1434,987,447
060952520001,749.8,500.5,194.2,813,562,251
060952520002,466.2,315.4,122.1,425,310,115
060952506053,877.1,662.1,168.3,663,504,159
060952521042,813.4,523.0,247.6,796,518,278
060952520003,518.7,353.3,133.6,522,354,168
060952521041,1131.8,740.7,323.6,1484,949,535
060133180001,375.0,267.5,76.6,464,360,104
060133160001,599.3,446.5,109.4,443,354,89
060133170001,523.0,369.8,112.3,527,409,118
060133180002,525.9,361.5,124.6,493,363,130
060952521081,867.6,590.7,223.6,864,592,272
060952521071,986.8,638.6,270.1,1108,719,389
060952521043,1028.7,662.6,312.4,606,377,229
060133190004,275.2,165.8,86.5,275,196,79
060133190005,362.1,238.8,94.0,344,264,80
060133190001,424.5,291.1,97.7,529,386,143
060133190002,842.5,524.3,260.1,790,558,232
060133200011,587.1,380.0,168.1,510,371,139
060952521061,863.7,558.4,253.7,866,559,307
060952522021,784.5,527.0,226.3,653,437,216
060133540011,1215.5,927.6,212.5,1233,912,321
060133530024,450.0,333.1,95.1,487,335,152
060133530023,712.1,545.1,133.7,768,536,232
060014219001,528.5,473.5,18.4,555,539,16
060014206001,970.8,894.6,40.4,911,844,67
060014206002,627.0,581.8,21.1,531,499,32
060014218002,716.8,667.3,17.3,706,679,27
060014201002,585.1,529.7,33.6,502,464,38
060014201003,403.1,363.7,24.5,395,351,44
060014213001,890.3,821.7,29.2,878,845,33
060014213002,784.7,722.3,26.8,732,685,47
060014212002,1108.7,1015.1,38.8,1068,1003,65
060014212004,595.4,544.6,20.5,615,579,36
060014213003,664.3,611.2,23.5,640,614,26
060014218001,696.6,630.5,17.0,726,706,20
060014217001,991.2,907.2,28.5,926,883,43
060014213004,602.7,556.2,20.7,563,530,33
060133910001,1192.3,1054.6,69.0,1177,1096,81
060133910002,633.7,554.4,46.0,543,470,73
060014212003,514.8,471.4,13.6,561,534,27
060014217002,452.8,413.9,12.0,473,450,23
060014214002,463.8,423.1,13.3,493,461,32
060014214001,714.2,656.9,20.8,699,664,35
060014224001,967.2,863.2,41.1,953,894,59
060014217003,650.7,585.0,17.8,651,615,36
060014215002,896.2,828.1,32.1,837,775,62
060014211002,917.6,847.7,41.6,888,843,45
060014216003,563.2,516.0,15.0,560,532,28
060014215003,808.1,750.6,22.6,882,839,43
060014216004,526.2,488.7,17.4,509,475,34
060014216002,676.5,609.4,24.6,822,771,51
060133592031,475.1,379.0,80.3,298,236,62
060133592032,727.3,611.0,78.0,873,712,161
060133560013,412.2,318.2,76.1,439,346,93
060133592034,1134.4,909.1,186.2,1035,789,246
060133601022,988.0,805.4,147.6,960,777,183
060133601021,877.7,672.1,155.1,1008,782,226
060133560024,1169.6,781.9,339.1,1110,763,347
060133592022,1122.0,778.8,291.9,1374,956,418
060133592033,306.6,235.7,58.3,110,76,34
060133592035,265.6,206.1,48.5,369,287,82
060133560021,934.0,761.3,129.3,817,670,147
060133560023,299.6,226.7,60.5,671,507,164
060133592041,403.0,316.2,71.9,417,305,112
060133560022,315.8,174.7,123.8,400,247,153
060133540024,1120.3,790.3,270.1,1051,653,398
060133540022,446.0,326.2,95.5,454,297,157
060952508011,793.4,568.8,175.7,744,570,174
060952517012,622.8,495.0,88.8,707,586,121
060952518043,403.6,313.5,72.8,424,302,122
060952518031,228.4,181.2,37.5,283,206,77
060952518021,827.7,663.2,130.3,741,562,179
060552011022,426.0,223.9,162.8,502,288,214
060552008023,1361.1,866.0,396.7,1220,804,416
060133591051,2023.0,1589.0,345.0,1766,1406,360
060133923001,1193.6,987.8,174.7,1048,846,202
060133591041,911.0,769.0,114.0,884,728,156
060133580001,525.1,381.3,119.6,529,364,165
060133560012,637.1,477.7,131.8,708,541,167
060133580003,376.1,270.2,89.4,352,251,101
060133580004,431.1,321.4,83.6,335,267,68
060133580005,315.1,229.1,64.9,290,230,60
060133560011,528.0,377.1,125.5,412,319,93
060133580002,295.6,221.3,55.7,334,243,91
060133570001,453.4,323.8,93.2,429,340,89
060133570003,580.5,420.9,116.7,494,403,91
060952508012,369.4,280.0,65.6,398,310,88
060952506012,682.8,527.2,126.0,650,536,114
060952506041,992.9,761.2,184.3,745,574,171
060952516002,519.1,429.0,64.5,610,509,101
060952516001,236.1,190.0,34.8,216,183,33
060952509002,506.5,400.5,74.8,499,409,90
060952509001,394.5,326.4,48.8,344,283,61
060952517021,381.9,304.9,50.6,431,348,83
060952517022,557.6,445.2,73.8,330,281,49
060952517011,525.2,417.1,83.0,491,426,65
060952507012,420.2,341.9,54.8,393,343,50
060952507011,473.4,386.8,61.6,497,413,84
060952511001,600.7,475.7,94.3,554,434,120
060952510003,251.7,192.2,41.6,252,221,31
060952511002,257.8,196.8,42.6,279,231,48
060952510002,326.5,255.5,48.2,352,294,58
060952510001,248.3,197.1,34.0,285,235,50
060952515002,445.3,330.4,84.6,348,292,56
060952515003,484.5,384.6,66.3,419,360,59
060952512001,404.8,327.2,53.9,418,344,74
060952512002,310.5,250.3,41.5,357,303,54
060952512003,232.1,191.3,30.0,222,196,26
060952508013,297.6,244.3,37.5,302,259,43
060952506013,347.8,268.3,64.0,303,237,66
060952506051,357.0,275.0,65.8,437,317,120
060952506011,586.4,442.1,119.2,531,446,85
060952506052,765.5,581.9,144.5,735,535,200
060952504003,326.0,211.7,93.6,287,188,99
060952504002,591.2,423.0,133.9,568,409,159
060952514003,712.0,522.1,148.0,929,650,279
060952514002,634.1,473.7,125.6,666,481,185
060952515001,325.2,233.5,69.8,208,161,47
060952513001,320.4,227.3,70.9,468,360,108
060952513002,452.2,318.2,102.1,662,488,174
060952513003,407.5,286.3,92.3,558,389,169
060952519012,359.7,293.7,50.5,325,227,98
060952519011,522.5,437.5,65.2,776,664,112
060952519013,596.4,499.3,74.4,603,488,115
060952514001,1029.4,750.5,212.3,770,581,189
060952501051,618.1,462.3,127.5,491,385,106
060133570002,621.0,441.6,131.1,698,531,167
060952506043,457.7,352.5,85.2,587,428,159
060952506042,380.4,286.5,73.4,526,417,109
060952521052,849.8,562.8,233.4,675,467,208
060952521063,644.8,424.5,174.5,507,377,130
060952521062,834.5,548.5,226.7,802,514,288
060952521082,872.8,591.2,229.0,881,612,269
060952521072,909.2,594.9,251.1,869,585,284
060952521051,1196.5,778.1,341.0,1208,763,445
060952505012,414.2,274.3,114.2,451,329,122
060952504001,327.0,234.9,73.3,358,254,104
060952502003,576.0,430.8,113.6,602,406,196
060952502002,376.3,281.1,74.5,340,235,105
060952503003,252.8,194.0,44.5,239,172,67
060952503002,444.9,341.5,78.3,557,463,94
060952502001,601.5,441.4,127.9,429,317,112
060952505011,358.5,243.4,94.6,365,256,109
060952505022,729.8,519.5,173.3,866,614,252
060952505021,695.3,496.2,164.1,707,497,210
060952521032,1324.0,929.9,319.4,1284,902,382
060952503001,463.8,342.6,96.0,414,273,141
060952521033,846.9,641.6,174.4,610,438,172
060952501031,482.2,360.6,99.5,483,341,142
060952501032,652.1,489.3,134.5,713,516,197
060952501052,913.9,712.6,170.1,850,636,214
060952501033,506.2,378.6,104.4,584,423,161
060952501041,440.9,327.7,95.7,474,335,139
060952501053,1043.3,806.0,202.6,1123,799,324
060952501042,522.9,388.3,114.1,575,387,188
060952501062,1261.4,997.6,222.0,1121,788,333
060952519031,417.4,361.0,44.8,493,400,93
060952518032,476.7,366.4,88.6,373,279,94
060952518041,433.9,342.0,74.9,365,274,91
060952518042,397.0,313.5,68.1,405,275,130
060952518033,422.1,329.2,75.3,322,232,90
060552010071,750.4,533.5,171.5,749,531,218
060552010051,387.9,265.7,97.8,409,285,124
060552010072,833.1,592.3,190.4,652,466,186
060552010052,589.8,387.1,162.1,486,315,171
060552010061,717.8,473.1,195.4,632,429,203
060552010062,667.6,418.5,202.2,628,397,231
060552010032,1384.5,1079.9,258.7,690,517,173
060552010031,311.9,168.9,115.5,394,214,180
060952518034,481.7,389.8,76.3,352,249,103
060952519021,361.6,292.6,57.3,366,286,80
060952519022,589.1,476.7,93.3,585,482,103
060952519023,317.5,256.9,50.3,306,269,37
060552010041,1225.1,913.0,250.0,945,680,265
060552010042,1024.9,769.0,203.0,980,712,268
060952519033,761.2,658.3,81.7,767,682,85
060952519032,690.9,597.5,74.2,699,606,93
060552009001,137.2,85.4,46.4,112,78,34
060552006012,551.0,331.0,184.0,544,361,183
060552006013,567.0,356.0,172.0,538,370,168
060552006011,878.8,515.8,298.0,748,471,277
060552006022,494.8,299.0,160.0,498,295,203
060552006023,560.7,335.3,186.1,458,272,186
060552006021,1299.8,850.1,382.6,1169,801,368
060552005012,372.0,260.0,86.0,322,231,91
060552005011,428.0,300.0,108.0,376,258,118
060552005043,379.7,267.5,87.2,471,323,148
060552005041,659.3,461.6,152.8,388,303,85
060552005042,1202.6,811.5,311.2,1053,745,308
060552012004,920.6,550.0,316.7,868,568,300
060552002023,516.8,392.6,80.8,518,414,104
060552002032,403.9,295.7,73.4,364,299,65
060552002031,491.0,346.5,111.3,368,294,74
060552003011,838.3,557.4,234.5,633,455,178
060552003012,379.8,264.7,90.8,342,241,101
060552002022,287.0,220.4,41.5,159,133,26
060552002021,217.6,162.1,40.3,245,192,53
060552005032,181.2,140.9,25.4,129,99,30
060552004003,452.5,311.6,104.4,453,311,142
060552005031,389.0,303.2,57.8,444,343,101
060411032003,1487.5,976.6,427.9,1472,988,484
060411031004,892.6,590.6,246.3,862,585,277
060411022023,1082.8,718.6,301.7,1057,738,319
060411021002,1069.5,757.5,243.2,1027,721,306
060411022025,977.5,679.5,248.8,903,612,291
060411041022,1218.9,915.9,233.6,953,758,195
060411041012,724.1,517.1,160.7,872,585,287
060411032002,1096.3,806.5,216.1,1000,779,221
060411032001,548.2,405.2,109.1,485,358,127
060411022021,263.0,188.3,58.5,132,111,21
060411041011,818.4,603.4,168.9,961,676,285
060411041013,1167.6,825.1,272.9,1177,839,338
060411022031,650.0,488.4,115.6,524,411,113
060411022022,461.1,328.3,104.5,592,425,167
060411022033,703.8,500.5,159.8,738,535,203
060411021001,384.9,272.0,89.5,482,334,148
060971507023,850.5,627.3,168.1,900,642,258
060971508001,513.0,402.2,71.8,468,388,80
060971509024,421.4,342.7,52.6,407,343,64
060971508003,511.3,400.8,71.5,433,359,74
060971509021,565.9,409.1,117.3,553,424,129
060971509015,571.5,433.4,98.4,468,382,86
060971506092,466.1,306.4,132.9,408,302,106
060971507014,469.7,372.9,67.2,431,363,68
060971507024,564.3,433.2,95.1,598,483,115
060971507013,564.0,462.7,67.2,478,416,62
060971508002,568.6,447.7,68.9,532,444,88
060971507012,961.4,723.1,177.6,822,698,124
060971509011,477.8,386.0,62.7,425,368,57
060971507022,561.8,408.2,116.4,612,467,145
060971507021,715.6,518.7,149.0,742,533,209
060971507011,575.5,434.7,102.0,426,355,71
060971509022,447.1,336.8,79.2,567,456,111
060971509014,387.7,292.0,68.6,279,228,51
060971506091,837.1,600.9,189.7,751,569,182
060971506071,514.4,356.0,125.3,486,337,149
060971506093,524.7,366.0,121.5,470,361,109
060971506094,472.5,329.5,109.4,467,356,111
060971506103,397.8,277.5,92.1,448,315,133
060971506101,560.0,390.6,129.6,554,427,127
060971509013,501.1,388.7,82.4,459,363,96
060971506031,875.1,635.8,179.7,841,659,182
060971509012,322.9,250.5,53.1,349,279,70
060971506035,543.2,377.8,117.0,267,207,60
060971506032,328.5,233.5,63.3,277,221,56
060971506036,541.6,365.8,132.6,538,408,130
060971506014,374.5,256.7,87.3,376,292,84
060971506021,661.5,450.8,162.8,641,468,173
060971506033,318.2,219.1,73.1,297,224,73
060971506011,591.3,406.6,135.0,625,449,176
060971506111,1243.0,840.8,312.2,959,692,267
060971506012,371.1,260.1,82.7,401,308,93
060971506013,466.2,326.8,103.9,330,253,77
060971506023,647.6,435.3,161.0,640,482,158
060971506034,812.7,530.9,224.3,802,549,253
060971506024,640.4,427.8,161.6,581,422,159
060971506022,378.1,254.1,95.1,340,246,94
060971506121,1516.2,1026.1,379.6,1538,1083,455
060971506112,383.8,257.7,98.5,534,348,186
060971506113,183.7,126.0,45.1,158,120,38
060411081003,808.2,615.9,147.3,731,570,161
060411081001,1867.1,1468.7,293.2,1860,1462,398
060411082003,504.4,376.8,108.9,751,553,198
060411060012,917.0,717.6,142.3,848,698,150
060411070001,913.1,714.2,149.1,989,743,246
060411060011,433.5,335.7,71.9,367,306,61
060411060022,944.4,741.3,137.3,948,729,219
060411042001,1064.4,752.5,244.4,926,656,270
060411041014,1165.0,866.5,245.4,1122,826,296
060552004002,753.8,554.7,145.5,758,598,160
060552003013,606.3,412.8,152.6,634,475,159
060552003022,570.2,357.9,162.3,550,396,154
060552003021,667.2,415.3,196.5,511,351,160
060552004001,817.7,500.0,259.9,901,588,313
060552005051,583.1,404.7,144.4,374,267,107
060552005052,341.2,232.8,85.3,469,337,132
060552014013,534.9,277.3,218.5,509,267,242
060552014021,457.1,240.4,188.2,482,284,198
060552014022,477.7,275.0,164.7,481,286,195
060552014023,880.8,476.1,340.1,982,554,428
060411090012,671.5,523.1,112.5,705,533,172
060411090023,330.1,261.9,48.8,407,322,85
060411082002,1112.5,900.8,155.2,1301,1042,259
060411090011,614.0,508.6,69.7,519,436,83
060411090013,621.9,509.0,69.6,608,520,88
060411101003,1128.4,920.2,153.8,989,845,144
060411101002,1066.7,801.9,215.1,1135,811,324
060411122022,171.7,141.2,22.8,70,60,10
060411122011,335.7,284.7,35.7,297,237,60
060411122012,199.8,169.4,21.2,138,115,23
060411102003,1303.7,932.7,303.4,1367,975,392
060411101001,1013.1,768.9,197.8,1044,750,294
060411110001,570.3,464.1,66.6,461,409,52
060411241004,1421.1,1085.1,246.2,1280,1002,278
060411241003,302.9,236.7,49.2,321,253,68
060411242004,1134.4,841.5,219.0,1039,744,295
060411242005,831.4,601.7,179.1,978,715,263
060411242002,645.1,467.5,134.0,552,391,161
060411242003,571.4,411.7,125.8,732,520,212
060411230002,787.6,560.2,183.9,877,554,323
060411241002,688.4,494.9,155.2,716,503,213
060411241001,852.7,657.7,132.1,880,668,212
060411212002,825.8,652.4,130.7,926,746,180
060411220001,185.9,127.4,45.3,96,70,26
060411122021,862.4,707.8,116.0,965,777,188
060411102001,1615.7,1175.8,360.2,1639,1105,534
060411070002,474.3,378.1,74.8,610,456,154
060411070003,407.8,340.5,50.7,559,460,99
060411070004,831.8,663.1,131.2,877,678,199
060411042003,1141.8,728.4,361.2,1126,673,453
060411031001,1199.0,833.8,300.1,1218,762,456
060411022024,460.0,332.8,100.2,403,314,89
060133760001,255.7,240.5,7.6,291,282,9
060133650023,367.1,335.4,20.8,255,234,21
060133650022,203.2,189.0,7.5,139,130,9
060133650021,403.6,367.9,23.1,368,347,21
060133730003,291.6,260.5,19.3,176,162,14
060014204001,644.0,524.0,25.0,531,454,77
060014205002,813.5,726.7,43.4,692,631,61
060133800002,398.7,375.5,11.0,263,258,5
060133790001,370.9,350.4,9.5,457,443,14
060133790002,367.3,350.9,7.0,431,429,2
060133810003,476.8,447.3,16.6,449,431,18
060133770001,243.5,220.3,14.7,204,190,14
060133820002,690.6,638.4,23.6,736,711,25
060133810005,289.2,256.2,16.9,247,220,27
060133750002,213.1,190.9,11.9,183,172,11
060133750003,145.1,130.0,8.1,138,127,11
060133750001,279.7,250.6,15.6,286,269,17
060133740004,466.5,407.3,32.8,392,349,43
060133740001,394.0,347.1,27.5,500,447,53
060133740002,434.2,383.8,28.9,361,324,37
060133740003,319.0,282.0,18.8,258,232,26
060133720005,308.3,265.4,25.6,251,220,31
060133720004,302.3,257.7,28.8,338,291,47
060133810004,257.9,238.7,11.1,187,184,3
060133810002,461.3,426.7,20.4,493,480,13
060133860002,254.6,223.1,16.8,243,225,18
060133820003,943.0,873.5,25.9,848,815,33
060133820001,277.9,256.8,9.3,446,441,5
060133810001,482.1,443.7,23.2,428,414,14
060133710005,323.0,283.0,26.3,271,234,37
060133710006,334.6,291.9,29.0,366,325,41
060133710004,364.6,314.3,37.2,324,278,46
060133710003,355.1,305.4,36.0,379,335,44
060133700003,426.6,359.8,44.4,341,305,36
060133710001,309.1,262.4,30.4,293,254,39
060133710002,251.1,213.2,24.7,227,190,37
060133720003,350.4,296.7,36.1,301,254,47
060014203003,502.9,429.9,49.5,396,349,47
060014203001,627.9,536.9,57.3,734,667,67
060014205001,414.1,358.5,27.8,438,388,50
060133820004,502.4,449.1,26.6,393,369,24
060133830003,960.1,835.1,70.8,937,838,99
060133830002,755.8,660.9,52.6,649,595,54
060133830001,662.1,577.0,34.6,608,569,39
060014203002,448.1,383.9,27.9,984,838,146
060014202003,502.2,437.9,34.3,403,364,39
060014202001,548.0,481.0,45.8,476,427,49
060014206003,612.6,548.3,35.3,623,573,50
060014202002,390.8,341.4,28.2,442,411,31
060014201001,552.7,496.7,35.9,544,503,41
060750120001,934.8,809.9,64.9,767,679,88
060750120002,759.0,663.0,50.1,671,609,62
060750111003,443.7,378.9,36.1,444,397,47
060750122012,684.4,591.7,43.0,663,604,59
060750122011,1008.4,884.2,51.3,949,880,69
060750111002,1144.9,992.3,80.0,1019,909,110
060750124012,946.0,809.8,67.2,596,514,82
060750125022,546.6,439.1,69.1,456,355,101
060750125021,473.7,388.5,58.0,519,411,108
060750121001,1123.7,980.2,79.2,1104,1008,96
060750123021,598.9,520.4,43.0,549,486,63
060750123012,375.8,317.7,33.0,299,266,33
060750123022,393.8,343.2,29.3,368,315,53
060750111001,1220.9,1045.9,94.8,1101,965,136
060750110003,1063.8,931.5,83.4,1012,885,127
060750112002,669.2,561.6,71.0,674,546,128
060750110002,987.7,852.4,88.0,964,829,135
060750110001,504.0,424.9,47.4,447,381,66
060750109003,1093.1,952.2,97.8,982,841,141
060750119011,505.5,424.2,54.7,481,397,84
060750119012,741.2,631.4,65.8,693,602,91
060750112001,743.9,614.3,85.0,634,506,128
060750112003,404.8,340.4,41.1,418,342,76
060750108003,866.5,735.4,81.7,867,736,131
060750125012,465.0,388.0,48.6,383,332,51
060750123011,399.3,338.3,38.3,435,362,73
060750176015,471.4,399.7,43.2,392,336,56
060750121002,437.3,378.0,36.0,399,357,42
060750131012,1443.4,1251.8,114.8,1356,1149,207
060750129023,576.9,478.5,64.2,551,441,110
060750130003,592.0,475.0,83.4,630,495,135
060750128001,1061.0,865.0,131.4,979,751,228
060750130004,617.6,508.5,79.6,575,447,128
060750126022,741.1,613.9,91.9,542,411,131
060750129022,695.7,586.6,65.6,662,525,137
060750129021,780.5,654.2,86.4,760,630,130
060750130002,641.2,524.9,79.3,632,485,147
060750130001,813.2,688.3,76.5,700,589,111
060750129011,773.1,648.6,78.3,785,644,141
060750129012,783.6,652.7,77.4,802,622,180
060750102003,617.1,535.2,53.4,636,517,119
060411250001,538.9,409.1,98.2,697,496,201
060411230001,468.2,333.0,109.4,622,452,170
060411242001,20.8,15.8,3.8,0,0,0
060411282002,1421.0,1250.4,101.7,1353,1208,145
060411261002,849.1,744.7,67.0,898,815,83
060411270001,729.6,634.7,65.2,668,600,68
060411261004,575.6,506.4,46.5,592,528,64
060411261003,708.7,620.4,53.3,632,559,73
060411261001,933.5,818.0,81.9,1016,867,149
060411262001,1144.3,1004.5,94.2,1157,982,175
060411262003,388.1,327.1,46.8,351,300,51
060411200003,1083.5,877.0,144.6,1122,948,174
060411200002,635.8,513.6,86.4,675,552,123
060411211003,681.9,574.8,78.5,632,528,104
060411211002,413.1,348.2,47.5,486,425,61
060750127003,448.0,359.9,58.2,482,364,118
060750128004,494.9,397.8,65.5,414,320,94
060750128003,592.8,472.1,86.3,601,455,146
060750127002,700.5,536.2,121.6,744,554,190
060750127001,882.3,663.6,162.4,907,635,272
060750126011,1403.9,1127.4,193.4,1441,1065,376
060750158011,238.4,216.1,11.4,259,240,19
060750153001,598.5,532.9,27.5,600,529,71
060750159002,777.0,675.0,66.0,802,698,104
060750155002,716.7,643.9,41.1,617,525,92
060750155001,877.3,740.4,96.6,730,578,152
060750152003,562.7,496.8,33.2,515,460,55
060750152002,796.5,691.3,63.1,778,682,96
060750152001,995.2,882.6,71.9,933,784,149
060750135002,828.6,720.9,62.5,798,688,110
060750135001,794.3,697.7,53.0,862,732,130
060750132002,432.9,353.5,58.4,431,332,99
060750132001,1411.4,1150.6,184.5,1196,946,250
060750131022,815.8,674.5,95.2,808,633,175
060750159001,1014.7,860.2,106.4,1099,931,168
060750161001,445.2,403.1,28.7,407,374,33
060750151002,496.4,418.9,50.4,462,372,90
060750160001,1397.7,1216.2,125.6,1229,1088,141
060750151001,977.6,829.5,97.8,934,791,143
060750131021,925.1,796.4,88.9,840,688,152
060750131011,1061.0,894.4,96.2,1092,901,191
060014215001,1040.7,957.2,42.1,934,859,75
060014212001,475.1,440.0,20.2,490,462,28
060133920002,482.2,439.9,22.8,500,460,40
060014211001,589.1,533.1,29.4,588,551,37
060133920001,771.5,688.6,46.4,771,698,73
060133920003,472.2,425.3,25.9,429,375,54
060133851002,610.2,528.1,49.6,626,537,89
060133901001,589.2,516.4,40.4,428,373,55
060133851001,909.7,768.9,96.6,1139,952,187
060014216001,658.3,588.2,34.2,734,673,61
060133601023,338.3,255.8,61.8,342,255,87
060133601011,636.1,485.3,114.8,587,446,141
060133592021,985.5,737.7,215.6,1033,726,307
060133592023,1062.5,781.5,235.4,802,588,214
060133592043,1282.8,1002.4,223.7,1203,873,330
060133592042,567.2,445.4,100.4,599,452,147
060750202002,1521.7,1376.7,71.8,1311,1223,88
060750168013,563.6,525.6,16.5,477,460,17
060750168023,690.7,643.4,17.4,583,554,29
060750168022,853.5,795.1,20.2,786,768,18
060750163002,683.2,621.1,30.8,707,662,45
060750163001,461.4,426.3,16.8,480,454,26
060750162002,710.6,648.0,30.0,527,488,39
060750162003,610.8,566.2,22.4,508,458,50
060750168021,718.6,658.8,23.8,563,531,32
060750162001,422.4,385.6,22.2,424,392,32
060750133002,692.4,576.6,74.8,677,539,138
060750154002,709.0,633.0,43.0,541,489,52
060750154001,402.0,327.0,55.7,508,413,95
060750134002,955.0,841.3,75.0,876,760,116
060750134003,873.8,761.6,71.3,895,743,152
060750155003,366.4,328.2,17.3,332,311,21
060750153002,712.5,634.1,37.5,624,570,54
060750132003,877.2,733.1,101.3,941,702,239
060750128002,523.9,420.4,70.7,552,409,143
060750134001,497.9,441.6,37.2,505,444,61
060411211005,483.4,411.8,34.7,490,416,74
060411211004,652.0,549.1,68.6,617,531,86
060411200001,608.1,490.9,83.1,621,513,108
060411211001,780.2,653.3,94.7,773,634,139
060411250002,738.0,553.5,139.9,701,505,196
060411250003,847.2,668.7,133.4,840,663,177
060411212003,1101.3,879.4,172.6,1016,802,214
060411212004,424.8,342.6,59.6,453,356,97
060411212001,588.5,466.0,93.1,620,459,161
060411191004,722.7,560.3,124.6,715,548,167
060411121002,475.3,377.2,69.9,520,449,71
060411121001,448.9,366.7,55.4,286,248,38
060411121004,622.5,490.9,90.6,566,469,97
060411191001,394.9,306.2,68.1,522,379,143
060411192013,968.2,786.6,139.8,1017,788,229
060411191003,547.2,424.2,94.3,394,312,82
060411200004,867.0,708.0,116.0,678,542,136
060411191002,652.4,531.5,89.2,784,638,146
060411110003,1080.8,904.8,118.8,1002,856,146
060411110004,916.1,769.3,89.6,853,773,80
060411192011,752.1,609.2,106.5,672,584,88
060411192022,990.0,773.8,164.0,1108,843,265
060411192021,1036.1,800.8,179.4,1078,770,308
060411192012,326.0,251.0,57.3,310,249,61
060411110002,391.0,318.3,44.4,390,354,36
060411121003,650.9,556.8,56.4,692,599,93
060411090022,1165.8,963.5,137.2,1107,951,156
060411082004,496.9,363.5,96.5,522,355,167
060133892001,296.5,259.1,20.6,219,202,17
060133892002,404.6,353.5,28.1,320,285,35
060133880002,703.5,619.7,45.6,700,630,70
060133891001,514.3,451.3,36.2,489,433,56
060133891002,584.7,514.8,41.8,484,427,57
060133880001,644.7,568.5,38.6,608,562,46
060133902001,648.7,572.0,46.6,624,556,68
060133902002,492.5,435.6,32.1,498,428,70
060133901003,414.8,366.1,28.5,404,350,54
060133901002,516.5,455.7,35.7,513,468,45
060133860001,395.0,334.7,35.7,327,298,29
060133860004,572.8,498.9,38.6,379,335,44
060133870003,436.6,368.8,43.3,383,332,51
060133840003,789.6,693.5,47.8,736,638,98
060133840002,598.2,505.7,56.5,598,510,88
060133852001,358.0,303.6,36.0,424,368,56
060133852002,367.1,307.1,36.7,294,246,48
060133860003,394.8,344.8,25.5,352,292,60
060133870001,527.6,460.8,34.0,476,408,68
060133700002,419.5,355.9,41.0,455,397,58
060133840004,481.6,422.6,31.2,444,395,49
060133840001,646.4,553.7,63.5,640,532,108
060133870002,350.4,286.0,46.7,356,296,60
060133730002,286.3,254.1,20.5,271,244,27
060133730001,428.5,380.3,30.7,386,346,40
060133680012,342.6,311.9,17.0,365,342,23
060133680014,245.6,221.7,13.3,166,151,15
060133680013,221.5,199.3,12.4,205,182,23
060133680011,158.7,143.8,8.3,100,95,5
060133680022,301.2,268.3,18.3,226,198,28
060133680021,342.3,304.5,23.0,369,325,44
060133720007,211.6,183.7,17.3,181,158,23
060133720006,303.4,263.3,24.7,281,242,39
060133690013,295.9,253.5,25.0,186,163,23
060133690012,607.2,529.0,51.4,728,658,70
060133690014,399.6,342.7,38.0,366,326,40
060133660022,463.7,408.9,38.1,427,357,70
060133660013,237.9,212.4,16.2,224,191,33
060133660021,255.0,227.0,19.8,217,189,28
060133672002,622.4,533.4,62.2,531,451,80
060133720002,407.7,345.0,42.6,368,316,52
060133720001,329.2,278.5,34.4,263,215,48
060133690011,353.4,313.0,26.2,290,248,42
060133672003,268.7,224.6,31.5,224,192,32
060133671003,498.5,444.3,25.9,461,420,41
060133671002,284.8,253.9,14.8,398,365,33
060014238002,783.4,716.0,34.7,800,733,67
060014238001,543.9,499.5,22.2,469,435,34
060014238003,904.7,829.7,28.0,931,892,39
060014237002,727.3,654.4,27.1,835,779,56
060014237001,850.1,756.2,45.1,773,700,73
060014237003,460.9,413.1,19.7,529,493,36
060014236022,810.4,734.7,23.3,853,790,63
060014228001,1220.8,1095.7,56.9,1950,1805,145
060014227003,761.0,671.0,34.1,1076,970,106
060014227002,413.1,362.4,15.7,546,500,46
060014225002,520.9,458.9,21.8,687,640,47
060014226001,377.1,333.0,14.4,318,291,27
060014225003,683.1,613.0,26.6,969,911,58
060014227001,281.6,250.6,9.8,502,468,34
060014002001,709.5,644.2,34.6,741,691,50
060014043001,781.1,691.7,58.0,780,691,89
060014002002,653.7,593.3,32.2,617,569,48
060014003001,725.7,654.4,24.5,750,717,33
060014073001,344.0,300.4,13.9,343,323,20
060014088004,629.4,584.6,19.8,509,479,30
060014061002,204.8,180.6,7.6,183,170,13
060014072004,387.3,338.0,28.7,327,294,33
060014072003,362.9,316.7,26.9,253,220,33
060014072002,306.5,271.9,18.3,260,232,28
060014074003,137.3,122.3,8.1,91,88,3
060014074002,235.6,212.3,11.5,196,187,9
060014072001,218.2,197.4,9.2,235,222,13
060014071022,315.3,277.9,20.1,279,253,26
060014071024,302.6,266.7,19.3,300,274,26
060014071023,239.5,209.6,15.2,218,196,22
060014074001,432.0,392.3,16.4,471,456,15
060014076005,312.0,279.0,15.0,284,263,21
060014076002,330.3,301.5,9.2,420,400,20
060014076004,506.5,462.4,14.1,427,406,21
060014076003,511.5,472.1,18.7,455,426,29
060014075003,245.1,232.3,3.9,339,327,12
060014075001,196.4,184.7,3.9,160,155,5
060014075002,408.5,384.0,8.1,399,382,17
060014278004,552.7,461.2,56.6,429,360,69
060014277001,462.7,380.5,58.9,204,166,38
060014276001,824.7,705.2,69.5,483,420,63
060014273005,428.2,358.3,46.3,532,430,102
060014273004,365.7,302.2,39.5,285,232,53
060014278003,457.1,390.0,41.0,412,338,74
060014278005,710.0,598.8,72.9,486,423,63
060014278002,565.2,454.2,67.7,531,415,116
060014278001,395.4,319.5,50.3,371,291,80
060014273003,386.7,322.3,40.8,421,346,75
060019832001,491.0,452.0,17.0,157,153,4
060014030002,383.4,307.9,61.1,410,333,77
060014031001,694.1,615.5,38.8,395,364,31
060014025001,382.0,342.0,19.1,426,415,11
060014025002,229.5,205.5,11.5,188,181,7
060014024001,645.6,581.3,16.4,520,506,14
060014024002,458.7,413.0,11.6,414,401,13
060014027002,495.8,442.1,11.2,418,401,17
060014028001,511.7,444.1,35.8,421,374,47
060014030001,493.6,395.6,71.1,434,325,109
060014033001,1339.5,1200.9,66.7,1113,1003,110
060014033002,404.5,341.1,37.3,295,236,59
060014049003,642.2,568.6,40.5,559,514,45
060014049004,792.8,716.3,40.1,801,723,78
060014057001,490.5,425.3,24.4,409,394,15
060014050003,850.5,763.1,45.6,800,736,64
060014050002,798.9,721.0,44.3,762,699,63
060014051005,752.4,683.2,34.4,627,572,55
060014014002,761.1,653.6,22.6,581,572,9
060014014001,472.3,410.9,14.2,400,397,3
060014251042,890.4,806.5,38.7,781,733,48
060014251023,372.4,336.5,16.9,214,200,14
060014251041,937.5,854.8,36.1,724,682,42
060014009002,688.0,613.6,12.7,558,548,10
060014009001,716.9,636.7,12.4,608,599,9
060014008003,788.4,696.6,20.0,624,617,7
060014008002,560.2,497.4,13.8,507,496,11
060014008001,714.6,636.3,17.5,674,650,24
060014007001,675.2,610.0,13.8,592,587,5
060014007002,723.2,662.4,12.7,662,654,8
060014013001,486.9,423.2,15.3,428,413,15
060014010004,397.9,354.4,8.3,274,273,1
060014010005,503.2,444.6,9.5,350,345,5
060014010006,523.9,467.1,9.7,475,463,12
060014010003,753.6,688.9,14.2,664,651,13
060014011004,723.9,660.0,20.4,498,478,20
060014011002,886.2,794.6,22.2,804,773,31
060014011003,567.8,492.6,18.2,435,415,20
060014035022,773.8,700.7,28.5,656,608,48
060014012003,390.8,358.6,8.2,366,350,16
060014041022,955.5,871.9,33.2,535,484,51
060014040002,747.0,685.3,22.3,807,771,36
060014012002,595.5,550.9,7.9,514,491,23
060014010001,484.9,446.6,7.9,398,391,7
060014010002,485.4,443.4,9.4,389,382,7
060014007004,744.3,674.6,12.1,577,565,12
060014007003,536.1,487.4,4.9,467,465,2
060014011001,416.7,378.2,13.0,457,443,14
060014003002,920.1,836.9,33.8,842,807,35
060014003003,620.3,565.9,19.5,635,607,28
060014012001,670.6,622.9,13.4,740,715,25
060014003004,986.4,910.7,29.6,976,929,47
060014006001,616.2,563.2,9.8,620,610,10
060014006002,394.8,360.8,6.2,382,374,8
060014005002,638.5,595.6,7.3,519,510,9
060014004002,816.4,758.0,10.2,777,762,15
060014005001,1272.4,1150.3,18.6,1249,1223,26
060014005003,376.4,335.5,6.0,429,422,7
060014004003,796.8,731.0,22.3,724,708,16
060014231004,486.3,448.5,12.3,460,441,19
060014234001,617.0,568.0,8.1,565,550,15
060014234002,535.0,492.4,7.0,511,496,15
060014240022,570.8,518.4,10.8,475,464,11
060014240013,612.0,549.4,11.4,545,528,17
060014240014,610.3,546.2,12.4,438,433,5
060014240012,381.2,341.7,8.2,379,370,9
060014240011,469.3,421.5,9.5,448,439,9
060014239012,625.4,542.3,17.5,645,630,15
060014234003,878.8,800.4,18.1,828,808,20
060014234004,639.9,581.4,14.3,583,567,16
060014235001,767.0,684.4,20.8,583,560,23
060014230003,868.0,780.8,23.4,791,765,26
060014223001,589.0,535.8,14.7,557,531,26
060014223002,945.5,856.9,25.6,915,866,49
060014230001,917.9,812.9,31.2,869,833,36
060014230002,999.6,892.0,33.3,994,955,39
060014229002,741.4,640.6,34.0,874,817,57
060014224002,433.4,385.3,15.1,442,416,26
060014224003,718.8,646.7,21.2,713,688,25
060014235003,640.0,574.4,14.5,627,604,23
060014235002,498.1,446.1,11.4,517,506,11
060014239011,666.1,596.3,8.6,550,537,13
060014236023,994.7,889.4,43.3,1067,1001,66
060014236021,843.3,723.7,32.4,872,802,70
060014236012,726.2,663.3,14.5,726,703,23
060014239022,604.0,561.6,7.9,529,513,16
060014236011,883.9,802.6,25.6,1054,1031,23
060014229001,832.3,722.3,30.2,786,742,44
060014228003,760.2,671.7,33.7,909,831,78
060014228002,545.1,484.7,21.1,847,784,63
060014225001,659.0,578.0,27.0,744,713,31
060014036001,535.3,486.9,20.4,540,523,17
060014036002,996.2,902.0,30.2,836,798,38
060014035013,269.0,247.0,7.0,241,238,3
060014040001,1158.7,1052.6,38.7,1040,980,60
060014039003,859.1,778.8,28.2,933,874,59
060014039002,604.8,544.9,23.2,498,476,22
060014041021,876.9,805.6,25.6,941,886,55
060014041012,1196.9,1084.5,46.2,1234,1153,81
060014041011,766.1,702.9,27.3,809,764,45
060014087004,187.1,172.9,5.8,194,191,3
060014087005,385.2,358.1,13.0,366,349,17
060014077002,558.1,513.9,17.6,550,528,22
060014077003,554.1,505.8,17.4,600,578,22
060014063003,235.3,203.1,11.7,166,158,8
060014063002,277.0,238.2,14.1,235,211,24
060014063001,259.7,221.8,13.8,347,300,47
060014065003,454.2,389.8,32.2,387,334,53
060014065004,371.4,319.7,24.8,349,309,40
060014065002,211.5,191.5,9.5,223,198,25
060014064001,298.1,259.7,16.3,312,280,32
060014064002,513.2,447.2,28.3,541,500,41
060014071011,420.1,363.4,26.5,358,326,32
060014071012,315.7,276.1,18.7,422,395,27
060014071021,592.8,525.1,32.2,453,419,34
060014065001,604.0,534.3,25.8,540,485,55
060014066022,364.4,330.3,16.3,344,310,34
060014066021,476.5,426.1,25.9,444,405,39
060014066012,512.8,444.7,30.1,483,429,54
060014066013,518.5,457.9,33.2,533,490,43
060014066011,369.3,328.9,20.5,274,247,27
060014066014,335.1,296.0,21.4,341,317,24
060014049002,656.2,585.0,35.0,564,531,33
060014049001,615.5,568.3,19.8,542,506,36
060014048001,772.4,685.4,51.2,704,650,54
060014048002,800.6,715.6,40.8,787,724,63
060014050001,500.4,448.9,29.1,506,468,38
060014070003,420.2,364.5,26.4,412,386,26
060014070004,438.8,380.5,27.6,370,334,36
060014070002,366.4,308.8,30.5,372,332,40
060014070005,294.6,248.2,24.5,293,260,33
060014076001,597.9,549.3,19.0,482,456,26
060014070001,313.6,266.9,28.8,325,272,53
060014060002,237.4,202.0,21.4,191,164,27
060014054013,296.4,254.9,19.5,222,184,38
060014054021,545.4,474.6,29.5,428,377,51
060014054012,392.1,336.7,20.4,288,256,32
060014054011,457.4,392.4,18.0,440,400,40
060014054022,326.9,284.3,13.6,311,291,20
060014055003,349.1,304.1,18.1,280,255,25
060014055002,379.8,330.8,19.7,303,281,22
060014055001,210.3,185.2,10.8,228,206,22
060014055004,504.3,440.1,24.7,522,495,27
060014053022,489.9,418.1,34.0,389,356,33
060014053011,1250.0,1120.1,36.7,1036,974,62
060014052002,595.7,504.2,45.2,511,469,42
060014052003,663.4,576.9,37.3,712,635,77
060014036003,1144.5,1049.1,36.4,1058,1009,49
060014037021,365.3,324.8,14.6,399,368,31
060014037022,833.7,741.2,33.4,738,697,41
060014052001,775.2,672.1,46.2,681,614,67
060014038003,608.1,555.2,17.4,464,444,20
060014051003,547.6,488.9,35.4,605,544,61
060014059012,331.8,290.5,18.0,345,297,48
060014059013,207.6,181.7,11.2,196,168,28
060014059011,310.5,271.8,16.8,241,207,34
060014059021,365.4,315.5,25.0,319,278,41
060014059022,444.4,384.2,30.1,368,308,60
060014058003,267.0,228.1,19.7,257,230,27
060014058004,199.3,178.2,9.9,185,160,25
060014056002,386.4,340.0,18.3,355,334,21
060014062011,245.0,213.7,15.8,289,269,20
060014062013,290.5,253.4,18.7,202,186,16
060014062014,213.8,186.5,13.8,143,129,14
060014062012,161.2,140.6,10.4,149,137,12
060014058002,275.9,235.1,21.9,220,206,14
060014058001,367.1,312.9,29.1,314,287,27
060014063004,276.0,241.0,12.5,238,220,18
060014057002,389.8,339.7,21.6,292,268,24
060014057003,374.3,325.2,19.4,358,337,21
060014056003,869.8,743.3,43.5,608,577,31
060014056001,252.7,221.6,11.9,299,280,19
060014051002,420.7,378.4,28.1,503,431,72
060014051004,511.6,472.8,19.9,440,421,19
060014039001,982.7,864.8,45.5,880,824,56
060014038004,852.6,780.2,22.6,855,807,48
060014038002,581.6,530.3,17.8,616,569,47
060014262002,1306.3,1133.3,116.3,1325,1127,198
060014262003,725.1,644.3,48.9,678,593,85
060014262001,1045.7,911.8,81.7,1048,883,165
060014043003,880.8,768.5,70.6,862,738,124
060014043002,658.6,590.6,41.9,648,569,79
060014038001,494.7,441.2,26.6,422,390,32
060014261005,787.1,642.8,101.0,823,592,231
060014261004,681.8,548.6,94.8,673,542,131
060014261001,766.6,646.7,75.1,680,573,107
060014004001,984.3,896.0,21.4,998,970,28
060014239021,535.8,493.0,10.0,520,500,20
060552008042,402.0,288.0,83.0,366,291,75
060552008041,469.0,350.0,81.0,333,263,70
060552007052,496.0,302.6,164.6,281,191,90
060552007051,1063.8,621.7,368.8,860,558,302
060552008021,306.0,219.0,65.0,280,211,69
060552002013,369.7,260.7,82.8,379,295,84
060552008044,338.8,237.9,79.2,295,219,76
060552002012,570.0,417.5,120.7,498,371,127
060552008043,272.0,193.0,62.0,241,173,68
060552002011,443.3,327.9,89.5,430,330,100
060552005013,817.0,592.0,179.0,669,499,170
060552007041,663.5,415.5,202.3,888,583,305
060552007042,531.1,338.4,152.5,593,372,221
060552007043,384.5,259.1,95.8,374,280,94
060133551141,898.7,549.4,298.1,910,523,387
060133430031,1487.3,1001.7,406.8,1569,1021,548
060133383022,768.1,478.5,248.4,822,479,343
060133383021,1311.9,855.0,391.1,1456,856,600
060133430022,1332.5,913.8,349.8,1376,903,473
060133383012,724.3,470.2,221.9,727,412,315
060133383023,1233.5,904.0,262.7,1285,916,369
060133382012,886.0,562.5,272.0,999,585,414
060133383011,1017.4,643.6,297.4,1105,651,454
060133373002,767.2,504.4,215.6,769,495,274
060133372006,770.0,502.0,219.0,729,507,222
060133373001,809.7,549.6,203.9,790,502,288
060133373006,607.3,377.4,194.1,623,382,241
060133373004,488.3,322.4,142.9,450,291,159
060133373003,418.4,267.5,130.7,407,252,155
060133553022,559.0,361.2,166.9,580,352,228
060133553021,588.7,367.9,190.0,567,344,223
060133340063,638.5,448.7,158.6,272,201,71
060133340062,1268.1,879.6,323.3,1213,840,373
060133372005,728.1,473.0,212.2,799,522,277
060133372001,290.7,185.9,87.8,231,161,70
060133372003,423.7,270.8,128.1,332,231,101
060133361013,196.2,153.1,30.9,91,77,14
060133371001,887.0,553.5,283.7,987,568,419
060133371002,708.3,426.6,245.0,617,352,265
060133350002,506.4,342.3,133.7,569,363,206
060133350003,359.3,264.4,73.2,261,192,69
060133142003,344.0,258.9,67.3,442,352,90
060133142002,613.7,442.7,137.4,546,404,142
060133142001,325.5,245.0,63.6,345,281,64
060133141033,480.4,384.6,68.4,375,307,68
060133141021,544.9,431.4,89.9,554,476,78
060133141032,366.9,291.5,51.1,404,304,100
060133141041,379.9,308.5,50.7,382,300,82
060133141042,556.1,451.5,74.3,524,424,100
060133141031,461.4,366.5,64.2,382,325,57
060133132033,197.3,144.5,39.8,272,216,56
060133132051,319.7,230.8,65.5,534,386,148
060133141043,369.4,292.0,54.0,403,310,93
060133141044,254.9,191.7,49.4,260,202,58
060133141022,371.7,299.1,56.4,352,288,64
060133141023,644.0,507.6,111.0,601,461,140
060133132061,415.7,344.6,52.8,422,352,70
060133110003,492.5,408.6,65.3,459,382,77
060952527071,731.3,519.5,165.8,660,485,175
060952527033,442.7,330.9,89.8,382,285,97
060952527045,418.6,287.4,101.3,428,319,109
060952527041,320.4,220.0,77.5,227,166,61
060952527042,241.4,165.8,58.4,296,214,82
060952527044,248.8,170.8,60.2,312,227,85
060952526082,638.2,459.5,141.6,656,494,162
060952526081,311.2,225.5,58.6,351,258,93
060952526112,187.6,145.8,31.8,235,189,46
060952526102,529.2,360.2,133.8,607,432,175
060952526113,234.7,183.1,38.9,247,188,59
060952526111,398.1,284.8,90.3,340,250,90
060952526101,615.0,405.1,166.8,671,432,239
060133400026,1101.7,783.8,259.7,1180,833,347
060133470001,1515.5,1037.4,377.0,1630,1063,567
060133260001,1356.6,930.6,345.9,1344,886,458
060133400021,578.3,391.9,142.9,584,401,183
060133211032,1143.7,715.7,361.7,1057,685,372
060133180003,635.0,422.7,167.7,706,532,174
060133190006,796.5,515.4,223.5,653,474,179
060133190003,885.7,550.2,273.8,913,659,254
060133211014,659.1,419.3,198.4,717,456,261
060133211033,406.0,244.5,139.9,391,249,142
060133170002,492.3,339.4,108.6,438,335,103
060133211031,1139.4,750.2,306.6,1124,764,360
060133211023,1178.0,791.5,315.7,1004,671,333
060133470003,920.4,595.0,256.6,914,584,330
060133211022,1217.7,836.2,307.6,1063,712,351
060133211021,655.7,443.1,166.1,772,540,232
060133211013,944.5,601.6,280.4,910,585,325
060133211012,806.3,512.4,237.5,809,545,264
060133211024,1096.2,762.4,262.0,1201,833,368
060133200043,668.9,433.5,180.7,718,484,234
060133200042,765.9,514.0,190.3,624,464,160
060133200031,1322.9,862.5,373.1,1524,1037,487
060133200012,922.6,556.1,305.0,802,542,260
060133400025,425.3,302.6,92.5,372,245,127
060133410003,1046.1,786.6,196.9,912,680,232
060133410001,958.9,699.1,200.0,885,671,214
060133400024,947.3,697.2,199.2,947,661,286
060133400023,1014.3,739.3,213.9,927,657,270
060133342004,522.4,394.8,97.8,521,374,147
060133390011,678.6,506.1,128.0,617,468,149
060133390023,1001.0,727.0,221.4,807,576,231
060133390021,760.1,557.4,155.7,754,552,202
060133390012,565.7,432.1,93.4,516,434,82
060133390024,423.3,305.3,97.3,352,247,105
060133382042,534.0,383.0,116.0,540,361,179
060133400022,399.1,274.0,95.2,424,292,132
060133260002,712.5,464.0,194.9,710,504,206
060133250003,985.3,708.3,208.6,977,696,281
060133250004,612.9,445.6,130.8,620,464,156
060133400013,675.5,480.9,155.6,709,487,222
060133400012,1026.3,735.3,222.4,958,682,276
060133400014,770.7,545.7,176.9,759,525,234
060133382031,1005.1,746.7,187.5,1053,756,297
060133250002,315.3,222.7,69.6,285,228,57
060133400011,379.5,271.1,82.1,366,257,109
060133250005,425.8,310.1,90.7,412,282,130
060133250001,540.6,390.1,111.2,603,424,179
060133240021,1019.2,745.3,206.3,962,706,256
060133430012,456.6,324.0,100.8,466,318,148
060133430014,900.9,649.9,193.8,659,441,218
060133430011,634.2,427.0,168.8,677,417,260
060133240022,581.1,410.6,123.4,434,331,103
060133230001,504.2,349.6,104.4,539,394,145
060133212003,350.7,245.2,82.6,289,230,59
060133220001,210.3,147.8,48.8,339,237,102
060133220002,237.4,167.4,54.2,368,266,102
060133270005,610.7,370.9,196.8,698,475,223
060133211011,962.6,643.1,256.4,1022,715,307
060133212002,1100.3,767.2,259.0,1032,752,280
060133212001,746.1,479.0,219.4,705,508,197
060133220005,346.3,245.7,78.4,397,281,116
060133240023,865.5,611.6,198.6,772,600,172
060133220004,966.1,656.2,240.9,991,680,311
060133362011,351.2,264.7,68.3,620,428,192
060133362021,499.5,360.6,114.6,347,263,84
060133240011,262.9,186.4,57.8,330,245,85
060133362013,147.3,114.9,24.4,159,113,46
060133362023,283.7,216.6,51.5,147,109,38
060133362022,183.5,143.1,30.4,85,73,12
060133362012,240.1,178.1,48.7,308,229,79
060133381011,291.7,214.6,58.2,295,215,80
060133381013,804.0,591.6,160.4,658,509,149
060133381022,253.8,168.5,71.5,253,170,83
060133381023,1019.4,661.4,292.0,1126,756,370
060133381012,334.1,211.8,94.9,345,236,109
060133372002,676.7,450.3,181.6,513,378,135
060133372004,348.3,231.7,93.4,433,289,144
060133361021,441.7,327.1,90.1,233,178,55
060133280002,301.6,225.5,56.9,366,275,91
060133361022,318.0,232.2,65.5,169,139,30
060133361023,200.7,146.5,41.3,104,87,17
060133361024,314.6,234.9,59.7,322,257,65
060133361012,354.8,276.8,55.9,487,372,115
060133361011,310.2,241.9,48.9,293,231,62
060133270003,463.7,332.9,104.0,410,297,113
060133270004,405.7,279.5,88.1,371,289,82
060133270002,285.3,196.5,61.9,188,137,51
060133290004,635.3,445.2,143.1,509,392,117
060133290003,473.7,331.7,106.5,495,362,133
060133280001,361.0,253.1,81.4,339,248,91
060133310003,352.8,222.3,99.7,350,245,105
060133310006,461.8,314.9,115.7,340,253,87
060133300004,687.0,479.0,152.0,671,508,163
060133300002,746.2,517.8,180.5,702,483,219
060133072043,605.5,437.6,138.8,656,433,223
060133072054,633.7,406.7,193.5,672,417,255
060133072052,655.4,472.8,148.9,608,469,139
060133072041,431.7,306.7,103.4,479,303,176
060133072042,304.8,212.9,77.2,405,269,136
060133072051,407.8,291.0,95.0,331,259,72
060133072023,354.1,267.3,64.2,77,65,12
060133072021,251.6,189.9,45.6,305,249,56
060133551083,1768.4,1387.1,306.6,1534,1179,355
060133551081,1699.8,1266.2,360.5,1714,1292,422
060133551082,1699.2,1290.9,334.4,1421,1082,339
060133551092,371.1,258.4,92.5,407,252,155
060133071013,583.4,356.1,192.4,690,443,247
060133071012,375.6,235.7,118.8,400,253,147
060133071011,628.5,408.3,187.9,694,433,261
060133071024,536.6,362.9,146.7,552,385,167
060133080014,509.6,307.9,175.4,509,321,188
060133071023,344.1,251.3,73.4,338,241,97
060133071022,232.1,169.5,49.5,491,385,106
060133072022,113.5,82.9,24.2,149,135,14
060133060031,446.8,297.5,120.1,475,324,151
060133032011,952.0,692.0,205.0,893,641,252
060133551102,700.1,506.4,154.3,634,491,143
060133350001,628.4,384.1,206.8,685,442,243
060133310005,527.8,351.6,137.4,557,360,197
060133340011,830.9,525.5,249.3,879,608,271
060133340012,821.1,522.8,243.2,741,509,232
060133373005,324.4,219.1,90.3,460,292,168
060133340061,526.4,344.9,145.9,612,434,178
060133340044,730.5,484.3,204.8,686,455,231
060133310004,542.6,337.5,171.2,497,318,179
060133320004,652.8,417.6,196.1,687,424,263
060133310002,665.2,419.1,196.8,694,447,247
060133300003,403.8,276.5,99.0,458,333,125
060133310001,332.0,212.5,96.1,281,206,75
060133320007,259.7,169.6,72.4,277,193,84
060133320005,377.6,238.1,115.8,392,262,130
060133320006,415.9,278.3,110.3,318,235,83
060133320001,835.0,524.5,261.3,960,623,337
060133320003,536.1,342.4,162.2,483,301,182
060133320002,474.6,305.6,139.1,488,321,167
060133340043,826.0,576.3,199.4,956,694,262
060133332004,697.0,434.3,217.4,652,424,228
060133332005,647.7,430.3,162.7,677,469,208
060133332003,610.6,379.1,197.1,632,396,236
060133332002,585.5,361.1,191.6,634,393,241
060133340042,969.9,665.5,240.8,836,586,250
060133340041,615.0,430.0,135.0,642,462,180
060133331012,823.6,522.8,244.7,827,547,280
060133331013,609.7,377.5,196.6,613,381,232
060133332001,453.2,283.1,146.3,490,301,189
060133331011,486.0,255.5,196.4,512,306,206
060133390022,653.5,516.2,92.5,534,428,106
060133430013,874.5,631.8,190.0,741,574,167
060133430021,833.6,592.8,195.7,1140,841,299
060133382033,452.4,334.3,87.6,480,336,144
060133382041,847.4,611.0,195.3,930,657,273
060133382043,688.7,500.1,150.1,701,493,208
060133240013,912.5,663.9,190.1,699,537,162
060133240012,764.8,548.9,164.0,778,548,230
060133240014,99.6,72.6,20.7,52,40,12
060133382032,867.5,634.8,162.8,826,612,214
060133381021,529.2,361.1,136.4,528,364,164
060133382044,897.5,634.5,213.1,794,549,245
060133382011,1089.4,711.7,323.7,1095,678,417
060133220003,1073.1,728.2,265.8,1217,792,425
060133230004,507.1,345.0,128.4,532,366,166
060133230002,602.1,394.5,161.6,539,366,173
060133230003,713.7,501.2,164.6,752,526,226
061130110021,548.0,250.9,257.0,531,253,278
061130110011,827.1,438.9,335.3,926,470,456
061130109021,653.0,378.0,231.0,668,420,248
061130110012,462.8,308.2,123.7,391,267,124
061130109022,659.0,404.0,196.0,618,387,231
061130109011,767.6,440.2,265.9,756,460,296
061130109012,314.3,182.4,106.3,390,232,158
061130109013,527.1,315.5,167.3,459,323,136
061130110013,779.8,413.8,308.5,651,423,228
061130109023,482.6,310.1,134.1,486,322,164
061130108002,399.0,253.5,117.7,402,261,141
061130111011,602.4,348.8,203.5,512,331,181
061130108001,617.4,374.7,203.8,588,360,228
061130107012,859.2,745.2,50.4,783,694,89
061130107034,347.3,294.7,28.7,331,272,59
061130107032,716.7,611.9,51.3,914,774,140
061130106024,391.7,329.2,27.9,287,238,49
061130107011,553.0,462.6,53.2,613,510,103
061130107013,403.8,345.7,30.5,382,340,42
061130107041,1261.2,1049.1,126.5,1190,995,195
061130107014,470.9,395.7,36.3,442,395,47
061130107031,228.3,195.4,15.4,194,165,29
061130105103,912.0,766.0,78.0,446,389,57
061130105091,816.0,667.4,93.8,636,515,121
061130105092,1292.3,1057.8,166.2,1046,866,180
061130106022,456.8,383.9,32.5,507,446,61
061130106021,974.5,828.0,85.6,910,773,137
061130105101,285.6,231.8,36.0,473,367,106
061130105102,523.9,446.8,50.1,1005,840,165
060070006033,352.0,244.4,66.0,488,361,127
060070006044,258.7,163.9,62.2,325,211,114
060070006042,430.1,241.1,139.7,313,232,81
060070006041,242.4,184.9,26.0,270,211,59
060070006034,273.2,193.8,42.9,264,216,48
060070006043,186.5,142.3,20.0,150,122,28
060070006045,269.1,205.2,28.8,272,227,45
060070006032,294.8,203.1,52.0,358,286,72
060070006031,211.7,145.9,37.4,248,186,62
060070010004,188.0,126.6,39.8,272,212,60
060070010002,217.5,149.6,40.2,290,228,62
060070010006,553.8,381.1,101.4,612,487,125
060070010005,196.8,131.8,40.2,231,187,44
060070012004,352.1,234.3,69.0,283,217,66
060070012001,344.1,229.0,67.4,414,349,65
060070012002,291.6,194.1,57.1,377,321,56
060070010001,254.0,172.3,47.5,335,253,82
060070010003,292.9,202.9,51.5,301,239,62
060070007002,574.8,374.6,139.9,653,486,167
060070007003,785.7,522.1,190.6,828,545,283
060070007004,443.1,296.4,101.3,472,348,124
060070007001,523.1,315.5,149.4,516,367,149
060070006012,387.7,230.4,127.0,424,258,166
060070003001,324.7,169.4,119.3,205,118,87
060070001021,615.1,321.3,236.0,651,380,271
060070002024,265.0,130.2,108.1,367,201,166
060070003004,315.4,164.6,115.9,330,190,140
060070003003,200.4,104.5,73.6,267,138,129
060070002021,412.0,202.9,167.6,490,282,208
060070002014,778.7,340.2,367.0,654,360,294
060070002023,396.1,180.2,185.3,352,179,173
060070002013,300.7,128.4,141.8,345,155,190
060070002011,354.8,155.7,161.8,328,186,142
060070002022,281.2,136.7,116.8,276,157,119
060070008004,525.3,312.4,153.8,595,321,274
060070001041,631.7,328.7,245.5,877,479,398
060070001042,1081.7,548.7,427.6,984,542,442
060070001031,1933.3,963.9,824.1,1729,967,762
060070001043,518.2,264.3,213.6,465,283,182
060070001022,690.9,360.4,266.7,638,350,288
060070003002,596.2,291.8,243.5,538,296,242
060070013002,254.5,170.9,49.0,373,284,89
060070013001,381.7,240.4,90.3,367,274,93
060070013004,307.7,206.1,59.7,246,200,46
060070008006,378.3,223.8,120.1,362,224,138
060070008003,611.1,361.3,190.3,563,373,190
060070008001,545.6,322.9,179.9,666,376,290
060070008005,491.3,290.6,156.5,358,222,136
060070009032,373.1,197.2,132.5,500,287,213
060070001023,683.1,345.9,280.3,674,372,302
060070008002,407.6,241.3,136.3,495,300,195
061030006001,674.9,220.2,410.3,747,322,425
060890123024,862.9,199.5,620.0,919,274,645
060890123031,1062.2,219.0,805.1,910,277,633
060890123022,451.4,103.6,321.8,419,130,289
060890123023,881.2,209.2,625.2,736,241,495
060890123021,398.7,90.7,283.4,507,169,338
060890106032,482.6,161.8,287.1,509,210,299
060890110012,481.5,131.8,315.5,495,171,324
060890106031,276.8,92.4,164.1,257,106,151
060890106024,804.0,291.0,454.9,943,385,558
060890106011,576.4,197.7,333.4,830,314,516
060890110011,425.1,121.0,274.3,418,157,261
060890110021,631.4,191.7,392.7,615,197,418
060890106012,648.7,233.0,366.6,758,296,462
060890106022,587.2,228.1,317.5,611,238,373
060890106023,882.4,321.0,499.0,848,338,510
060890106021,457.5,185.2,233.7,435,230,205
060890123012,397.7,116.3,257.1,438,174,264
060890123011,575.6,172.8,371.7,572,206,366
060890110024,782.0,229.7,498.3,807,303,504
060890120001,343.2,82.6,237.8,269,109,160
060890115001,456.4,98.9,335.0,345,118,227
060890111002,730.0,203.9,480.2,641,254,387
060890122004,585.5,140.1,415.1,446,175,271
060890121013,679.9,173.9,456.4,602,224,378
060890120003,225.5,63.8,144.5,142,66,76
060890120002,447.3,122.1,289.5,397,157,240
060890121012,553.7,155.4,354.5,569,245,324
060890114012,588.7,155.4,403.3,515,179,336
060890115002,724.1,182.2,502.6,1210,318,892
060890114022,801.5,218.1,531.9,614,203,411
060890114021,972.4,255.4,667.4,729,226,503
060890114031,643.8,145.0,459.0,651,181,470
060890114032,613.4,169.8,402.0,566,199,367
060890108051,482.7,113.0,342.6,441,130,311
060890114011,682.8,187.7,450.0,643,238,405
060890113004,504.2,135.2,328.1,479,160,319
060890112093,508.4,163.3,307.8,453,190,263
060890114013,548.2,144.5,378.0,670,236,434
060890119001,752.3,163.4,551.6,938,280,658
060890103002,859.9,270.1,525.5,931,341,590
060890103001,638.8,188.6,400.4,625,251,374
060890108033,1010.0,272.5,670.2,922,340,582
060890113002,429.5,126.0,269.9,371,159,212
060890113001,341.4,105.4,209.0,394,176,218
060890112094,316.0,94.9,188.8,264,90,174
060890108052,1660.9,433.9,1119.5,1774,654,1120
060890108032,409.6,117.3,261.1,277,108,169
060890108031,909.9,248.4,599.2,915,323,592
060890113003,520.6,139.3,339.9,555,196,359
060890112092,401.8,119.4,244.0,535,205,330
060890108042,616.2,189.4,395.9,702,232,470
060890108041,641.5,184.9,418.0,692,230,462
060890119002,742.3,165.7,541.2,608,161,447
060890121021,373.7,88.7,268.7,366,129,237
060890121011,471.4,133.3,303.4,428,194,234
060890115004,672.9,164.6,468.2,515,174,341
060890119004,613.7,145.7,445.0,593,201,392
060890115003,937.4,220.5,668.5,1090,345,745
060890116003,460.4,130.7,302.2,354,133,221
060890107021,953.1,343.0,555.0,961,390,571
060890107022,897.5,307.2,536.4,1079,429,650
060890110023,499.4,155.2,307.7,390,176,214
060890110022,503.8,162.4,306.2,483,196,287
060890105003,496.6,192.2,259.2,562,286,276
060890105002,616.2,225.8,341.8,666,292,374
060890111001,889.0,251.1,582.8,816,298,518
060890104004,584.2,177.7,373.0,617,244,373
060890104003,332.8,101.2,212.5,285,121,164
060890104002,462.2,165.7,257.0,559,232,327
060890104001,361.3,129.9,200.4,299,146,153
060890101002,273.9,104.9,147.3,233,123,110
060890102001,854.6,348.6,444.0,926,433,493
060890109002,865.2,229.8,576.3,921,300,621
060890109001,697.7,229.5,424.4,658,263,395
060890105001,534.6,221.6,261.3,540,290,250
060890101001,359.1,147.3,183.5,172,93,79
060890107032,996.0,313.5,605.3,837,319,518
060890107043,890.5,282.1,554.2,647,254,393
060890107042,522.4,163.3,325.7,419,162,257
060890107031,472.0,148.5,294.7,515,204,311
060890107041,548.6,179.7,340.0,618,264,354
060890108062,409.0,130.0,244.0,409,184,225
060890112091,495.0,160.1,296.7,527,227,300
060290052034,425.8,95.7,308.3,472,131,341
060290060041,462.1,100.1,341.7,537,142,395
060290060042,267.0,69.2,184.0,210,61,149
060290065003,264.5,63.1,185.4,268,89,179
060290055081,448.4,159.0,261.2,443,169,274
060290055083,435.7,190.8,227.4,444,193,251
060290060073,835.2,180.1,606.2,823,217,606
060290055073,542.0,208.3,295.4,568,247,321
060290055072,984.0,360.8,557.3,1000,387,613
060379002011,402.7,111.4,263.7,438,108,330
060379100011,358.9,234.1,99.4,723,414,309
060379001043,557.1,310.7,203.7,495,278,217
060379001042,576.4,302.9,234.7,518,281,237
060379001031,535.6,289.9,208.0,430,218,212
060379001033,449.5,253.3,159.7,471,264,207
060379800031,1.0,0.0,1.0,0,0,0
060379009002,570.6,241.6,298.9,522,227,295
060379003001,1444.2,553.1,820.5,1059,393,666
060379001021,259.9,136.6,103.3,275,169,106
060379110012,379.2,100.6,253.2,317,121,196
060379001032,507.3,259.5,209.8,480,222,258
060290055082,476.7,165.2,283.7,375,131,244
060290057001,126.0,52.0,63.0,201,75,126
060290056002,335.6,105.0,202.1,384,153,231
060290065001,409.3,96.9,273.8,482,169,313
060290056001,324.1,105.1,191.1,404,163,241
060290055071,373.8,153.3,197.4,760,309,451
060290055014,189.9,47.4,125.7,89,22,67
060290054033,534.6,152.0,334.5,569,164,405
060290054034,736.2,176.1,493.4,701,207,494
060290054031,769.7,223.3,471.1,738,250,488
060290054023,721.3,221.2,432.2,898,252,646
060290054014,673.1,201.4,412.4,765,214,551
060290054032,1096.5,319.3,670.9,1013,363,650
060290054012,626.2,210.5,354.3,513,201,312
060290054021,525.5,167.4,306.8,543,189,354
060290054022,644.7,193.7,397.9,912,284,628
060290054042,922.9,274.0,556.9,1015,337,678
060290054035,325.4,89.9,197.4,222,90,132
060290054043,772.6,224.0,469.9,992,309,683
060290054015,611.0,196.0,368.0,660,233,427
060290054013,296.4,102.5,164.9,390,134,256
060290054011,323.6,111.9,180.0,311,130,181
060290054044,339.5,91.2,221.9,241,76,165
060290054041,532.8,156.4,335.7,511,145,366
061070043001,176.0,88.0,82.0,161,83,78
060290046042,1209.7,955.0,204.1,791,611,180
060290046041,153.0,32.0,114.0,140,24,116
060290046031,0.0,0.0,0.0,0,0,0
060290046043,0.0,0.0,0.0,1,0,1
060290046011,0.5,0.5,0.0,0,0,0
061070043002,161.0,100.7,56.0,300,179,121
061070042004,159.4,47.7,105.4,179,51,128
061070042001,148.6,72.2,70.7,145,88,57
061070044003,116.3,93.4,19.5,80,67,13
061070043003,76.9,41.3,33.8,145,68,77
061070044004,173.6,140.0,28.3,144,107,37
061070044001,328.3,271.0,47.2,298,249,49
061070032002,121.1,27.3,91.1,149,45,104
061070031003,148.7,44.2,98.0,151,34,117
061070031001,155.2,48.8,99.0,166,42,124
061070021001,281.5,78.3,191.4,233,43,190
061070042003,420.1,182.0,216.1,370,191,179
061070032003,108.9,34.8,69.3,201,80,121
061070042002,136.9,59.3,70.4,116,62,54
061070032001,368.4,231.0,116.9,251,102,149
061070031002,408.1,142.8,241.6,322,141,181
061070024003,499.0,165.7,302.5,442,167,275
061070029041,860.0,330.4,471.8,736,323,413
061070034002,180.3,76.3,95.8,201,79,122
061070034005,190.0,54.5,123.8,217,74,143
061070034004,380.0,165.6,195.7,478,194,284
061070034003,257.9,112.6,130.5,173,56,117
061070039021,671.8,232.0,405.1,621,228,393
061070037003,404.7,185.5,194.1,623,252,371
061070039015,452.6,203.9,226.5,209,106,103
061070039012,162.9,84.5,72.3,137,68,69
061070039014,295.6,145.3,135.5,144,79,65
061070035021,203.8,95.0,99.8,232,76,156
061070034001,214.9,138.8,62.3,180,108,72
061070033001,374.2,155.4,203.9,422,160,262
061070033003,170.2,45.7,116.8,241,41,200
061070033005,375.4,136.8,226.9,570,177,393
061070037001,314.0,155.3,140.8,396,187,209
061070035011,912.1,326.2,545.5,903,291,612
061070037004,300.3,142.4,142.6,411,148,263
061070039022,336.9,137.7,182.9,214,104,110
061070039023,212.5,86.9,115.4,139,64,75
061070039013,156.2,76.3,70.0,192,96,96
061070007012,391.4,116.7,255.1,310,84,226
061070035024,1483.8,630.5,779.8,1255,575,680
061070036023,1036.1,428.6,550.1,876,335,541
061070041012,348.8,229.5,99.7,188,139,49
061070041011,542.5,365.8,145.8,364,224,140
061070038011,263.1,129.0,121.7,150,62,88
061070038012,400.5,197.5,178.4,310,163,147
061070041014,284.5,153.8,116.1,161,102,59
061070041021,326.2,176.4,133.2,293,136,157
061070038022,127.1,68.6,51.9,96,58,38
061070038021,296.9,153.0,121.6,245,150,95
061070041013,249.6,127.2,102.3,123,91,32
061070035023,495.5,221.6,245.7,503,233,270
061070036021,477.6,243.6,209.3,261,132,129
061070035022,555.6,251.3,272.9,697,286,411
061070040001,134.2,72.5,54.8,118,45,73
061070039011,172.8,89.6,76.9,192,84,108
061070037002,297.9,139.8,138.5,189,101,88
061070025002,311.4,120.9,179.8,433,150,283
061070033002,238.2,96.1,129.1,196,79,117
061070033006,328.0,151.0,161.8,259,122,137
061070033004,201.8,92.9,99.5,122,68,54
060310012002,410.2,93.9,304.1,441,121,320
060310001001,347.4,65.6,274.2,407,87,320
060190070033,470.3,252.4,207.1,476,237,239
060190070031,486.2,281.8,190.2,483,268,215
060190070034,327.8,179.8,136.6,391,224,167
060190070032,824.2,567.6,218.4,618,417,201
060190070021,441.0,196.4,229.6,335,182,153
060190070023,354.4,199.1,139.7,273,166,107
060190070043,487.7,250.4,215.3,435,247,188
060190070042,902.0,444.5,421.1,592,285,307
060190070041,370.8,159.9,197.5,732,320,412
060190016001,837.9,373.9,431.9,849,415,434
060190069002,142.2,76.1,60.8,191,103,88
060190015002,423.4,252.9,149.1,419,266,153
060190059042,269.0,101.6,153.7,211,90,121
060190071001,193.9,140.4,45.3,203,130,73
060190085011,250.0,156.9,84.6,192,97,95
060190085021,396.4,321.6,61.6,302,229,73
060190085023,433.7,371.6,45.9,211,177,34
060190085013,210.8,177.9,25.4,225,187,38
060190085012,258.0,217.6,31.2,200,164,36
060190069003,196.2,112.8,78.1,223,126,97
060190069001,287.3,201.4,79.7,207,167,40
060190061002,297.3,206.3,79.9,145,107,38
060190061005,648.6,389.8,223.3,470,278,192
060190059051,389.9,130.4,247.2,379,146,233
060190061003,284.5,167.1,98.3,361,220,141
060190061001,378.2,253.1,110.2,355,257,98
060190061004,336.4,200.2,122.2,364,229,135
060190062022,257.2,206.5,39.2,201,167,34
060190062012,267.4,201.0,54.8,291,199,92
060190062011,234.7,188.4,35.8,115,95,20
060190062023,385.8,298.2,68.9,273,228,45
060190084021,139.3,36.0,98.7,124,40,84
060190084015,189.8,110.9,69.2,170,93,77
060190084016,146.8,113.5,23.0,135,110,25
060190083013,308.1,253.9,44.4,126,94,32
060190084013,237.1,154.1,72.7,351,189,162
060190083021,285.1,222.4,53.7,223,177,46
060190039002,233.0,87.4,136.9,169,69,100
060190084012,126.6,87.3,32.7,108,73,35
060190084011,553.4,396.2,125.3,338,277,61
060190084014,266.2,175.3,78.9,180,121,59
060190083012,255.5,214.7,32.7,304,245,59
060190083011,157.6,127.1,25.9,209,157,52
060190083024,134.5,108.4,22.1,83,66,17
060190083025,235.6,189.9,38.7,146,112,34
060390004001,143.4,35.5,103.2,140,30,110
060390004002,181.7,66.5,111.8,210,74,136
060190073002,247.9,107.8,135.0,256,101,155
060190017002,317.0,147.9,158.1,298,152,146
060190017001,363.3,168.7,183.3,360,163,197
060190017003,950.8,491.1,415.1,744,370,374
060190016003,558.7,352.6,182.0,412,272,140
060190016002,302.9,152.4,136.9,217,134,83
060190074002,222.0,69.1,145.0,197,83,114
060190073003,243.0,90.9,143.3,207,86,121
060190073005,293.6,95.3,187.4,278,90,188
060190073001,241.4,93.5,137.3,242,104,138
060190071003,184.7,106.8,73.2,141,75,66
060190071005,459.6,345.3,94.7,384,263,121
060190071002,118.7,92.7,20.9,104,77,27
060190071004,287.5,233.0,43.1,197,164,33
060190070022,275.8,178.5,80.6,286,181,105
060310001002,414.4,65.1,331.7,392,82,310
060190073004,228.6,82.8,132.9,198,61,137
060190072022,1213.3,422.2,725.2,934,365,569
060190072011,510.1,109.0,382.9,505,131,374
060190072021,476.3,202.7,250.5,696,287,409
060190072013,374.0,116.4,230.1,315,133,182
060190072014,297.6,84.9,187.9,352,96,256
060190072015,1015.1,298.3,663.2,994,310,684
060190072012,1064.3,194.5,827.7,957,221,736
060379102011,1106.8,484.6,561.4,891,386,505
060379800041,5.5,0.9,4.6,6,3,3
060379005071,900.1,585.4,260.4,832,527,305
060379005073,663.1,421.8,197.5,666,391,275
060379005042,1576.0,910.1,592.7,1239,673,566
060379006052,649.3,430.5,178.4,604,402,202
060379006092,496.7,344.3,121.8,530,339,191
060379005072,420.1,267.7,131.9,328,206,122
060379005081,1535.9,812.3,618.9,880,443,437
060379006053,742.0,441.7,255.6,735,406,329
060379006051,367.4,208.3,135.5,336,173,163
060290058011,895.3,320.2,509.4,744,294,450
060290055063,536.6,172.5,316.1,583,208,375
060290058023,614.7,261.1,296.9,556,239,317
060290058021,288.8,107.5,159.3,327,131,196
060290058024,553.7,240.6,260.7,561,230,331
060290059001,166.9,68.1,85.9,143,62,81
060290059003,423.3,173.0,217.5,487,188,299
060290059002,247.1,100.9,126.9,276,141,135
060290060033,553.7,120.3,392.3,511,172,339
060290060063,552.5,106.5,419.4,502,139,363
060290060031,617.7,142.9,432.5,709,194,515
060290060032,678.6,175.0,463.4,540,152,388
060290061004,569.6,181.2,345.7,385,170,215
060290061003,1062.2,312.4,674.8,990,303,687
060290061002,860.4,256.3,538.4,739,264,475
060290061001,642.4,157.3,448.8,713,246,467
060290060081,471.5,95.7,354.3,521,149,372
060290052045,330.5,93.7,218.5,403,160,243
060290052043,569.1,124.7,418.3,597,242,355
060290052042,339.1,84.0,232.8,271,101,170
060290052044,742.3,209.1,491.1,797,290,507
061070010031,3325.0,1075.5,2091.4,2646,901,1745
061070020032,437.0,155.7,245.3,434,148,286
061070020033,325.0,131.3,171.7,323,134,189
061070010064,498.8,171.2,301.8,482,175,307
061070010063,1049.6,376.9,616.5,1007,364,643
061070020024,413.2,155.2,232.1,440,181,259
061070020023,432.5,164.3,242.1,588,208,380
061070020021,282.8,107.4,158.3,378,158,220
061070020022,536.1,203.7,300.0,399,162,237
061070018004,408.5,163.1,216.4,392,174,218
061070018002,550.7,209.0,299.9,705,283,422
061070019012,530.0,179.7,318.5,621,223,398
061070010062,469.6,168.4,264.0,433,152,281
061070011004,177.9,125.9,36.8,158,106,52
061070010061,259.7,93.1,146.0,398,100,298
061070012001,437.5,187.5,217.8,325,176,149
061070010034,1448.0,673.0,691.0,825,404,421
061070011003,405.6,251.1,127.5,399,234,165
061070010033,1376.0,554.7,745.6,794,364,430
061070010035,363.5,246.3,94.6,374,243,131
061070010032,1144.3,487.0,585.6,725,302,423
061070019023,548.8,184.3,329.7,691,210,481
061070019011,495.1,165.9,299.5,453,174,279
061070019013,298.4,100.2,179.4,309,118,191
061070018001,221.5,95.1,109.4,285,128,157
061070017014,390.3,143.6,215.1,271,124,147
061070018003,229.3,97.5,114.1,443,194,249
061070017012,275.3,117.0,137.0,120,71,49
061070017011,234.3,99.6,116.6,157,83,74
061070020081,575.1,247.6,300.3,348,155,193
061070020093,298.7,123.6,155.2,346,155,191
061070011002,122.8,82.2,30.6,119,69,50
061070019021,269.3,96.1,151.2,155,65,90
061070019022,373.4,128.9,217.5,419,129,290
061070017041,2309.3,810.6,1372.4,2013,771,1242
061070017033,1362.1,483.8,795.6,1121,408,713
061070017013,505.8,183.3,284.0,329,174,155
061070017032,933.9,313.8,564.5,932,278,654
061070017031,699.6,252.7,401.7,832,301,531
061070013021,100.5,58.5,34.3,89,56,33
061070010044,140.8,99.6,29.1,120,91,29
061070011001,191.8,135.7,39.7,105,69,36
061070010043,381.8,261.8,95.2,345,234,111
061070010042,270.8,201.1,51.2,229,185,44
061070010041,300.2,222.9,56.8,344,253,91
061070013013,714.8,330.6,339.0,679,353,326
061070013011,932.5,270.0,616.9,976,304,672
061070006004,228.5,115.8,104.1,228,114,114
061070008002,282.3,68.7,198.8,417,114,303
061070008003,260.0,71.1,177.0,496,122,374
061070008005,305.9,140.4,150.2,185,109,76
061070008006,403.2,230.4,149.8,373,154,219
061070009001,517.3,111.4,381.9,254,50,204
061070003021,152.2,42.9,103.5,160,42,118
061070009003,218.6,83.5,120.1,231,111,120
061070009002,418.6,145.7,253.9,426,156,270
061070008001,163.8,49.5,108.0,148,67,81
061070008004,245.8,119.1,114.6,178,98,80
061070003011,333.2,101.7,219.6,579,133,446
061070003023,186.2,49.1,130.2,102,49,53
061070003013,433.4,107.0,307.5,502,93,409
060310012001,429.3,101.1,317.9,467,126,341
060310011001,272.3,147.5,110.6,309,192,117
060310010031,725.2,457.5,215.4,792,472,320
060310010023,273.9,161.0,92.0,229,150,79
060310010021,223.8,128.5,76.4,173,98,75
060310010032,550.0,284.6,240.3,516,275,241
060310010022,295.4,167.6,99.7,263,147,116
060310011003,276.3,206.0,55.6,213,145,68
060310009007,120.2,48.9,59.4,127,66,61
060310010011,392.8,132.2,238.4,429,155,274
060310009002,263.5,99.9,147.8,288,121,167
060310010012,1147.7,403.7,672.4,1095,433,662
060310009001,296.2,97.4,183.4,227,100,127
060310011004,183.8,131.3,39.7,190,133,57
060310009006,127.9,58.0,60.5,171,82,89
060310011002,318.3,219.1,77.9,306,235,71
060310009005,319.5,170.8,119.2,338,206,132
060310009003,243.1,95.2,133.1,258,126,132
060310008004,177.5,69.6,101.5,195,92,103
060310006011,2628.2,900.2,1565.1,2366,889,1477
060310006012,618.2,216.9,358.8,522,216,306
060310006022,898.6,316.9,536.5,811,296,515
061070003016,224.4,78.3,138.0,348,96,252
061070005012,260.2,177.3,69.8,180,128,52
061070005014,308.2,210.0,82.6,172,119,53
061070004013,480.4,327.8,129.0,389,261,128
061070004012,460.4,259.5,176.6,350,169,181
061070005021,552.1,340.6,183.0,438,247,191
060190085022,446.4,379.2,47.9,341,286,55
060190068024,135.5,109.9,18.9,67,53,14
060190068023,324.0,220.9,86.7,305,207,98
060190068021,167.7,133.4,25.6,146,114,32
060190068022,184.8,55.7,118.5,227,78,149
060190062024,405.0,298.3,85.5,318,234,84
060190060001,1775.6,917.3,776.3,1421,725,696
060190067001,704.0,226.3,435.0,773,242,531
060190067003,594.7,241.9,323.6,277,158,119
060190067004,449.0,165.7,264.4,562,163,399
060190067005,400.1,152.0,225.3,441,186,255
060190067002,203.3,119.6,68.4,228,130,98
060190066023,311.0,183.1,104.7,286,186,100
060190066022,245.8,184.3,48.5,234,155,79
060190066043,127.5,68.6,47.7,114,73,41
060190066032,282.4,137.9,117.3,342,168,174
060190063003,695.5,261.7,393.2,704,281,423
060190066031,293.9,120.1,156.7,259,121,138
060190066041,389.8,247.0,121.2,350,228,122
060190066044,285.4,149.5,120.3,392,194,198
060190066042,292.1,214.2,61.9,242,197,45
060190066024,186.9,141.0,36.0,108,86,22
060190066021,289.7,186.7,90.7,234,149,85
060190063005,436.8,218.3,203.2,537,231,306
060190066045,219.1,157.5,49.5,74,51,23
060190063004,173.9,62.9,105.8,168,64,104
061070003012,257.3,87.3,161.0,216,97,119
061070003014,168.4,57.1,105.4,203,77,126
061070003022,341.1,115.7,213.5,112,78,34
061070004011,208.8,96.8,102.9,215,79,136
061070002023,140.7,73.5,61.7,167,92,75
061070003015,133.8,45.4,83.7,117,48,69
061070007011,252.0,169.5,69.2,193,137,56
061070005013,258.9,169.5,75.2,132,90,42
061070005011,368.7,238.2,110.3,255,164,91
061070004023,337.5,204.0,116.0,403,208,195
061070004022,1086.2,566.9,465.2,1083,460,623
061070004021,268.5,132.6,123.3,314,162,152
061070007022,166.4,117.0,40.6,166,109,57
061070007021,296.1,202.0,76.1,280,174,106
061070007023,352.7,237.7,93.3,295,216,79
061070007024,152.8,107.7,35.8,128,99,29
061070001003,579.0,183.5,374.4,667,216,451
061070014002,301.8,65.3,221.7,332,85,247
061070014005,229.0,56.6,157.5,190,50,140
061070001004,762.6,263.7,461.9,702,257,445
061070014003,347.8,75.7,259.5,356,84,272
061070002021,107.8,58.7,44.9,82,42,40
061070002013,201.1,118.5,75.0,127,90,37
061070002011,222.1,149.8,60.7,215,147,68
061070002022,102.9,58.6,40.2,199,80,119
061070002014,235.3,185.6,34.1,209,151,58
061070006001,341.7,260.6,71.0,218,166,52
061070002012,330.3,231.0,88.7,234,153,81
061070001002,268.8,100.9,153.1,353,178,175
061070045004,228.8,90.4,130.3,351,80,271
061070045001,623.7,246.4,355.1,635,238,397
061070045002,227.7,89.9,129.6,148,107,41
061070032005,73.7,50.8,18.5,67,36,31
061070045003,176.1,69.6,100.2,123,78,45
061070038023,351.2,182.1,156.3,261,149,112
061070027002,485.1,109.5,356.2,559,132,427
061070027003,420.6,108.5,291.4,328,116,212
061070001001,226.9,94.7,119.8,229,122,107
061070001005,716.9,326.1,343.7,686,345,341
060190058051,2063.5,885.9,1066.1,958,455,503
060190059041,1896.5,715.6,1090.9,1188,411,777
060190014121,843.5,447.6,351.8,805,438,367
060190059111,2185.5,806.5,1276.7,1302,541,761
060190059053,785.8,202.3,554.3,789,221,568
060190059121,1312.2,357.4,898.2,1030,278,752
060190059112,12.2,4.3,7.3,7,0,7
060190058022,1333.7,470.3,791.2,1111,345,766
060190057033,833.9,274.2,512.5,888,313,575
060190058021,990.4,335.4,603.7,1065,358,707
060190059072,1256.7,432.6,764.3,1078,446,632
060190059091,1874.2,673.3,1119.4,576,252,324
060190057032,803.2,260.6,503.6,793,288,505
060190057023,631.0,212.0,382.0,652,225,427
060190059092,1193.4,447.8,682.5,847,382,465
060190059052,2273.4,631.1,1545.1,2088,615,1473
060190059122,896.2,252.2,601.7,780,258,522
060190060005,270.5,159.4,99.7,206,135,71
060190060003,270.1,191.6,64.6,241,175,66
060190060004,589.7,330.7,230.3,583,358,225
060190060002,238.3,152.3,73.5,186,114,72
060190057022,618.5,214.5,368.9,609,240,369
060190055181,2187.3,804.1,1247.0,861,312,549
060190055203,412.7,137.6,251.7,336,114,222
060190055201,900.6,300.9,553.8,778,291,487
060190055122,1164.9,374.3,731.7,1031,388,643
060190055252,494.5,126.0,352.6,516,154,362
060190055151,843.4,222.6,589.7,813,251,562
060190055251,215.7,55.0,153.6,230,60,170
060310008003,228.5,85.0,126.9,268,113,155
060190074001,207.8,54.7,147.0,243,72,171
060190077001,421.7,155.1,252.2,419,166,253
060190075002,228.0,83.3,135.6,217,90,127
060190075003,194.9,70.5,115.9,226,92,134
060190074003,318.6,149.6,151.3,278,122,156
060190076004,370.1,151.5,207.9,355,126,229
060190010002,364.7,318.3,34.9,311,274,37
060190010001,312.2,278.5,23.7,371,349,22
060190018001,327.4,194.7,121.3,313,165,148
060190011001,271.5,244.0,17.9,267,249,18
060190015001,155.1,77.1,74.0,167,105,62
060190012022,523.4,451.0,54.2,482,385,97
060390001042,741.0,229.2,467.7,621,228,393
060390001041,443.7,137.2,280.0,371,153,218
060430004002,172.0,86.0,73.0,212,125,87
061110025001,642.8,389.7,201.9,623,415,208
061110025002,886.8,493.0,319.5,858,539,319
061110025004,946.2,539.8,344.0,1091,648,443
061110012061,445.0,230.7,193.1,515,306,209
061110001001,390.3,187.6,177.3,388,208,180
061110024001,468.0,315.3,105.2,330,231,99
061110023004,384.6,285.2,66.5,269,219,50
061110023001,812.6,592.8,151.0,595,473,122
061110023002,201.3,148.7,34.4,312,252,60
061110024002,676.4,448.0,160.3,637,468,169
061110021021,757.4,508.2,186.2,1095,754,341
061110022002,348.2,238.7,80.2,224,176,48
061110022001,882.8,615.6,193.4,678,534,144
061110012041,897.6,494.3,317.5,877,558,319
061110023003,486.1,309.7,132.8,415,311,104
061110026003,315.8,206.5,81.4,310,239,71
061110026001,356.3,243.9,80.6,397,286,111
061110026002,771.9,498.5,206.6,817,602,215
061110020003,608.5,373.7,186.9,612,393,219
061110022003,994.5,633.7,271.7,1062,776,286
060830016041,500.1,354.3,115.5,438,317,121
060830016043,482.7,335.8,117.8,400,293,107
060830016042,322.8,226.4,76.9,408,291,117
060830017041,699.4,491.4,168.6,868,577,291
060830016044,763.1,517.0,200.6,958,617,341
060830016013,1029.6,647.6,315.0,1042,660,382
060830017061,861.7,555.5,259.1,828,509,319
060830017042,575.3,421.0,122.3,199,151,48
060830016011,494.2,315.3,146.6,518,314,204
060830017062,595.0,372.3,184.6,562,371,191
060830016012,1101.6,727.6,294.7,970,639,331
060830017065,481.6,310.4,145.0,449,330,119
060830017064,345.8,222.9,104.1,360,247,113
060830015001,767.7,465.1,261.3,985,570,415
060830017063,374.4,226.3,127.0,314,209,105
060830015002,560.8,336.0,195.1,522,258,264
061110010011,306.4,154.0,124.4,366,199,167
060790111024,823.1,599.1,145.4,743,573,170
060790111023,736.4,529.6,153.0,718,530,188
060790111011,549.0,391.3,96.4,545,418,127
060790111012,660.0,470.7,115.8,687,529,158
060790112005,528.9,371.0,110.0,628,471,157
060790112004,770.3,530.8,159.2,808,552,256
060790109023,550.8,399.0,99.0,518,394,124
060790111013,551.4,399.3,97.0,568,450,118
060790110021,1009.1,703.6,229.0,1097,737,360
060790110022,618.8,427.4,132.4,519,387,132
060790112002,720.8,467.5,191.1,1400,907,493
060790112003,371.6,255.7,76.4,423,303,120
060790112001,1152.4,774.5,268.9,946,644,302
060790109011,618.6,455.4,100.4,1207,769,438
060790109012,1018.2,560.9,370.2,507,372,135
060790114001,1056.4,778.4,164.7,0,0,0
060790115042,128.2,57.9,59.5,13,12,1
060790109022,508.9,355.7,95.3,534,372,162
060790109021,383.5,263.5,75.2,458,261,197
060790110011,1115.0,748.2,273.6,877,565,312
060790110012,768.6,518.7,193.7,924,558,366
060790110013,1052.5,743.3,235.1,1013,702,311
060790115041,290.4,112.0,161.3,314,138,176
060790127022,564.8,221.1,305.1,622,279,343
060790127023,915.9,434.5,404.8,849,474,375
060790126001,954.9,402.6,480.3,956,413,543
060790127042,1054.7,443.3,540.9,1065,449,616
060790127043,1865.3,773.6,964.5,1740,728,1012
060790129002,1252.0,532.4,643.0,1016,479,537
060790127044,612.8,237.3,332.2,624,251,373
060790126005,1131.1,466.1,590.9,1077,469,608
060790126002,678.4,315.7,314.2,681,327,354
060790125052,577.3,221.4,311.6,641,282,359
060790126003,623.5,288.4,290.2,635,316,319
060790126004,770.5,317.5,397.3,772,368,404
060790125053,856.6,391.3,387.9,847,437,410
060790125022,494.7,235.6,210.9,564,277,287
060790125021,618.3,295.9,261.3,648,311,337
060790125032,1209.0,609.8,481.8,873,486,387
060790127025,1129.6,442.1,602.6,977,368,609
060790128001,374.3,171.5,175.4,70,28,42
060790125033,365.4,164.8,173.9,542,258,284
060790102041,1301.7,505.2,709.2,1260,529,731
060790101025,437.2,204.7,193.5,440,234,206
060790101023,537.7,257.3,230.6,400,222,178
060790101024,487.0,219.9,226.1,434,218,216
060790102042,1056.9,470.8,515.1,957,393,564
060790102022,1390.4,608.1,698.3,1591,689,902
060790102053,846.2,361.8,427.4,733,347,386
060790102051,605.3,265.1,303.3,542,253,289
060790102012,2104.0,773.0,1195.0,1584,665,919
060790102052,431.2,180.6,220.6,373,171,202
060790102021,872.8,361.3,463.1,855,408,447
060830031021,344.1,151.8,167.1,364,153,211
060830026061,178.5,74.0,76.7,411,201,210
060830028094,877.3,318.7,500.3,987,375,612
060830026041,244.8,88.3,139.0,68,35,33
060830028082,348.7,134.5,193.0,352,125,227
060830028062,371.0,198.4,147.1,364,186,178
060830019011,680.8,327.0,307.4,713,308,405
060830019012,567.0,261.5,272.5,540,261,279
060830029322,969.2,603.5,299.0,1036,646,390
060830019052,412.5,227.7,152.9,453,213,240
060830019015,347.9,162.0,165.5,364,192,172
060830019013,1307.7,630.5,577.1,979,485,494
060830019031,620.5,285.2,300.4,747,298,449
060830019014,788.8,372.3,366.8,895,472,423
060830019034,1139.5,548.2,533.2,897,455,442
060830029281,1756.5,1372.8,224.6,1595,1406,189
060830029151,342.5,199.0,117.6,297,246,51
060830019063,359.9,147.4,190.6,618,224,394
060830019033,419.7,190.4,203.0,516,229,287
060830019035,540.5,245.6,261.2,405,202,203
060830019032,487.0,229.3,233.7,509,238,271
060839801001,6.0,5.0,1.0,7,6,1
060290060061,851.7,188.1,621.2,991,254,737
060290060062,392.5,88.2,282.2,514,129,385
060290051031,1148.5,227.7,860.5,1346,317,1029
060290051041,1524.4,413.5,1061.6,1157,338,819
060290010004,717.9,246.7,441.6,490,152,338
060290038031,3447.6,660.4,2643.8,2075,425,1650
060290052015,29.8,7.0,21.7,67,16,51
060376704162,937.6,516.3,375.2,951,469,482
060376706023,1375.9,757.6,560.2,1418,658,760
060376706022,734.6,387.7,305.4,966,497,469
060376706021,1255.6,614.4,565.4,1599,780,819
060376704161,982.2,499.7,411.2,968,470,498
060376703282,719.0,338.0,334.9,720,311,409
060376703283,1341.3,660.7,589.4,1403,624,779
060376703281,532.0,259.8,241.2,519,219,300
060376703263,416.1,203.9,188.2,417,177,240
060376703262,955.9,463.7,423.8,1020,447,573
060376704132,1242.8,703.8,487.0,1386,677,709
060376704131,1141.5,620.7,462.8,1118,547,571
060376704111,817.1,438.2,324.7,1238,587,651
060376703261,831.7,414.9,371.8,905,378,527
060376703243,770.4,367.2,355.1,985,430,555
060376703244,895.3,469.0,376.5,901,415,486
060376704061,824.0,443.0,349.0,1003,465,538
060376704072,711.5,425.2,246.6,556,304,252
060376704071,930.1,519.9,351.1,885,492,393
060376704073,747.3,457.2,250.0,826,442,384
060376704051,1673.6,887.4,703.5,1341,639,702
060376704112,1258.7,669.2,522.5,1159,539,620
060376704031,1321.1,705.1,543.5,1397,587,810
060376702021,1487.0,723.0,663.0,1633,725,908
060376702011,752.9,383.4,322.8,920,440,480
060376702012,1237.1,603.7,543.3,1351,596,755
060290009041,426.3,215.1,179.3,455,229,226
060290009031,918.7,385.8,467.5,999,432,567
060290009043,399.6,203.5,177.5,403,196,207
060290009082,533.9,215.3,286.5,614,252,362
060290009021,733.3,319.5,364.1,779,324,455
060290009083,653.6,280.4,330.9,684,277,407
060290009022,572.0,255.0,279.2,598,285,313
060290009032,456.8,189.6,236.7,546,218,328
060290009081,610.5,260.7,310.3,740,303,437
060290009102,627.1,246.7,341.8,695,242,453
060290009091,582.6,179.6,378.4,618,184,434
060290009092,687.9,226.2,433.0,835,204,631
060290009101,891.5,335.5,519.0,697,265,432
060290009103,2267.6,805.0,1345.0,1341,479,862
060290009104,881.4,379.7,455.3,755,337,418
060290051042,822.6,246.1,547.4,681,259,422
060290060082,1040.5,257.9,739.5,1047,306,741
060290060084,1063.3,242.7,763.3,975,247,728
060290060072,1567.7,296.3,1195.6,1382,360,1022
060290060083,1078.1,258.8,766.5,948,253,695
060290060071,502.3,93.7,380.9,447,115,332
060830014024,399.5,250.4,125.7,443,300,143
060830015003,589.9,359.3,198.5,560,313,247
060830014022,673.5,412.5,224.7,779,444,335
060830005011,799.3,574.3,180.8,943,692,251
060830005012,951.6,679.5,214.1,899,646,253
060830007002,992.9,670.4,251.5,966,659,307
060830028084,632.2,238.8,343.8,584,250,334
060830028081,143.3,58.9,70.1,438,164,274
060830028086,1207.3,533.7,581.0,917,416,501
060830028092,442.6,195.0,214.8,458,210,248
060830027073,392.1,195.9,168.5,355,172,183
060830031023,631.4,301.6,287.1,633,323,310
060830027071,250.6,128.9,102.3,244,155,89
060830031022,416.9,189.0,190.3,490,203,287
060830028022,582.7,291.7,252.8,732,349,383
060830027051,536.6,261.6,240.4,482,241,241
060830028061,569.6,258.7,274.9,519,232,287
060830028023,607.4,318.4,248.9,554,273,281
060830027072,250.2,131.5,100.5,292,141,151
060830027024,504.3,284.2,181.6,322,206,116
060830027023,288.3,178.5,85.5,255,170,85
060830027021,220.0,129.0,72.8,168,100,68
060830027022,246.6,154.2,71.5,225,134,91
060830027025,236.1,137.8,80.9,181,104,77
060830027053,351.5,197.7,130.1,309,178,131
060830027052,480.1,292.9,153.3,438,262,176
060830027081,237.1,116.0,101.4,216,121,95
060830027082,456.9,216.8,201.6,449,214,235
060830027032,650.3,343.4,253.3,592,330,262
060830028024,885.0,411.0,412.0,874,430,444
060830027064,220.6,128.6,76.3,231,134,97
060830028021,698.1,355.8,294.8,692,353,339
060830028085,530.6,199.6,287.2,536,182,354
060830028083,756.7,291.3,420.9,625,205,420
060830025023,305.3,212.5,76.2,232,144,88
060830020113,473.2,271.5,168.5,418,237,181
060830020061,677.1,186.2,449.4,626,195,431
060830020132,945.6,280.1,623.2,945,292,653
060830027083,424.0,179.7,206.4,426,180,246
060830027065,177.5,107.3,56.8,51,26,25
060830027031,549.0,294.3,211.2,633,364,269
060830027063,306.6,185.4,98.0,219,134,85
060830027062,490.9,274.9,186.0,326,178,148
060830027061,423.2,227.3,168.1,457,262,195
060830028093,427.4,188.3,207.5,393,181,212
060830028091,468.5,165.8,275.2,493,179,314
060830020123,455.6,166.1,258.7,346,139,207
060830020131,675.0,212.6,427.3,691,236,455
060830020122,512.6,176.0,305.4,572,229,343
060830020051,387.4,106.8,255.6,366,148,218
060830020054,811.5,241.5,518.7,721,212,509
060830020052,779.0,243.6,486.7,692,218,474
060290033041,427.5,76.6,329.7,366,69,297
060290033043,519.7,97.1,406.8,72,33,39
060290037002,576.9,172.5,376.0,557,191,366
060290037001,227.8,131.6,86.5,225,110,115
060290042001,316.5,78.4,220.3,340,81,259
060290043011,258.7,125.2,114.8,241,85,156
060290043012,293.8,170.9,99.1,249,140,109
060290039001,240.8,59.8,174.1,206,43,163
060290040001,362.0,196.8,147.2,396,149,247
060290040002,299.3,153.8,131.1,122,83,39
060290040004,595.8,310.9,255.8,394,249,145
060290040003,299.1,186.4,95.2,275,182,93
060290041012,214.4,108.8,95.0,183,76,107
060290041011,619.9,303.3,281.9,961,299,662
060290041022,552.5,300.1,222.3,405,273,132
060290044011,608.2,360.8,208.2,718,386,332
060290043013,862.9,543.8,263.7,738,428,310
060290044013,540.9,262.3,243.7,673,285,388
060290044021,405.2,257.2,119.0,211,135,76
060290044012,329.5,205.1,99.9,368,214,154
060290044022,388.9,302.4,63.8,355,255,100
060290032063,2467.0,1301.1,1022.6,647,306,341
060190082006,171.3,96.9,70.0,106,76,30
060190082003,95.9,52.6,41.0,114,51,63
060190039003,366.2,161.4,190.8,220,129,91
060190082005,103.5,87.7,12.8,38,31,7
060190082004,479.8,410.9,54.8,290,233,57
060190076002,193.1,87.7,97.9,166,81,85
060190040012,850.6,424.2,385.7,707,339,368
060190076001,226.8,93.9,123.6,189,60,129
060310016011,156.6,98.6,53.2,177,120,57
060310017015,20.3,7.1,13.0,19,9,10
060310004022,686.6,245.5,402.1,716,268,448
060310004052,510.7,185.6,286.4,434,184,250
060310016012,323.9,127.6,169.3,312,130,182
060310013002,400.5,209.2,173.4,409,223,186
060310015001,497.8,253.7,209.3,486,245,241
060310014011,538.2,358.9,155.2,511,325,186
060310015002,200.3,141.5,50.1,200,147,53
060310013001,270.8,190.4,65.2,246,178,68
060310014021,164.4,94.6,61.1,182,93,89
060310015003,167.5,94.4,64.0,279,137,142
060310015004,212.0,119.2,81.2,215,98,117
060310014022,232.4,145.0,74.9,227,139,88
060310003001,116.4,47.9,51.8,276,135,141
060310003002,193.7,78.0,84.0,195,80,115
060310002002,326.7,69.7,247.2,319,86,233
060990029011,431.1,104.4,303.7,448,120,328
060990036041,462.2,137.3,303.3,414,158,256
060990036042,331.1,98.3,217.3,330,129,201
060990029013,327.8,86.7,224.0,405,119,286
060990029014,265.7,97.9,153.9,385,115,270
060990029012,309.3,87.7,205.0,370,108,262
060190079021,276.6,109.9,155.1,340,161,179
060190080001,229.8,91.3,128.0,76,36,40
060190080003,199.1,66.5,120.4,256,92,164
060190079022,190.7,103.3,79.9,396,213,183
060190083023,86.8,52.0,31.5,64,46,18
060190080004,390.1,130.4,235.9,315,103,212
060190081004,273.7,150.8,109.9,262,141,121
060190080005,312.4,104.4,188.9,417,152,265
060190080002,364.4,136.0,208.2,366,194,172
060190081002,393.0,201.9,171.2,299,167,132
060190081003,169.4,90.3,70.1,130,80,50
060190081001,280.6,125.1,141.4,324,137,187
060310017011,393.1,269.6,102.5,399,250,149
060190079011,258.0,160.0,82.0,28,6,22
060310017012,158.9,114.8,35.3,156,110,46
060310017013,211.0,147.6,52.0,188,135,53
060310017014,231.2,179.9,37.8,257,179,78
060190082001,76.9,46.0,28.1,102,57,45
060190082002,142.2,84.3,53.0,175,88,87
060190078011,269.3,221.6,37.6,256,219,37
060190078022,68.5,59.0,6.6,39,33,6
060190078021,71.6,46.5,25.0,61,38,23
060190078024,163.4,144.0,12.3,126,113,13
060190078023,160.0,141.0,12.1,116,100,16
060790123022,540.3,229.7,275.1,513,226,287
060790123041,1559.7,720.1,768.3,972,406,566
060790119011,943.0,392.6,474.7,917,369,548
060790124012,822.4,370.4,387.0,657,336,321
060790124011,435.0,189.2,211.9,413,209,204
060790122003,854.4,446.1,354.9,820,482,338
060790124013,1258.0,577.0,584.1,1185,592,593
060790119012,862.0,412.6,373.7,944,492,452
060790122002,203.6,113.5,72.8,245,133,112
060790123042,1452.2,566.1,798.3,1544,669,875
060830020062,493.9,168.5,307.1,553,164,389
060830019062,18.4,7.8,9.7,647,262,385
060790118005,1296.2,597.9,587.0,1668,783,885
060790118001,908.6,429.3,413.5,852,424,428
060790118002,1155.9,573.4,507.9,1189,503,686
060790123021,1762.5,796.9,855.4,1612,735,877
060790115031,932.8,559.2,285.5,964,570,394
060790103003,326.3,110.6,192.4,193,76,117
060290001015,2308.7,466.3,1697.5,1810,479,1331
060290001013,460.4,111.3,316.9,413,123,290
060290001012,234.0,58.5,159.8,257,75,182
060290001014,674.6,119.0,527.1,620,164,456
060290001011,305.4,72.5,214.6,371,102,269
060290001022,552.5,108.5,414.4,550,153,397
060290001021,583.9,110.4,445.5,578,130,448
060290033051,590.0,174.4,369.5,641,257,384
060290033053,585.2,185.6,347.1,513,198,315
060290033052,237.5,74.8,141.5,338,114,224
060290033061,748.9,236.7,475.7,683,247,436
060290062021,854.1,624.9,185.5,602,396,206
060379201041,1387.5,503.8,812.4,1352,567,785
060290060021,2.0,2.0,0.0,5,2,3
060290060034,487.1,129.4,317.8,410,141,269
060290032041,4318.1,1513.1,2596.2,3333,1081,2252
060290031142,491.0,205.2,254.6,580,201,379
060290041021,313.9,202.7,101.8,281,194,87
060290041013,334.5,162.8,153.6,275,133,142
060290038042,2357.1,623.2,1601.3,1825,545,1280
060290038043,2600.2,647.2,1837.2,2129,616,1513
060290005033,1106.3,184.9,889.8,996,158,838
060290005031,1666.1,451.5,1148.1,975,281,694
060290039002,0.9,0.1,0.8,1,0,1
060290047013,269.6,191.1,60.2,66,39,27
060290047021,230.7,183.4,34.5,262,213,49
060290047012,447.9,327.3,93.0,500,328,172
060290050032,310.9,220.7,75.1,159,109,50
060290047011,630.9,462.3,130.5,520,355,165
060290047022,226.6,187.7,26.3,236,189,47
060290038041,1413.0,340.0,1010.0,1196,336,860
060290038071,1064.0,203.4,800.6,1051,231,820
060290038111,719.4,164.8,511.9,658,126,532
060290038051,1232.3,332.4,817.6,1260,328,932
060290038052,1210.3,293.7,844.2,1081,311,770
060290038054,726.1,207.8,481.0,550,171,379
060290038053,762.6,209.8,519.6,736,224,512
060290038061,2224.2,628.4,1482.4,2052,641,1411
060790107032,1041.3,682.6,278.8,919,595,324
060790107075,799.3,529.5,214.1,904,574,330
060790107011,719.4,494.6,174.3,854,591,263
060790107013,637.8,415.6,170.0,719,504,215
060790107012,1104.2,729.7,280.0,1119,761,358
060790107031,924.9,589.3,256.2,821,547,274
060790106021,709.7,423.4,244.2,773,489,284
060790106022,923.8,554.1,322.3,844,495,349
060790107071,429.4,284.2,117.9,475,309,166
060790106023,705.8,409.9,246.9,756,490,266
060790106032,299.3,165.7,108.8,296,141,155
060790106031,393.3,227.9,136.7,339,230,109
060790113003,636.1,421.2,159.3,716,445,271
060790105033,540.8,303.3,202.2,647,367,280
060790113002,1180.0,777.5,272.3,1257,836,421
060790107074,616.9,407.6,169.9,734,459,275
060790117012,944.1,465.1,414.8,956,480,476
060790116002,976.4,557.5,352.4,997,564,433
060790117043,705.9,388.7,274.6,702,416,286
060790117041,667.6,335.9,290.7,590,362,228
060790117044,411.7,226.7,160.2,443,230,213
060790117042,348.9,172.9,151.3,385,225,160
060790121021,702.2,338.5,307.8,495,281,214
060790113001,1367.6,883.4,364.2,1470,928,542
060790113004,457.9,302.9,98.5,410,285,125
060790115011,881.0,550.3,254.8,921,556,365
060790111032,899.3,589.1,232.5,807,529,278
060790111031,569.5,356.2,166.6,436,305,131
060790115032,1186.4,780.7,303.9,1201,786,415
060790121022,979.0,475.3,423.8,946,506,440
060790121024,308.7,163.7,112.9,312,168,144
060790117013,646.6,297.9,313.6,663,333,330
060790117011,279.0,128.6,135.3,240,93,147
060790117014,885.6,391.5,447.4,899,376,523
060790118003,612.1,296.1,278.4,544,241,303
060790116001,1024.2,479.5,482.1,1070,507,563
060790111022,675.0,486.0,116.1,519,393,126
060790111021,653.8,484.5,97.2,599,463,136
060830020053,834.1,282.5,500.1,793,289,504
060830025022,912.8,645.5,216.1,750,540,210
060830025024,244.5,185.2,46.3,210,136,74
060830025021,248.7,188.4,47.1,317,251,66
060830024022,1774.2,1012.0,659.6,1392,780,612
060830020112,353.3,194.1,137.9,375,147,228
060830020111,1089.7,374.8,656.5,1079,377,702
060830024031,541.6,324.8,187.0,209,152,57
060830023064,1389.1,850.0,472.8,861,544,317
060790123043,595.1,250.2,307.2,396,184,212
060790124022,1870.8,792.0,969.1,1470,619,851
060790124021,1593.6,629.2,874.1,1471,576,895
060790123044,762.9,300.9,422.0,712,296,416
060790123045,1188.5,470.2,655.6,1179,464,715
060790118004,595.5,277.1,271.7,457,245,212
060790124023,1214.5,565.5,573.8,1081,526,555
060830020121,615.8,187.3,398.7,675,202,473
060830020077,849.2,326.9,481.4,941,346,595
060830020075,268.9,123.5,129.4,334,134,200
060830020071,455.6,167.8,267.6,466,155,311
060830020092,579.5,177.7,362.1,618,231,387
060830020093,694.2,204.5,436.2,536,210,326
060830020091,665.6,220.2,406.5,821,286,535
060830020084,686.8,228.3,413.6,685,246,439
060830020085,467.2,157.0,274.4,533,198,335
060830020082,428.8,136.6,263.2,399,154,245
060830020083,536.5,183.7,322.8,501,181,320
060830020081,862.2,300.4,503.7,882,341,541
060830020073,536.3,200.9,303.7,567,206,361
060790122001,700.8,391.5,251.9,641,381,260
060790122004,781.2,437.8,285.0,556,369,187
060790120004,1091.0,562.0,433.2,928,484,444
060790121023,492.3,259.6,181.3,543,316,227
060790120003,740.1,385.8,285.7,695,396,299
060790119024,708.1,329.8,313.6,679,341,338
060790120002,348.5,173.4,148.3,379,219,160
060790120001,906.0,469.6,373.9,767,393,374
060790119023,737.5,327.6,340.5,639,299,340
060790119025,727.5,376.4,301.5,724,384,340
060790119021,867.9,429.9,372.0,757,401,356
060790119022,946.1,456.2,415.5,917,495,422
060790107072,1033.9,706.9,258.7,991,708,283
060790105031,959.8,539.6,364.3,817,475,342
060790105032,1128.2,619.1,433.3,1282,757,525
060790105034,381.7,217.0,137.5,371,250,121
060790104031,868.9,542.3,280.8,952,576,376
060790104032,702.2,427.1,238.5,765,455,310
060790104042,441.5,292.2,117.4,395,259,136
060790105042,658.9,356.2,264.8,662,377,285
060790105043,574.3,309.6,230.3,599,342,257
060790105041,426.5,228.2,170.1,449,269,180
060790107073,761.7,524.6,185.4,735,516,219
060830029143,904.8,560.8,288.6,959,571,388
060830029142,565.9,371.1,162.9,588,367,221
060830029132,1155.4,753.3,327.8,1125,715,410
060830029131,997.3,640.4,290.5,1062,660,402
060830029071,436.4,257.0,148.9,1106,608,498
060830001032,428.2,276.6,118.1,1151,769,382
060830029072,178.4,108.2,55.1,875,503,372
060830001031,528.4,336.5,158.8,608,344,264
060830001024,838.6,587.7,201.6,815,620,195
060830030042,950.9,617.4,270.2,1000,659,341
060830030053,1239.9,810.1,344.1,834,601,233
060830030071,872.0,518.2,305.0,824,429,395
060830030073,937.1,544.2,346.6,918,489,429
060830030072,828.1,520.0,258.8,638,396,242
060830013062,490.1,290.2,167.2,540,358,182
060830001013,716.1,462.0,213.0,662,400,262
060830001021,959.6,649.6,247.0,1033,736,297
060830001012,758.6,513.9,191.1,633,390,243
060839800001,7.7,5.1,2.1,10,8,2
060830001033,618.3,394.9,185.9,533,281,252
060830030052,1123.0,717.1,337.7,848,522,326
060830001011,1599.2,1028.0,472.4,1259,834,425
060830030043,1108.3,707.7,333.3,768,507,261
060830030051,748.0,492.8,208.4,504,380,124
060830002003,1130.8,823.7,233.1,1125,827,298
060830030011,177.4,139.7,28.2,209,154,55
060830030012,557.0,394.8,133.8,529,365,164
060830001023,718.6,515.4,154.5,543,408,135
060830001022,368.8,252.3,91.1,266,197,69
060830013061,854.7,583.9,224.5,949,629,320
060830013063,721.1,511.2,175.6,656,453,203
060830001014,395.8,289.9,83.7,226,159,67
060830005026,935.1,677.8,200.5,945,631,314
060830005025,569.0,375.0,157.0,507,326,181
060830005024,626.2,428.5,153.2,626,417,209
060830013048,339.7,255.4,60.6,396,323,73
060830013046,391.1,294.0,69.7,469,357,112
060830012084,417.7,307.3,79.2,397,307,90
060830012082,491.2,343.6,109.0,515,353,162
060830012083,484.7,344.2,100.6,402,267,135
060830012032,932.0,645.8,230.0,1160,822,338
060830013044,431.5,308.6,98.3,448,331,117
060830012085,373.5,255.6,90.5,518,374,144
060830012081,526.1,359.9,127.5,439,343,96
060830013047,470.1,353.5,90.3,440,341,99
060830013049,657.7,505.2,117.7,568,450,118
060830013043,663.5,474.8,151.7,710,538,172
060830013042,434.9,312.8,97.5,568,407,161
060830013045,390.5,275.6,93.1,300,210,90
060830011014,675.8,533.1,113.0,444,390,54
060830011021,563.7,453.4,77.8,527,456,71
060830011012,515.9,424.2,64.1,308,267,41
060830011013,397.4,326.8,49.4,392,343,49
060830011011,327.1,264.0,44.6,497,398,99
060830010002,548.0,438.2,75.0,359,312,47
060830003012,530.8,430.3,68.0,489,423,66
060830013041,203.6,159.7,31.4,290,233,57
060830003025,325.6,260.6,41.5,266,226,40
060830003024,243.7,195.0,31.1,237,203,34
060830002002,834.0,535.0,258.0,888,546,342
060830002001,455.5,343.3,84.6,501,385,116
060830003023,441.7,353.4,56.4,562,456,106
060830003022,301.1,233.9,49.7,327,258,69
060830003021,370.9,288.1,61.3,352,278,74
060830029302,691.9,484.9,162.1,591,439,152
060830029093,1003.9,655.2,283.7,964,613,351
060830029301,734.2,529.6,147.5,660,489,171
060830029306,428.7,331.0,53.0,544,427,117
060830029304,239.2,184.7,29.5,296,252,44
060830029092,842.5,527.1,258.5,908,577,331
060830029091,1010.7,670.9,267.6,976,673,303
060830029224,691.7,488.5,151.2,549,392,157
060830029222,524.0,432.0,60.0,758,619,139
060830029303,704.2,475.9,187.8,667,484,183
060830029305,691.3,480.0,165.3,624,427,197
060830029061,548.2,330.8,187.5,492,286,206
060830029262,1248.5,1031.5,118.8,1131,991,140
060830029261,799.5,647.7,72.9,761,682,79
060830029241,1006.8,841.1,93.4,836,721,115
060830029242,1074.9,892.8,98.1,919,791,128
060830029282,482.0,386.0,46.0,393,340,53
060830029263,471.1,367.1,50.6,738,648,90
060830029244,642.8,520.8,68.4,836,677,159
060830029225,600.8,503.3,35.3,664,560,104
060830029223,0.0,0.0,0.0,0,0,0
060830029221,1414.2,1181.7,107.7,2588,2114,474
060830029243,544.4,447.0,53.8,555,458,97
060830029063,1003.1,607.7,339.4,1077,619,458
060830029141,400.5,262.7,114.8,440,271,169
060830029062,860.4,549.6,261.0,867,536,331
060830030014,445.7,351.1,70.9,391,308,83
060830030015,181.8,143.2,28.9,139,111,28
060830030013,428.0,303.5,102.8,312,233,79
060830030041,669.9,460.8,165.2,777,517,260
060830012031,549.5,408.2,104.3,325,251,74
060830012062,365.0,297.6,37.7,321,282,39
060830011023,224.1,182.8,23.2,225,204,21
060830010005,642.4,497.7,90.2,585,494,91
060830010003,508.1,406.1,65.5,435,372,63
060830011022,444.8,362.7,46.0,302,263,39
060830010004,603.6,470.0,84.4,594,504,90
060830009002,715.6,566.4,101.3,705,587,118
060830009001,777.4,601.0,122.2,716,593,123
060830003011,322.0,261.1,41.3,359,287,72
060830003013,406.4,326.4,54.5,440,380,60
060830010001,475.6,380.3,65.1,446,385,61
060830004001,711.0,526.2,153.4,742,545,197
060830004004,541.4,425.4,80.8,674,530,144
060830004005,616.3,483.5,96.5,686,589,97
060830004003,397.9,313.5,54.3,368,308,60
060830004002,429.7,327.0,77.1,467,364,103
060830005022,456.5,346.5,83.7,476,363,113
060830005023,455.8,344.9,83.2,422,316,106
060830005021,538.6,414.1,98.5,611,465,146
060830005013,605.0,466.3,112.2,556,436,120
060830006002,571.4,415.9,127.1,572,440,132
060830006001,364.9,272.0,74.7,423,279,144
060830014021,553.2,351.1,169.0,604,412,192
060830012063,407.2,333.3,48.0,406,344,62
060830012061,493.7,365.1,98.0,444,338,106
060830007004,929.3,588.0,285.5,949,627,322
060830014023,378.8,238.2,118.6,450,298,152
060839900000,0.0,0.0,0.0,0,0,0
060830008011,345.3,263.0,58.0,247,210,37
060830008044,413.4,338.9,51.2,395,344,51
060830008041,452.4,301.9,112.6,562,419,143
060830006004,403.6,322.3,54.4,417,328,89
060830006006,363.6,270.2,73.7,291,246,45
060830006005,675.9,510.5,131.4,693,558,135
060830006003,490.1,344.8,118.3,597,422,175
060830008013,483.3,403.4,54.9,436,388,48
060830008012,678.3,564.8,78.1,494,424,70
060830008043,498.5,418.9,54.1,449,396,53
060830007001,486.1,340.3,115.4,815,557,258
060830008045,538.4,449.7,60.7,304,260,44
060830008042,530.0,442.7,59.7,214,181,33
060830007003,413.3,275.3,110.2,644,395,249
060830020072,460.6,176.0,255.8,359,133,226
060830020076,475.6,215.1,234.2,523,235,288
060830020074,1114.7,505.0,547.7,965,442,523
060830021032,514.9,286.7,201.9,416,218,198
060830024024,299.2,193.5,92.0,170,106,64
060830021033,370.7,206.6,144.7,506,224,282
060830021022,236.7,126.2,97.6,255,130,125
060830020101,1008.7,334.2,615.0,1123,392,731
060830020104,367.8,119.0,227.0,384,127,257
060830020103,442.1,143.1,272.8,436,154,282
060830020102,463.5,151.0,286.9,514,173,341
060830021011,450.8,254.5,169.8,555,284,271
060830024032,259.7,165.3,77.5,224,149,75
060830024033,198.0,150.0,35.7,77,53,24
060830024042,161.4,122.2,29.1,112,78,34
060830024044,146.6,111.0,26.4,147,94,53
060830024043,104.0,78.8,18.8,126,89,37
060830024021,233.9,154.8,68.7,339,175,164
060830024023,220.7,146.1,64.8,10,6,4
060830023033,217.9,162.7,43.1,268,208,60
060830023043,247.8,185.1,49.1,262,168,94
060830023044,301.4,224.4,60.8,132,81,51
060830023034,140.4,104.8,27.8,159,111,48
060830023035,84.4,63.0,16.7,94,71,23
060830024041,315.2,200.6,94.0,77,51,26
060830021021,231.6,139.4,78.2,445,238,207
060830021031,297.6,165.9,115.7,214,106,108
060830023041,141.3,86.5,45.5,82,44,38
060830022053,359.0,216.9,118.6,162,97,65
060830022063,218.1,129.6,74.9,230,131,99
060830022061,403.4,208.3,169.1,649,318,331
060830023031,237.2,150.0,72.2,194,114,80
060830022052,350.5,179.7,148.2,458,235,223
060830022062,350.2,202.6,127.0,326,184,142
060830022051,381.1,177.7,179.0,347,157,190
060830023032,253.6,187.6,52.9,203,148,55
060830023042,197.8,146.3,41.3,123,91,32
060830023054,335.3,258.5,59.5,382,255,127
060830023051,281.4,215.3,51.6,214,146,68
060830023052,295.8,224.2,56.3,252,176,76
060830023053,300.7,228.1,57.1,295,197,98
060830023063,398.2,239.9,140.3,664,302,362
060830022092,312.3,185.0,106.9,270,141,129
060830022091,450.0,266.6,154.1,421,219,202
060830023061,287.1,175.3,94.9,204,115,89
060830023062,462.9,282.7,153.1,457,275,182
060830021012,449.0,221.3,202.7,464,197,267
060830022103,412.5,210.6,172.5,345,171,174
060830022113,768.7,350.7,373.8,846,373,473
060830022102,584.3,275.5,271.9,501,242,259
060830022114,373.7,160.1,194.5,358,119,239
060830022101,968.1,512.3,402.1,909,449,460
060830022111,491.8,219.1,244.4,488,222,266
060830022112,780.5,333.0,406.3,675,256,419
060190019002,286.0,170.1,99.6,211,117,94
060190008001,136.7,108.9,18.7,72,49,23
060190019003,224.4,150.1,65.1,204,125,79
060190019001,340.4,181.7,143.0,331,190,141
060190007002,400.6,326.1,59.4,336,286,50
060190038073,164.4,97.1,56.6,163,81,82
060190038071,289.9,183.6,89.0,319,194,125
060190038072,243.3,135.4,90.8,246,134,112
060190020004,169.1,101.1,59.3,134,93,41
060190020005,118.5,77.9,34.5,115,86,29
060190020001,254.5,171.5,68.9,130,98,32
060190020002,291.7,197.1,79.3,409,266,143
060190020003,85.2,62.9,16.7,78,65,13
060190007001,223.9,194.1,21.8,211,182,29
060190007003,397.1,350.0,32.6,413,376,37
060190009011,498.6,426.1,51.3,459,423,36
060190011002,265.2,227.3,26.8,233,210,23
060190009023,229.1,198.2,18.8,205,182,23
060190009021,270.6,243.4,17.2,233,218,15
060190009022,225.6,199.4,17.5,177,162,15
060190003003,209.0,188.2,10.7,236,212,24
060190003001,338.5,302.0,24.0,370,357,13
060190002002,127.3,113.4,9.1,98,90,8
060190021003,332.9,227.1,80.6,292,211,81
060190021002,322.6,220.1,77.7,360,273,87
060190021004,326.6,217.0,84.6,280,199,81
060190021005,333.7,222.8,85.6,349,254,95
060190021001,301.4,201.0,77.5,338,235,103
060190002001,107.3,94.4,9.2,65,58,7
060190002003,176.5,155.6,15.0,147,126,21
060190006004,178.1,138.6,28.8,170,123,47
060190001001,362.4,273.8,64.2,129,99,30
060190006001,139.9,98.3,28.8,200,161,39
060190005021,127.9,97.7,23.0,218,157,61
060190003002,170.8,151.2,10.1,138,112,26
060190006002,192.1,132.1,41.2,181,140,41
060190006003,322.3,238.9,59.2,175,130,45
060190022002,336.1,230.5,76.1,318,240,78
060190022003,331.1,226.9,74.3,278,205,73
060190023003,360.6,258.8,75.7,321,248,73
060190022001,276.0,190.0,62.0,284,211,73
060190022004,345.0,236.2,77.1,412,302,110
060190038082,859.6,580.0,242.5,713,469,244
060190038053,447.3,294.0,121.9,365,232,133
060190038041,408.7,247.8,144.7,516,319,197
060190038052,329.6,225.5,88.5,148,111,37
060190038051,612.1,407.6,178.0,589,390,199
060190038091,583.8,370.3,182.7,661,397,264
060190042052,294.6,188.7,87.9,301,190,111
060190042053,583.6,371.7,181.5,717,443,274
060190042054,277.7,154.0,99.2,174,117,57
060390006031,320.7,246.5,56.5,302,216,86
060390006032,235.4,179.7,42.4,257,175,82
060390005073,523.0,372.0,114.9,476,342,134
060390005071,307.4,175.7,114.0,382,228,154
060390006042,217.2,149.6,54.7,196,136,60
060390005072,910.8,330.9,533.5,778,311,467
060390005091,1581.6,390.6,1111.5,1479,465,1014
060390010002,1030.9,281.3,710.4,1042,362,680
060190004003,289.0,233.7,40.2,160,120,40
060190004004,175.4,139.2,27.3,125,94,31
060190012011,205.1,167.4,27.7,122,97,25
060190005012,190.3,145.8,34.4,138,108,30
060190023002,295.1,207.9,66.1,406,296,110
060190023001,220.2,155.7,48.6,226,171,55
060190024003,166.2,129.9,26.0,131,95,36
060190005023,112.1,88.4,17.0,82,66,16
060190024002,78.2,61.9,12.1,108,91,17
060190005022,141.1,113.0,20.1,139,112,27
060190024004,286.4,197.7,67.2,175,128,47
060190005011,102.5,84.9,12.5,94,80,14
060190004001,291.2,234.1,42.8,253,214,39
060190026023,250.6,192.5,43.8,270,193,77
060190025023,268.5,211.1,43.8,208,160,48
060190025021,82.7,68.5,12.2,103,80,23
060190025022,62.3,51.6,9.2,87,62,25
060190024001,163.0,127.5,26.8,165,124,41
060190033021,227.0,167.6,46.7,196,131,65
060190025011,144.6,113.1,23.8,136,98,38
060190033023,252.1,181.0,56.8,226,162,64
060190025012,148.1,113.5,26.9,161,121,40
060190012014,287.0,226.5,46.6,73,60,13
060190012012,178.2,144.9,25.0,297,241,56
060190012013,306.0,248.8,42.9,219,175,44
060190004002,234.2,198.3,26.2,191,153,38
060190013032,187.1,156.8,21.7,124,97,27
060190013031,127.2,105.8,15.1,145,111,34
060190013043,163.3,135.0,20.3,74,56,18
060190013011,247.5,192.9,39.7,182,141,41
060190013012,190.0,148.1,30.5,196,154,42
060190013013,200.7,174.1,18.6,139,116,23
060190013015,192.5,150.1,30.9,129,102,27
060190012021,340.6,292.1,31.6,221,187,34
060190013042,458.7,390.3,51.3,530,456,74
060190013041,151.7,123.6,23.3,91,63,28
060190013014,216.1,187.5,20.1,208,169,39
060190026022,365.9,273.1,69.2,280,202,78
060190026021,219.1,163.5,41.5,292,225,67
060190055032,1622.2,586.0,968.8,910,342,568
060190055172,885.6,352.5,490.4,849,330,519
060190055031,1049.8,397.8,602.5,1232,456,776
060190055171,2016.4,620.5,1318.2,1850,583,1267
060190055173,772.3,299.7,444.1,734,304,430
060190055051,2742.0,1105.0,1505.0,2712,1148,1564
060190055041,1313.5,477.7,770.7,956,354,602
060190056051,645.2,271.1,340.0,787,318,469
060190055092,887.4,393.4,444.4,791,340,451
060190056061,808.4,302.9,469.4,723,268,455
060190055143,512.0,195.3,292.3,496,212,284
060190055082,1352.0,567.0,730.0,1251,534,717
060190055141,650.0,186.0,431.0,722,233,489
060190055241,2133.0,722.0,1348.0,1464,524,940
060190055142,757.0,255.0,460.0,695,270,425
060190055131,788.7,266.8,491.9,760,256,504
060190055223,1464.6,434.2,960.1,1648,558,1090
060190055221,216.8,56.0,149.7,226,76,150
060190055132,680.3,224.2,425.1,599,225,374
060190055121,1108.9,357.5,697.2,1047,394,653
060190055202,33.1,9.3,22.1,28,5,23
060190055224,100.5,25.9,69.5,99,27,72
060190057021,409.3,141.6,242.1,377,116,261
060190057012,300.2,103.8,177.6,246,107,139
060190057013,347.2,123.4,202.5,219,121,98
060190059071,10.5,3.3,6.7,6,4,2
060190055222,365.7,122.3,225.7,331,124,207
060190014131,1930.0,1076.4,763.3,1336,673,663
060470003041,449.5,363.8,59.7,497,412,85
060470003043,142.8,108.6,25.4,196,148,48
060470003042,232.8,181.9,36.7,138,116,22
060470009013,266.7,102.3,154.6,271,133,138
060470007023,748.4,281.7,426.6,486,175,311
060470007022,891.4,280.8,573.2,817,303,514
060470007021,680.2,178.5,461.2,677,234,443
060470006013,266.2,151.7,102.4,150,97,53
060470007011,408.9,236.0,151.7,347,201,146
060470007012,308.3,180.0,110.4,197,130,67
060470008021,827.9,407.9,382.9,548,312,236
060470008022,648.2,321.8,293.4,487,252,235
060470008012,518.3,249.7,247.3,504,289,215
060470008011,992.7,517.8,424.5,569,325,244
060190054051,656.0,339.0,264.0,739,374,365
060190054052,581.5,264.3,288.3,622,292,330
060190054062,483.5,219.7,239.7,521,250,271
060190033011,515.4,338.3,142.7,480,332,148
060190033022,261.7,168.3,77.5,240,161,79
060190033024,259.4,166.3,77.2,269,174,95
060190032021,261.9,167.1,80.4,254,161,93
060190032022,322.6,218.5,86.7,285,196,89
060190032011,496.3,311.4,158.0,402,253,149
060190033012,381.9,251.8,110.7,367,239,128
060190052032,520.0,345.0,139.0,538,373,165
060190052022,359.0,221.4,108.9,352,227,125
060190052021,308.1,190.0,93.4,319,201,118
060190052041,397.6,223.7,145.8,417,258,159
060190052043,333.3,190.5,119.3,374,216,158
060190053011,512.0,307.0,170.0,496,304,192
060190032012,594.4,380.9,176.1,622,389,233
060190032023,588.4,391.7,164.9,544,360,184
060190053051,578.0,311.0,240.0,553,315,238
060190053021,607.0,378.1,186.1,637,409,228
060190053022,899.3,527.8,311.2,862,488,374
060190053041,229.3,139.1,74.7,398,258,140
060190054092,256.3,143.5,91.3,693,371,322
060190054033,259.5,141.1,96.7,159,121,38
060190054031,386.4,211.7,143.7,311,219,92
060190054053,644.0,291.0,315.0,661,307,354
060190053052,528.0,320.4,169.3,522,326,196
060190053042,585.6,389.2,152.0,549,371,178
060190053043,339.5,203.4,111.6,308,201,107
060190054081,298.0,186.2,86.2,120,91,29
060190054091,432.2,270.1,125.1,455,323,132
060190056084,228.8,84.9,131.9,229,96,133
060190054071,575.1,227.6,317.2,578,250,328
060190054072,815.9,348.4,418.8,833,369,464
060190014101,1939.0,1399.7,461.5,1376,871,505
060190014102,500.3,405.2,73.1,431,303,128
060190014082,209.8,132.6,65.8,355,199,156
060190014081,548.2,350.4,167.2,518,318,200
060190014073,306.4,248.8,46.0,194,146,48
060190014072,193.6,157.2,29.0,172,140,32
060470014011,534.0,281.0,219.0,512,301,211
060470014024,382.0,191.2,168.9,262,140,122
060470017003,317.0,185.0,98.0,302,195,107
060470016011,164.1,134.5,22.0,91,68,23
060470014012,511.3,271.0,202.4,444,282,162
060470014021,438.0,219.1,189.0,309,177,132
060470014023,550.6,271.7,245.4,591,321,270
060470014022,236.2,114.1,110.3,243,123,120
060470012003,418.2,208.9,184.0,390,176,214
060470012002,562.8,289.1,241.0,585,303,282
060470011013,534.3,269.8,229.8,590,310,280
060470011012,639.2,342.0,254.4,461,257,204
060470012001,464.4,233.1,197.3,394,209,185
060470010024,677.1,350.4,281.1,570,327,243
060470010023,521.9,258.6,233.9,465,240,225
060470010021,2788.5,1714.3,882.3,1447,852,595
060470010022,747.0,385.0,308.0,616,321,295
060470018011,2003.9,1083.3,788.8,1441,704,737
060470011011,590.1,278.3,277.9,648,349,299
060470011014,572.6,258.8,287.8,526,232,294
060470025002,589.6,186.4,376.7,527,185,342
060470009012,205.2,61.7,134.6,196,80,116
060470016021,704.0,532.4,128.6,444,322,122
060470016022,636.9,496.9,88.0,304,256,48
060470026001,760.3,375.8,336.6,344,183,161
060470017001,930.0,543.0,315.0,823,479,344
060390005032,1039.7,532.2,432.0,680,380,300
060390005062,673.3,318.3,309.7,566,295,271
060390006023,168.0,129.3,32.1,132,105,27
060390007002,1647.4,716.1,837.9,1622,750,872
060390007001,149.3,71.1,69.5,313,127,186
060390006022,137.5,106.0,26.2,156,108,48
060390006041,339.9,234.6,84.5,338,233,105
060390005061,556.7,263.2,256.1,546,286,260
060390005063,657.7,311.0,302.6,668,319,349
060390005074,747.9,353.6,344.1,900,361,539
060390002012,57.5,29.1,24.8,256,149,107
060390002011,348.3,180.5,146.9,141,49,92
060390003002,249.4,115.6,119.2,230,111,119
060390002021,633.7,170.6,436.0,566,174,392
060390002023,181.3,43.7,130.0,260,88,172
060390002024,1071.9,337.0,688.8,653,247,406
060470015031,217.9,175.1,30.1,131,106,25
060470015032,283.8,227.5,39.8,167,141,26
060470015011,692.1,441.5,201.8,585,400,185
060470009023,506.6,216.6,270.2,506,253,253
060470009021,844.0,408.5,384.4,388,197,191
060470009022,492.4,316.0,144.7,314,215,99
060470010051,592.6,369.8,181.7,608,393,215
060470009024,500.1,314.3,163.0,399,232,167
060470022021,597.0,389.9,171.2,718,476,242
060470023021,279.9,179.4,83.1,38,24,14
060470023022,1932.5,1287.1,544.1,979,661,318
060470023023,691.0,468.5,187.4,405,283,122
060470024021,237.4,148.4,72.9,176,127,49
060470024022,502.9,233.7,247.1,344,197,147
060470024024,623.5,372.4,216.9,386,215,171
060470024023,519.2,235.1,251.5,521,249,272
060470020005,368.7,179.3,164.7,374,219,155
060470020003,411.5,193.2,187.7,447,252,195
060470020004,273.6,120.9,132.3,99,64,35
060470020006,319.5,145.2,155.8,334,193,141
060470017002,274.0,123.0,138.0,291,159,132
060470012004,769.2,315.1,406.7,676,314,362
060470026002,1308.7,616.7,634.1,1089,530,559
060310016013,197.1,137.3,50.8,237,165,72
060310004021,367.1,97.4,262.9,353,111,242
060310004023,759.0,262.0,463.0,633,237,396
060310004044,815.0,314.0,449.0,765,318,447
060310002001,491.5,91.0,387.5,558,148,410
060190077002,238.3,101.0,128.0,242,102,140
060190077003,277.9,118.8,149.0,289,124,165
060190077004,177.0,76.2,94.8,133,100,33
060190075001,236.5,85.3,139.6,213,95,118
060190076003,285.2,141.4,134.1,229,116,113
060190075005,324.8,135.7,173.1,295,120,175
060190075004,290.2,144.7,131.5,236,102,134
060190018003,375.2,134.1,220.6,375,160,215
060190018004,479.6,202.4,251.8,427,179,248
060190018002,212.7,116.6,85.4,221,122,99
060990033004,326.9,108.5,200.1,317,121,196
060990031001,235.4,78.3,144.4,202,66,136
060990031003,495.4,191.4,283.7,519,239,280
060990036032,207.2,53.7,146.5,179,72,107
060990036031,188.5,49.6,132.3,211,74,137
060990025011,273.9,204.7,51.4,182,146,36
060990023011,417.1,322.0,71.8,373,282,91
060990024023,339.9,246.4,74.8,328,247,81
060990024022,37.7,27.4,8.3,26,19,7
060990031002,220.1,126.2,78.2,204,127,77
060990024012,415.4,325.9,67.1,312,255,57
060990024011,308.6,242.1,49.9,189,158,31
060990025013,1017.9,720.6,244.0,841,589,252
060990025012,186.2,131.8,44.6,59,46,13
060990023014,284.5,223.1,43.3,226,177,49
060990023022,346.5,255.9,67.6,242,186,56
060990023021,297.6,219.8,58.1,261,203,58
060990005101,816.5,385.2,373.0,703,347,356
060990005103,829.2,430.1,344.3,861,439,422
060990005104,400.6,217.3,158.9,219,140,79
060990036053,120.4,67.9,42.0,1,1,0
060990030024,538.6,216.2,294.0,324,172,152
060990030023,647.9,260.1,353.5,357,210,147
060990029015,432.7,173.7,236.1,524,174,350
060990029024,285.5,112.9,157.7,269,91,178
060990029022,1386.1,505.3,816.4,1199,487,712
060990029023,483.7,176.3,284.9,358,168,190
060990021002,260.6,161.5,76.0,269,186,83
060990019005,355.1,176.8,154.3,408,221,187
060990019001,852.9,426.1,372.3,1119,583,536
060990019003,464.0,231.5,202.2,422,236,186
060990019004,347.4,173.0,151.0,314,187,127
060990010012,629.9,293.5,299.6,425,189,236
060990019002,304.2,152.2,133.1,266,155,111
060990020042,283.8,152.6,105.7,317,190,127
060990020043,570.1,306.4,212.3,477,273,204
060990010011,587.1,268.6,283.1,631,295,336
060990010015,547.1,254.0,256.8,531,255,276
060990010013,327.3,151.9,153.6,332,177,155
060990009102,599.2,294.8,256.6,527,313,214
060990009103,338.4,166.5,144.9,294,153,141
060990010014,537.5,242.5,265.8,527,256,271
060990009052,1003.7,435.7,503.2,1008,500,508
060990009051,786.3,346.8,389.4,658,332,326
060990009111,639.4,282.6,319.0,714,339,375
060990009104,447.9,208.5,209.4,424,224,200
060990009101,555.1,258.4,259.6,582,304,278
060990009112,731.6,323.4,365.0,667,340,327
060990009121,422.1,184.0,213.7,457,217,240
060990009122,391.9,170.8,198.4,431,223,208
060990009113,480.0,209.2,243.0,397,205,192
060990020044,447.6,252.6,165.1,307,203,104
060990009053,819.5,369.7,398.4,1014,493,521
060990020061,718.9,400.0,269.3,769,454,315
060990020062,708.9,392.5,266.9,667,411,256
060990020052,458.3,273.7,158.9,424,291,133
060990020051,632.4,347.4,240.0,513,319,194
060990009061,815.8,361.8,399.1,697,359,338
060990009062,935.4,415.4,458.4,944,460,484
060310004045,496.4,170.9,290.9,526,217,309
060310004041,787.8,292.0,449.8,720,284,436
060310004053,312.4,114.0,174.0,320,153,167
060310004042,190.2,69.4,105.9,299,93,206
060310004043,456.6,166.6,254.3,456,177,279
060310005004,378.3,155.6,201.0,386,178,208
060310005003,500.6,295.4,174.1,439,215,224
060310004031,448.0,158.0,259.0,465,195,270
060310004054,321.4,158.6,136.7,265,145,120
060310004051,417.3,202.8,180.7,303,164,139
060310004032,614.5,224.5,350.2,865,344,521
060310004033,284.0,104.3,161.4,244,108,136
060310001003,571.8,87.6,455.1,572,107,465
060310005002,196.2,70.5,114.2,284,122,162
060310005001,373.9,80.6,270.6,336,72,264
060310006021,613.4,191.8,390.6,668,227,441
060310007012,638.3,201.4,394.8,781,283,498
060310006023,507.3,158.7,323.1,603,182,421
060310007013,273.1,94.2,162.1,340,129,211
060310009004,509.6,216.0,260.7,371,201,170
060310007022,613.3,261.9,313.9,881,368,513
060310006024,452.0,130.0,305.0,432,141,291
060310007011,849.0,224.0,578.0,902,303,599
060310008002,645.2,297.0,314.5,573,321,252
060310008001,245.0,94.2,126.3,296,123,173
060310007021,654.8,217.7,399.8,778,295,483
060310007014,507.0,159.0,320.0,515,167,348
060190043032,508.2,222.1,262.5,585,215,370
060190043034,682.0,296.5,348.7,720,273,447
060190045061,732.9,327.8,364.5,829,381,448
060190046012,444.4,203.9,214.7,502,260,242
060190046011,750.9,389.8,325.6,779,406,373
060190046023,380.0,186.2,168.6,447,240,207
060190045062,960.7,456.3,450.7,1011,497,514
060190045032,1288.7,613.6,602.7,1203,591,612
060190043033,468.8,208.0,231.8,482,187,295
060190045031,1181.2,510.1,614.0,1250,582,668
060190043023,597.3,248.5,320.8,629,254,375
060190043025,514.8,224.8,267.5,574,239,335
060190043022,588.7,238.9,322.4,696,238,458
060190046021,412.1,188.9,199.3,461,216,245
060190045042,485.9,226.7,231.9,366,184,182
060190045043,292.6,138.7,135.9,304,151,153
060190042161,1335.5,706.6,550.8,930,511,419
060190042151,1480.7,825.9,584.7,1445,802,643
060190042081,2392.2,1050.9,1244.5,2190,1090,1100
060390010001,261.3,91.2,150.2,263,104,159
060390005083,1068.0,271.1,746.2,1064,353,711
060390010003,312.2,100.8,195.9,326,93,233
060190042111,748.0,404.3,294.3,605,341,264
060190042112,1571.0,849.7,608.7,1386,776,610
060190042082,931.5,327.2,566.4,937,321,616
060190042101,657.4,306.7,319.9,410,236,174
060190042102,872.1,383.8,449.6,626,338,288
060390005092,944.8,240.0,660.3,945,358,587
060390005093,456.8,116.0,319.3,466,142,324
060190042141,612.0,243.4,344.7,714,235,479
060190042143,679.6,262.9,387.9,627,283,344
060190042142,534.1,199.1,316.2,587,229,358
060190043021,550.6,191.2,337.1,629,201,428
060190043013,1009.5,300.8,669.5,965,295,670
060190043011,809.7,244.4,534.4,969,261,708
060190043012,517.1,146.9,343.6,517,158,359
060190044092,527.1,176.6,331.1,585,228,357
060190044093,401.5,183.7,196.2,375,196,179
060190044091,425.3,206.4,192.7,500,246,254
060190044041,507.9,307.8,171.5,430,301,129
060190044063,647.6,279.0,332.0,737,344,393
060190044082,861.6,376.6,436.4,843,369,474
060190044081,665.0,311.6,309.9,653,312,341
060390008002,121.2,84.0,29.9,92,66,26
060390008003,86.2,60.2,20.9,78,59,19
060390008001,148.2,82.1,57.1,108,45,63
060390009001,320.0,243.3,56.5,271,202,69
060390006021,230.0,128.0,87.0,265,157,108
060390002022,184.9,37.5,140.0,202,39,163
060390005033,325.7,88.2,223.2,327,97,230
060190039001,224.7,74.9,141.8,246,85,161
060190040013,274.2,137.1,123.9,142,95,47
060390010004,291.6,117.1,155.2,225,112,113
060390007003,472.1,194.1,249.9,985,457,528
060390005031,2097.8,918.5,1051.2,1608,745,863
060390007006,222.9,100.8,110.3,191,91,100
060390007004,527.5,237.5,260.4,676,270,406
060390007005,366.2,167.0,179.8,416,203,213
060390008006,269.2,145.9,106.8,271,163,108
060390003001,288.9,127.5,149.7,312,131,181
060390003007,184.4,54.4,117.0,133,48,85
060390003006,826.1,292.3,488.5,795,271,524
060390003004,188.8,67.0,112.0,162,68,94
060390003005,186.6,69.5,107.2,158,71,87
060390003003,170.6,77.3,85.8,136,69,67
060470013013,269.7,150.7,103.0,232,143,89
060470015021,221.8,181.7,26.2,154,125,29
060470015022,175.4,143.9,20.0,179,148,31
060470015033,189.3,155.6,19.9,181,152,29
060470016012,136.7,114.4,13.5,98,85,13
060470016013,139.4,116.0,16.1,70,60,10
060470013012,432.0,228.8,163.3,380,229,151
060470013011,163.2,96.2,55.7,165,96,69
060470010031,205.0,129.0,66.0,160,88,72
060470010032,441.9,305.1,110.5,350,260,90
060470010033,282.0,195.4,69.9,158,119,39
060470013023,297.5,188.4,86.5,216,174,42
060470013022,249.5,152.6,77.5,232,149,83
060470010041,346.9,242.7,77.9,206,131,75
060470010042,401.0,196.0,177.0,389,185,204
060470013021,224.8,118.8,81.3,219,137,82
060470010043,506.0,256.0,222.0,434,241,193
060190056023,438.0,201.0,206.0,378,203,175
060190057041,401.9,192.7,184.7,308,189,119
060190057044,222.4,112.2,97.0,170,88,82
060190056022,450.0,220.0,207.0,422,208,214
060190057014,291.7,112.4,159.6,307,124,183
060190057011,481.7,185.7,263.6,556,223,333
060190056021,590.4,232.4,314.5,669,298,371
060190057042,657.7,229.2,391.5,682,300,382
060190058012,716.2,254.6,425.5,605,251,354
060190058011,874.0,333.3,494.8,882,390,492
060190057034,590.8,189.5,375.9,573,225,348
060190057043,560.9,182.0,343.0,606,235,371
060190057031,398.4,127.5,255.1,420,139,281
060190057024,782.0,225.0,512.0,802,277,525
060190045044,479.0,231.7,215.1,518,250,268
060190044042,257.7,185.4,60.5,219,178,41
060190045041,483.9,242.4,198.7,387,228,159
060190054061,541.1,244.6,254.3,667,302,365
060190044062,316.6,119.4,179.8,430,190,240
060190044061,933.9,399.9,473.2,821,412,409
060190044053,555.4,245.8,276.8,492,247,245
060190044051,483.3,205.7,252.9,603,245,358
060190044052,1058.7,403.2,623.5,1119,445,674
060190055161,890.0,380.8,471.9,963,409,554
060190055163,747.7,305.1,410.4,810,377,433
060190055101,782.9,348.2,391.8,833,362,471
060190054063,647.0,256.0,344.0,638,312,326
060190055103,469.0,215.0,218.0,437,202,235
060190055072,1234.5,502.9,677.3,1393,568,825
060190055102,945.0,339.4,564.2,879,356,523
060190055091,964.4,402.6,512.6,930,359,571
060190055081,1151.5,471.2,635.2,1102,477,625
060190055071,1150.9,497.9,602.2,1132,521,611
060190055162,1035.0,461.7,532.0,726,313,413
060190026012,281.7,231.0,36.6,248,200,48
060190026011,242.0,198.7,31.2,174,147,27
060190027011,208.9,159.8,37.2,209,157,52
060190026013,317.0,242.6,56.5,243,206,37
060190027014,193.4,148.0,34.5,189,147,42
060190025014,215.8,161.8,43.4,101,75,26
060190025013,136.2,102.1,27.4,108,81,27
060190028004,220.0,168.2,39.5,124,99,25
060190028003,152.6,114.1,30.4,136,108,28
060190027023,182.0,152.0,20.0,132,106,26
060190027012,113.2,84.9,22.7,71,47,24
060190027021,246.2,191.2,43.3,178,132,46
060190027022,258.2,200.5,45.4,214,171,43
060190027013,280.9,211.8,55.0,300,214,86
060190028002,110.6,80.7,23.9,62,45,17
060190028001,218.3,160.4,46.3,223,158,65
060190034003,173.3,123.7,39.0,206,146,60
060190035005,273.5,186.8,68.2,257,177,80
060190034004,293.4,192.0,80.6,292,180,112
060190035001,246.3,175.4,55.7,202,158,44
060190035002,305.6,201.7,81.7,322,215,107
060190049011,555.9,331.7,190.7,600,423,177
060190049012,590.3,375.3,183.5,488,316,172
060190049022,365.6,182.1,161.8,427,242,185
060190048011,210.8,122.8,72.6,146,96,50
060190051005,308.5,184.3,101.9,295,195,100
060190051003,188.8,135.3,44.0,204,143,61
060190051002,308.2,188.8,97.9,332,220,112
060190051004,164.9,118.2,38.4,103,73,30
060190050003,736.2,381.7,310.1,705,375,330
060190050002,316.9,206.2,92.1,260,167,93
060190053013,583.4,346.6,196.9,518,301,217
060190034002,344.0,262.8,65.0,184,128,56
060190034001,171.4,110.6,48.5,208,135,73
060190051001,395.6,226.4,138.8,497,298,199
060190052031,453.0,286.0,147.0,495,317,178
060190052042,373.0,205.8,140.8,406,221,185
060190053012,544.5,294.1,219.3,625,301,324
060190045051,724.7,363.5,312.8,781,449,332
060190045052,650.0,393.0,215.0,601,371,230
060190050001,335.6,185.2,125.0,381,209,172
060190054101,284.4,159.9,105.1,356,222,134
060190054102,837.3,432.8,361.4,748,425,323
060190054032,285.8,160.7,105.6,275,149,126
060190037022,302.7,212.9,73.5,244,174,70
060190037021,412.6,284.4,105.7,439,302,137
060190047041,379.4,272.2,89.1,299,218,81
060190047031,532.0,345.0,148.0,543,367,176
060190047013,349.8,214.3,119.6,357,253,104
060190047012,558.0,317.3,215.6,613,336,277
060190042051,321.3,205.5,95.7,236,146,90
060190042123,1045.8,622.2,368.1,787,440,347
060190042124,435.3,274.7,136.9,373,235,138
060190042144,767.1,359.6,375.7,746,367,379
060190042131,544.0,307.0,200.6,449,259,190
060190042132,803.2,384.4,381.8,777,366,411
060190047014,391.2,257.4,115.8,333,251,82
060190043031,773.1,307.5,432.0,885,325,560
060190043024,512.0,199.0,289.3,559,203,356
060190037011,376.0,247.0,105.0,361,255,106
060190037012,412.0,277.0,104.0,360,256,104
060190037023,182.9,116.5,56.2,215,143,72
060190037024,232.7,148.2,71.5,218,138,80
060190047042,560.5,378.9,143.7,541,374,167
060190047032,279.1,201.4,66.2,252,166,86
060190047033,234.9,169.6,55.8,228,150,78
060190048023,311.8,199.5,96.6,263,168,95
060190048022,264.3,166.2,84.9,292,210,82
060190048021,567.9,393.8,144.3,455,338,117
060190046022,444.8,211.8,205.7,529,240,289
060190036004,421.8,288.5,110.3,439,312,127
060190036003,358.1,237.9,100.1,388,257,131
060190036002,318.3,213.2,82.9,286,195,91
060190036005,383.7,264.4,98.5,305,202,103
060190035003,499.8,337.5,120.3,566,382,184
060190036001,416.3,268.5,117.3,449,290,159
060190035004,487.0,319.0,130.6,345,239,106
060190049021,386.4,195.2,165.6,301,199,102
060190048014,227.6,174.2,41.9,212,168,44
060190048013,273.7,159.4,94.3,339,204,135
060190048012,255.5,148.8,88.1,299,189,110
060190047011,519.0,348.0,141.0,502,336,166
060190038032,2115.1,1280.7,701.0,1395,828,567
060190038081,451.5,284.0,142.3,468,288,180
060190038033,270.5,111.9,146.3,284,130,154
060190038031,342.2,135.0,194.6,368,145,223
060190038042,721.9,478.8,203.2,352,240,112
060190038043,648.5,414.8,191.5,652,433,219
060190042072,746.2,503.0,208.5,609,431,178
060190038101,705.9,455.4,216.9,632,443,189
060190038102,889.4,536.7,309.7,626,406,220
060190038092,582.9,364.6,183.0,497,311,186
060190042121,1525.5,853.5,588.2,1188,692,496
060190042122,496.3,289.1,179.3,518,276,242
060190030031,534.7,348.6,162.1,326,212,114
060190014091,636.2,350.0,252.0,868,476,392
060190030032,400.9,234.0,143.6,300,199,101
060190029032,243.4,170.4,60.4,234,163,71
060190029031,277.1,204.3,62.9,204,159,45
060190029033,223.7,175.0,40.3,124,103,21
060190014071,229.2,187.1,33.0,170,129,41
060190029041,346.4,246.1,86.0,378,269,109
060190029051,314.0,204.6,91.7,341,203,138
060190029042,286.5,193.9,78.7,364,234,130
060190029052,225.7,163.5,46.0,185,128,57
060190029063,339.1,217.0,99.7,319,191,128
060190030042,359.4,191.4,143.8,355,187,168
060190030041,310.4,177.0,115.9,363,213,150
060190030012,345.0,215.0,114.0,329,205,124
060190029061,304.7,213.3,75.5,336,225,111
060190029062,311.8,213.9,81.4,299,195,104
060190030011,200.1,149.4,42.0,177,139,38
060190014143,1854.0,1229.0,543.0,1177,761,416
060190014142,450.2,192.6,237.0,589,222,367
060190014141,421.8,180.4,222.0,375,207,168
060190014111,384.0,212.8,151.5,433,244,189
060190014112,384.3,204.7,159.2,345,200,145
060190014113,336.0,198.1,119.7,175,101,74
060190014114,452.7,268.4,158.6,148,86,62
060190031041,400.6,227.2,132.8,376,208,168
060190031033,309.9,160.5,131.2,293,173,120
060190031031,369.7,191.9,156.7,345,191,154
060190031032,358.4,186.6,152.1,335,180,155
060190031035,290.5,126.6,144.3,306,136,170
060190031034,347.5,151.4,172.7,355,165,190
060190031043,393.4,152.3,227.5,442,170,272
060190031042,406.9,143.4,251.5,458,182,276
060190031022,290.7,148.1,126.7,320,173,147
060190031023,530.8,283.0,211.0,440,233,207
060190031024,336.2,179.0,134.0,356,176,180
060190056083,329.5,122.3,190.0,332,142,190
060190056062,946.0,333.0,565.9,1020,421,599
060190056073,341.0,144.0,178.2,210,110,100
060190056071,320.1,142.8,159.6,402,173,229
060190056072,378.0,176.6,170.8,296,154,142
060190031025,414.1,233.8,155.2,408,242,166
060190031021,156.1,92.1,54.2,124,78,46
060190056081,345.8,139.4,189.0,318,143,175
060190056082,267.2,107.6,146.0,273,114,159
060190056074,227.2,109.4,95.5,215,118,97
060190056024,348.6,140.4,180.8,279,124,155
060190058043,735.8,298.6,404.3,816,381,435
060190058045,381.8,195.7,156.3,281,174,107
060190058042,392.3,192.0,167.4,379,201,178
060190058044,294.9,151.6,121.6,303,136,167
060190058041,368.0,151.4,198.4,394,169,225
060190058013,444.4,210.5,211.0,424,213,211
060379102091,1729.9,797.1,817.4,1860,915,945
060379102101,3059.9,1382.7,1513.7,2960,1405,1555
060379102021,1772.9,587.4,1084.7,1298,447,851
060379102022,747.0,230.6,479.1,632,192,440
060379010104,505.9,211.8,266.0,427,179,248
060379010101,641.4,284.9,319.9,577,250,327
060379010072,493.1,174.3,295.9,457,145,312
060379010071,462.1,163.3,277.3,674,219,455
060379011021,750.6,248.6,444.2,704,304,400
060379010111,944.2,436.9,446.5,883,411,472
060379010113,487.2,225.6,227.5,430,215,215
060374083021,1605.3,1162.3,375.9,1437,1010,427
060379010043,3080.5,1459.6,1438.0,2640,1352,1288
060379011023,891.6,349.3,485.5,703,279,424
060379010042,745.2,322.2,376.5,847,396,451
060379006022,488.5,322.0,137.0,453,330,123
060379010031,734.1,372.1,321.1,11,1,10
060379008042,384.5,272.7,88.8,235,163,72
060379012051,1540.3,669.4,782.6,1014,483,531
060379010102,651.2,294.6,318.1,541,259,282
060379010041,547.3,230.5,278.8,611,318,293
060379010112,557.8,257.9,268.5,538,256,282
060379007052,839.7,416.5,369.4,722,350,372
060379010091,1037.4,408.2,563.8,1166,416,750
060379010093,867.4,359.6,452.0,939,362,577
060379010081,784.3,371.6,359.8,706,399,307
060379007031,454.6,241.2,181.0,436,212,224
060379010092,299.5,154.0,125.4,263,166,97
060379010082,211.5,115.8,79.5,207,115,92
060379008052,724.5,399.3,273.6,447,204,243
060379008051,463.7,224.9,204.6,609,307,302
060379008034,709.3,384.7,272.2,598,328,270
060379008032,782.8,465.2,274.1,707,407,300
060379102012,336.8,245.4,67.2,178,123,55
060379102081,1219.9,704.1,441.0,899,522,377
060379007053,234.0,117.9,100.8,120,80,40
060379007051,451.5,239.2,181.8,894,300,594
060379007033,534.3,313.5,186.9,534,296,238
060379007041,535.6,320.3,176.8,382,266,116
060379007042,270.9,162.0,89.4,142,98,44
060379005041,502.9,301.5,171.3,317,172,145
060379007032,283.2,166.2,99.1,242,141,101
060379007012,355.0,207.3,124.9,279,150,129
060379007013,405.5,233.9,145.0,268,143,125
060379008053,481.4,215.8,230.7,465,216,249
060379008062,720.0,465.4,207.1,556,353,203
060379008061,518.2,325.3,158.6,294,206,88
060379007011,404.9,233.2,145.1,300,168,132
060379007014,286.9,165.2,102.7,356,193,163
060379006062,248.4,177.0,52.6,194,136,58
060379006071,535.5,345.6,153.5,437,270,167
060379006061,705.9,465.6,196.7,703,430,273
060379008031,502.1,286.9,183.1,531,315,216
060379008033,451.7,275.4,147.9,535,297,238
060379008041,630.4,444.6,146.4,365,259,106
060379005012,558.4,379.3,145.7,461,294,167
060379005011,514.7,336.7,147.3,523,291,232
060379005013,947.1,641.2,245.6,826,479,347
060379006072,501.6,297.7,173.4,488,270,218
060379005052,766.1,434.8,282.6,702,377,325
060379005061,698.6,456.4,207.0,573,340,233
060379005062,704.0,471.4,197.2,472,311,161
060379005051,585.3,390.4,164.2,480,260,220
060379006082,360.1,214.4,114.5,323,180,143
060379006081,696.2,443.5,203.6,643,392,251
060379006021,522.4,344.4,146.4,407,228,179
060379006091,820.6,533.1,244.8,628,425,203
060290058012,439.4,163.1,239.5,420,180,240
060290055064,240.7,87.7,131.3,196,81,115
060290058013,961.0,352.2,536.5,786,332,454
060290058022,502.0,197.1,258.7,531,207,324
060377013041,902.7,687.1,183.9,990,726,264
060377012011,502.4,380.4,99.8,511,356,155
060377012014,669.9,510.5,133.7,667,453,214
060377012013,482.1,366.9,89.5,485,343,142
060377012015,439.0,334.1,81.5,483,343,140
060377012012,643.5,486.0,125.6,628,458,170
060377012022,964.4,815.9,107.0,944,767,177
060377013021,1274.8,1012.3,192.4,1191,948,243
060372625011,542.5,402.6,110.1,510,357,153
060372625012,477.9,353.6,98.1,480,331,149
060372625013,1166.4,872.7,236.0,1199,854,345
060372624001,724.4,503.2,177.0,750,479,271
060379800191,96.5,65.4,25.9,169,110,59
060372628021,856.6,693.2,126.7,900,728,172
060372624002,1231.7,921.6,264.2,1554,1092,462
060372628023,838.9,615.9,182.4,873,598,275
060372623033,623.7,480.3,122.4,546,375,171
061110056002,1179.5,554.3,575.4,2174,1178,996
061110073001,1041.5,469.3,514.0,1014,504,510
061110058022,2110.9,1127.1,871.3,2373,1232,1141
061110058013,1397.0,694.7,613.5,1542,767,775
061110058012,983.6,502.2,424.4,1183,621,562
061110056001,1136.0,617.0,436.0,1117,599,518
061110056003,2484.1,1278.0,1060.9,1523,745,778
061110053051,1834.2,783.2,935.3,2020,859,1161
061110058011,731.5,342.6,336.4,394,189,205
061110058021,1407.7,683.6,642.4,1298,584,714
061110059012,1121.5,528.2,520.9,1663,791,872
061110059015,771.9,375.5,348.3,748,360,388
061110059011,724.7,351.4,321.5,603,289,314
061110060002,228.9,105.1,108.9,217,109,108
061110060003,808.6,370.5,377.1,819,413,406
061110060001,320.5,143.8,153.8,201,90,111
061110058023,896.7,402.4,430.4,671,307,364
061110059014,577.9,272.7,267.7,413,218,195
061110059101,1128.8,560.4,494.3,2066,998,1068
061110059013,667.7,308.4,316.8,516,237,279
061110059081,724.1,353.4,325.2,722,356,366
061110059082,718.4,351.4,323.5,675,356,319
061110061001,1130.6,650.0,411.4,1693,931,762
061110061002,134.4,76.9,49.0,201,105,96
061110061004,879.6,508.1,319.4,309,182,127
061110061003,474.2,273.9,172.2,235,149,86
061110062002,786.3,370.2,361.2,408,169,239
061110062001,2099.7,1042.5,919.5,1625,768,857
060378005061,633.5,436.5,158.8,654,414,240
060378001023,1474.4,1161.7,202.9,1113,925,188
060378005041,1336.1,871.0,401.1,1380,882,498
060378005062,224.6,153.9,59.5,284,194,90
060372626043,686.4,478.1,176.5,705,462,243
060378005063,718.7,503.0,189.7,839,547,292
060372626041,262.4,193.3,55.4,361,237,124
060372626044,1739.3,1252.1,412.9,1691,1169,522
060372626011,2062.0,1374.6,574.1,2201,1327,874
060377019023,504.6,394.3,77.1,461,370,91
060377018023,543.1,436.2,73.2,417,352,65
060377020021,953.5,781.1,112.3,817,675,142
060377020024,858.8,707.9,92.6,834,710,124
060377019022,396.4,293.8,78.5,371,275,96
060372627041,2031.0,1502.1,409.1,2013,1439,574
060372627063,348.6,267.4,65.0,397,290,107
060372627061,949.4,720.6,185.0,974,685,289
060372627062,801.9,522.9,223.6,713,413,300
060372626042,927.2,673.4,205.2,859,553,306
060377014021,573.8,444.4,95.7,568,445,123
060377013043,1464.9,1101.0,297.1,1379,1008,371
060377014023,899.5,669.6,173.8,876,695,181
060377014022,1297.4,1006.6,209.4,1376,1099,277
060372628022,499.7,401.1,77.0,508,416,92
060377013042,716.6,538.4,142.7,931,704,227
060377013022,1578.8,1254.0,230.6,1508,1187,321
060377019021,1101.2,815.2,213.5,768,606,162
060377014024,805.4,617.2,143.0,793,609,184
060377015013,1157.5,901.1,190.1,1157,897,260
060377015023,721.6,560.9,114.1,761,618,143
060377017023,548.2,426.9,82.6,534,436,98
060377015022,625.0,512.5,77.5,608,501,107
060377015012,730.7,583.4,111.4,691,553,138
060377013044,433.2,335.0,79.1,464,331,133
060379303011,128.3,56.3,59.9,124,63,61
060379110013,670.1,231.7,394.8,749,243,506
060379108111,53.0,12.0,40.0,25,13,12
060379110011,635.8,211.8,385.0,518,217,301
060379100022,661.5,314.9,309.9,605,277,328
060379100012,450.2,291.8,127.7,284,185,99
060379001041,545.6,268.3,239.6,448,235,213
060710002013,347.9,240.9,83.9,347,240,107
060710002012,494.5,342.3,119.2,395,273,122
060710002032,349.8,243.7,89.2,279,178,101
060710002051,510.0,332.5,146.3,414,283,131
060710002011,343.6,237.8,82.8,157,106,51
060710002052,826.9,516.8,258.8,847,511,336
060710008211,876.7,596.9,221.9,574,410,164
060710008232,544.2,374.1,135.4,399,275,124
060710008233,689.3,435.5,212.0,821,473,348
060710010011,564.6,365.1,169.9,493,311,182
060710010013,349.4,225.9,105.1,342,220,122
060710008252,532.5,332.4,168.0,411,293,118
060710008251,232.5,145.1,73.4,249,161,88
060710008253,219.6,137.1,69.3,114,81,33
060374018001,1298.8,863.4,363.8,1236,766,470
060374018003,1377.2,887.0,399.6,1455,932,523
060374002061,1583.2,926.1,563.1,1532,844,688
060374002051,1551.7,814.6,652.4,1685,889,796
060710008173,525.0,262.6,240.7,443,187,256
060710008172,703.9,339.8,330.7,716,332,384
060710008152,1070.7,545.3,473.9,1028,485,543
060710008151,862.7,427.2,394.3,882,432,450
060379203123,1142.5,515.6,547.4,1079,568,511
060379203121,384.6,171.3,184.9,537,218,319
060379203364,314.7,163.1,132.1,104,61,43
060379203223,251.4,128.3,110.8,172,102,70
060379203222,669.6,341.7,295.2,796,380,416
060379203361,404.0,211.0,167.0,452,212,240
060379203312,750.1,362.3,346.5,795,361,434
060379203311,855.1,414.1,395.0,810,432,378
060379203313,457.8,220.6,211.5,519,250,269
060379203122,810.6,356.9,402.5,921,395,526
060379203363,274.1,173.1,84.5,97,53,44
060379203362,262.6,165.9,81.0,188,100,88
060379203141,854.4,362.0,438.7,913,401,512
060379203142,461.3,200.1,231.2,459,161,298
060371066032,723.1,455.5,237.2,766,476,290
060379302002,63.2,32.5,26.9,74,31,43
060379203371,437.0,301.6,110.0,185,124,61
060379203374,220.9,162.3,45.2,93,74,19
060379203373,507.7,319.0,160.9,383,246,137
060379203372,217.4,159.8,44.5,191,126,65
060379203322,344.2,88.7,234.3,420,144,276
060379203321,746.9,222.6,479.1,560,212,348
060379200314,780.9,430.8,293.6,596,310,286
060379200421,579.8,299.0,255.0,711,355,356
060379203291,685.7,349.1,284.5,660,367,293
060379203292,799.9,393.2,352.6,1142,609,533
060379201152,1370.3,689.1,601.1,1100,572,528
060379203293,1145.0,530.0,555.0,810,399,411
060379201141,2334.6,1228.2,952.6,2113,1101,1012
060379201121,742.0,371.2,326.1,643,345,298
060379201123,758.0,374.6,343.3,647,317,330
060379201122,907.4,427.5,419.6,931,430,501
060379200131,606.1,303.8,264.1,371,172,199
060379200133,1342.2,682.0,570.6,441,205,236
060379200172,957.0,408.0,479.0,661,291,370
060379201101,1454.1,669.2,701.7,1343,617,726
060379201151,609.1,272.1,300.7,600,290,310
060379203391,3284.9,1668.8,1452.2,2948,1532,1416
060379203262,1523.0,693.2,741.5,1157,545,612
060379203031,582.3,319.2,229.1,465,277,188
060379203381,2348.3,1240.9,976.6,2356,1194,1162
060379203261,1377.5,781.9,531.6,1155,680,475
060379203341,310.3,161.4,130.4,420,153,267
060379203343,910.9,501.4,347.4,1080,629,451
060379203131,843.3,407.1,363.5,661,329,332
060379203221,656.4,320.6,305.4,554,281,273
060379203132,507.7,249.8,214.0,392,194,198
060379203134,794.1,340.4,400.2,1104,439,665
060379203342,935.0,415.9,467.0,686,307,379
060379203344,821.5,442.0,335.2,1010,502,508
060379203281,960.0,477.0,430.0,770,412,358
060379203302,507.2,256.8,216.8,520,259,261
060379203303,670.0,325.1,300.5,1032,483,549
060379203301,608.0,323.7,244.1,614,365,249
060379203304,967.7,427.2,476.2,523,263,260
060379201071,2325.2,1183.6,1024.6,1417,763,654
060379201081,1981.8,1172.1,677.0,890,511,379
060379202001,259.5,154.3,85.0,1,1,0
060379201091,2859.0,1398.9,1325.6,2717,1342,1375
060379203133,396.8,180.8,188.0,368,160,208
060379201111,827.3,363.4,411.1,761,361,400
060379201112,815.7,356.6,407.9,846,402,444
060379200173,726.3,290.5,377.9,672,283,389
060379200171,427.4,172.6,227.1,604,298,306
060379200183,237.0,94.2,128.3,286,126,160
060379200151,1479.9,654.7,750.5,1499,685,814
060379200161,623.1,300.1,283.0,445,225,220
060379200152,1503.5,605.8,816.8,1369,591,778
060379200162,1826.9,800.7,926.6,1636,815,821
060379200182,389.6,152.2,213.9,411,178,233
060379200181,538.7,210.4,295.9,464,198,266
060379200132,1046.7,439.0,536.7,1149,492,657
060379200301,1364.8,778.8,499.1,1141,637,504
060379200231,650.5,346.1,257.9,884,448,436
060379200302,1040.5,542.8,450.3,996,553,443
060379200291,1072.2,494.0,513.8,721,354,367
060379200281,2458.3,1234.5,1064.6,2017,1038,979
060379200441,938.7,417.8,443.4,1004,490,514
060379200453,343.3,163.7,155.1,486,264,222
060379200452,1650.7,741.8,822.2,1444,683,761
060379200451,386.4,172.9,182.4,393,202,191
060379200442,287.9,129.8,133.0,217,121,96
060379200201,1062.4,433.6,552.3,1058,450,608
060379200203,1828.2,761.0,945.9,1722,733,989
060379200202,412.1,160.7,222.5,341,160,181
060379200321,1683.0,742.0,834.0,1151,562,589
060371066433,371.5,211.6,139.2,413,221,192
060371112013,354.3,199.8,129.2,429,225,204
060371112012,722.1,412.0,259.8,652,363,289
060371066423,503.3,297.1,182.5,468,284,184
060371066422,514.1,296.4,191.7,543,341,202
060371066421,480.6,268.1,185.9,503,287,216
060371066431,1179.6,659.5,449.3,1204,674,530
060371066411,1119.9,665.7,401.4,1178,691,487
060371093003,534.0,333.2,170.6,366,224,142
060371066462,592.4,392.3,164.1,478,333,145
060371066451,616.9,355.2,233.4,643,387,256
060371066461,887.5,498.6,346.8,846,511,335
060371066452,1004.2,511.0,432.9,1205,677,528
060371066031,753.0,452.8,258.4,782,470,312
060371065103,559.0,411.0,123.0,288,197,91
060379800221,2.3,1.1,1.0,0,0,0
060371065101,581.0,386.2,160.3,583,377,206
060371066044,407.9,310.5,70.7,330,249,81
061110002001,281.9,205.0,59.7,280,197,83
060379201061,1097.2,615.9,396.6,925,541,384
060379201181,797.2,347.4,409.5,710,339,371
060379201182,2123.3,952.6,1050.7,1869,940,929
060379201191,512.3,216.5,266.7,748,361,387
060379201162,2121.8,836.0,1164.3,1874,833,1041
060379201161,541.4,211.1,299.6,337,152,185
060379201021,145.9,62.6,73.6,469,243,226
060371311003,426.5,294.2,110.0,366,238,128
060371311001,656.1,451.5,169.0,597,428,169
060371311002,353.5,243.7,91.2,359,224,135
060379800081,38.4,29.0,7.0,14,7,7
060371274002,374.9,293.3,62.5,414,313,101
060371321022,809.1,583.1,180.9,655,484,171
060371274003,410.3,316.0,73.4,379,288,91
060371321021,191.2,144.4,37.0,121,76,45
060371173032,408.6,263.9,116.8,381,248,133
060371173031,1128.4,755.1,322.2,968,622,346
060371173024,697.8,447.6,209.8,650,437,213
060371151013,707.1,405.3,260.0,761,408,353
060371173023,578.7,339.1,214.1,627,373,254
060371151012,1136.2,680.4,398.8,1164,690,474
060371151011,921.9,625.4,251.1,959,576,383
060371151042,1131.3,796.4,261.2,808,607,201
060371113022,1163.8,751.4,349.6,1119,741,378
060371151031,642.4,536.8,55.8,361,298,63
060371113013,1104.4,676.4,354.0,973,589,384
060371113021,647.9,401.7,219.3,635,398,237
060371112022,708.9,427.0,236.3,721,430,291
060371112021,577.9,346.1,196.0,572,348,224
060371113011,661.5,437.8,193.5,633,402,231
060371112023,924.4,566.9,300.5,866,547,319
060371173021,492.1,307.4,156.1,447,295,152
060371173022,443.5,277.1,140.6,430,248,182
060371114001,916.1,582.2,277.6,907,593,314
060371098003,501.2,318.7,161.5,452,272,180
060371114002,818.8,533.9,238.3,848,516,332
060371114003,899.2,613.1,233.7,710,480,230
060371111002,693.9,463.9,189.2,687,435,252
060371111001,640.1,427.1,175.8,496,320,176
060371112011,554.8,334.2,186.3,501,300,201
060371081021,1423.1,800.4,542.4,1701,921,780
060371081032,660.7,384.7,243.0,772,414,358
060371081011,1068.8,604.7,403.3,1133,647,486
060371081041,953.2,544.0,365.5,903,498,405
060371081031,872.8,511.4,323.4,867,531,336
060371112062,459.1,266.4,165.4,475,268,207
060371112061,461.9,267.2,162.5,464,284,180
060371066432,356.7,196.3,139.2,439,236,203
060379200111,68.1,23.7,42.9,104,40,64
060290036003,562.7,99.0,442.9,711,166,545
060290036002,236.2,46.4,178.1,186,50,136
060290036001,155.3,30.5,117.1,108,26,82
060290035001,415.6,117.7,276.8,466,165,301
060290035003,142.5,21.1,116.8,603,144,459
060290033062,1180.0,438.6,669.3,1298,549,749
060290035002,980.0,138.9,826.9,871,170,701
060290034001,413.7,106.8,290.6,554,173,381
060290034002,371.8,95.9,261.2,278,89,189
060371395031,927.0,623.0,267.0,888,603,285
060371395032,786.5,511.4,235.1,748,532,216
060371392002,357.8,247.4,83.2,345,249,96
060371392003,1316.7,899.0,328.1,1118,778,340
060371325022,491.8,361.9,106.3,497,348,149
060371325021,724.1,549.8,138.9,656,491,165
060371393013,795.6,524.9,232.0,850,548,302
060371393021,605.9,419.6,156.4,483,361,122
060371331001,844.0,589.5,207.8,801,584,217
060371331004,422.5,280.2,118.6,379,261,118
060371331003,372.8,230.9,122.8,372,235,137
060371331002,363.2,254.4,88.8,236,162,74
060371325011,586.9,440.5,118.6,556,393,163
060371310203,449.6,345.6,82.9,450,314,136
060371325012,534.9,392.9,117.7,500,368,132
060371317021,1078.7,754.8,256.4,813,574,239
060371317012,652.8,490.1,132.7,540,386,154
060371317022,275.7,202.4,59.1,248,198,50
060371317011,822.2,633.4,157.7,740,535,205
060371310201,694.9,526.7,134.2,585,430,155
060371318002,899.9,654.1,203.6,629,440,189
060371393031,974.2,680.5,237.4,853,636,217
060371329002,748.0,465.0,241.0,749,517,232
060371327003,329.6,244.9,64.3,369,254,115
060371327004,641.4,491.3,113.7,387,297,90
060371327002,353.5,254.1,75.8,363,246,117
060371327001,308.5,221.7,66.1,274,186,88
060371310202,358.1,274.1,68.7,361,265,96
060371323003,555.0,431.9,99.5,398,291,107
060371323001,1020.1,789.5,182.9,683,490,193
060371323002,436.0,321.0,91.7,453,329,124
060371318001,781.0,561.0,181.2,683,485,198
060371397013,476.3,321.5,135.0,591,376,215
060371396002,1111.2,771.2,296.0,1138,776,362
060371395022,478.6,295.7,161.2,499,305,194
060371396001,1110.2,731.7,318.5,1279,867,412
060371397024,1413.1,990.1,378.5,1477,980,497
060371395041,858.6,577.3,237.7,866,607,259
060371395042,449.8,302.3,121.2,411,299,112
060371390012,724.2,530.2,149.2,694,519,175
060371390014,411.2,295.5,91.7,399,289,110
060371397014,711.2,492.4,191.7,606,421,185
060371397012,740.9,519.7,191.9,730,473,257
060371397011,505.2,373.9,112.8,481,340,141
060371397022,550.8,401.0,128.2,635,425,210
060371397015,349.2,228.9,98.5,306,203,103
060371390013,398.1,297.1,78.5,408,310,98
060371392001,476.7,334.8,116.0,433,310,123
060379800241,96.3,74.1,16.7,101,75,26
060371329001,596.0,412.0,148.0,605,432,173
060377018015,978.4,825.1,90.5,791,698,93
060377018012,278.7,226.3,31.1,380,307,73
060377018014,659.2,555.8,56.0,571,512,59
060377018011,529.8,420.1,76.4,477,379,98
060377023001,744.6,615.5,93.0,699,555,144
060372676003,377.0,297.4,57.7,317,254,63
060377023003,631.4,510.4,82.3,609,487,122
060377023004,754.0,613.6,88.6,787,644,143
060377023005,937.3,770.6,108.4,896,718,178
060377018013,254.3,216.0,21.4,240,206,34
060377017011,877.8,728.0,107.8,824,677,147
060377017012,682.4,546.8,101.2,682,543,139
060377016022,848.8,690.0,108.3,831,665,166
060377016021,793.6,657.2,93.5,714,589,125
060372643022,1051.5,822.3,178.1,1059,808,251
060372643023,876.4,653.8,189.5,803,587,216
060372643021,1118.5,890.1,169.5,1134,841,293
060372674022,1341.5,1109.3,146.0,1190,970,220
060372675021,654.8,532.6,76.3,683,562,121
060372674021,801.8,662.1,89.3,831,685,146
060372674041,1153.8,923.3,155.7,1061,817,244
060372675022,647.6,519.5,82.0,533,422,111
060372675013,714.2,588.5,81.3,553,456,97
060372676001,564.7,439.7,92.5,534,416,118
060372675012,607.1,498.2,74.6,519,428,91
060372640001,360.5,260.4,83.7,371,259,112
060372623032,444.3,318.0,109.5,505,347,158
060372640003,670.1,477.0,170.7,709,495,214
060372640002,732.9,551.1,152.2,720,512,208
060372623031,707.0,547.0,133.9,839,632,207
060372623022,626.7,466.3,131.5,803,554,249
060372643012,970.1,770.9,150.1,901,673,228
060372643013,807.4,642.1,127.0,711,510,201
060372643011,607.8,482.4,91.9,628,493,135
060372641021,1580.1,1235.7,278.7,1399,1087,312
060372641031,1156.2,919.0,176.4,1163,894,269
060377011001,130.3,88.5,35.0,166,126,40
060372674032,351.9,275.2,52.8,371,310,61
060372674031,985.0,813.4,118.5,936,753,183
060372654102,558.6,423.2,115.1,593,396,197
060372623021,1045.3,754.5,242.8,871,576,295
060372654101,371.0,298.6,60.8,270,185,85
060372654201,478.7,362.3,90.9,542,382,160
060372654202,574.3,434.7,109.1,556,390,166
060372721005,401.3,322.6,54.9,355,295,60
060372721004,475.7,382.4,65.1,509,413,96
060372721001,585.8,463.0,96.6,548,420,128
060372721003,441.9,350.6,66.7,451,353,98
060372714001,376.9,293.9,67.2,378,253,125
060372714003,1041.4,805.7,191.5,980,739,241
060372753023,1087.0,830.0,214.0,1091,760,331
060372754002,1279.1,1050.4,157.1,697,546,151
060372754001,686.9,545.6,101.9,636,512,124
060377028032,414.5,330.0,61.4,325,259,66
060377028033,487.1,387.7,72.1,570,460,110
060377028031,276.6,218.8,42.3,222,178,44
060372753022,1329.6,1038.7,239.4,1166,836,330
060372756021,4385.3,3572.1,625.9,2407,1757,650
060372753021,393.4,306.3,64.6,378,287,91
060372753112,589.8,479.0,74.1,613,474,139
060372753111,528.3,423.7,73.2,460,369,91
060372753113,591.9,485.8,67.7,506,403,103
060372722022,870.6,729.1,89.4,781,654,127
060372722021,456.4,386.6,45.8,439,363,76
060372721002,477.0,378.1,66.6,439,336,103
060372722012,469.3,372.4,63.6,414,352,62
060372722011,571.7,453.6,77.4,548,436,112
060372715002,363.6,290.1,53.5,441,330,111
060372719022,617.3,497.4,85.5,600,462,138
060372715003,763.9,585.2,132.7,794,576,218
060372723021,864.4,691.1,116.4,722,569,153
060372723022,747.3,598.5,100.2,658,540,118
060372719013,318.8,257.8,38.8,283,235,48
060372719023,1004.0,832.1,119.4,830,679,151
060372719021,421.2,342.6,58.0,440,345,95
060372719012,514.0,416.4,65.5,539,419,120
060377018024,346.6,283.8,40.5,293,258,35
060377015021,508.7,420.1,60.6,432,347,85
060377017022,521.3,433.3,48.4,465,404,61
060377017021,492.8,391.1,72.2,419,346,73
060377018022,486.2,406.0,50.4,434,373,61
060377018021,856.3,713.2,90.4,704,647,57
060377022013,601.7,481.2,77.4,605,509,96
060377022012,404.8,326.3,51.8,399,323,76
060377017013,232.7,181.5,38.6,224,171,53
060377016023,435.6,351.8,57.1,348,287,61
060377015011,925.8,748.6,133.6,896,726,170
060377016012,1075.6,851.5,180.5,1004,717,287
060377012021,959.1,759.5,158.0,873,689,184
060377016014,640.9,505.9,101.5,643,497,146
060377016013,390.9,311.7,61.0,458,363,95
060377016011,383.5,283.3,82.2,387,258,129
060377022011,634.9,504.4,92.1,571,461,110
060379103022,1346.1,515.9,756.7,1129,479,650
060379103011,1307.2,404.6,821.2,1281,430,851
060379012052,866.9,303.4,517.3,971,354,617
060379011011,1158.8,439.4,646.1,1017,489,528
060379103012,727.5,206.2,482.3,688,212,476
060379011012,975.2,348.3,555.5,843,318,525
060379011022,579.6,206.9,328.9,474,162,312
060379010103,498.7,263.9,205.4,486,240,246
060376016003,291.3,255.4,22.1,293,245,48
060376016002,386.8,339.1,29.4,309,256,53
060376016001,270.5,237.1,20.5,273,220,53
060376015021,456.5,421.6,19.6,450,394,56
060376015012,408.3,362.5,22.2,261,233,28
060376015022,171.5,158.4,7.4,169,144,25
060376015011,366.4,321.7,23.7,289,245,44
060376014022,419.0,354.9,43.8,379,309,70
060376014023,289.6,246.1,30.8,224,182,42
060376012022,389.0,339.5,33.4,381,321,60
060376012023,368.3,325.6,28.1,285,249,36
060372742024,473.6,384.2,65.7,330,270,60
060372739023,477.5,404.3,44.5,418,369,49
060372742022,607.0,459.9,112.6,621,488,133
060372742021,1065.6,815.9,192.6,1364,1022,342
060372742023,436.2,340.7,74.6,343,266,77
060377029013,1098.7,821.1,215.9,875,629,246
060372735022,213.5,184.1,16.9,241,228,13
060372734021,316.7,273.2,25.1,311,294,17
060372734023,368.3,315.6,28.0,401,369,32
060372735024,490.9,442.4,27.2,571,538,33
060372734024,437.9,369.2,41.7,450,402,48
060372734022,447.0,367.6,56.1,479,425,54
060377020022,759.6,642.5,66.8,680,588,92
060377021024,414.3,331.7,54.7,491,420,71
060377021021,765.1,584.5,132.8,759,588,171
060377020023,949.9,814.1,70.1,918,812,106
060377021025,392.6,327.2,37.1,378,346,32
060377021026,437.0,370.7,38.1,437,391,46
060377021027,968.9,819.0,91.5,970,845,125
060377021023,343.6,293.5,29.1,379,328,51
060377021022,360.0,306.8,31.8,352,311,41
060372733001,768.4,674.4,42.7,796,727,69
060377022021,524.7,432.6,62.1,409,358,51
060377022014,545.3,461.2,58.1,509,436,73
060377022015,386.5,326.9,41.2,371,318,53
060372735023,456.5,396.2,32.7,535,489,46
060372735021,291.2,247.8,23.4,293,269,24
060372739025,215.1,180.8,23.5,216,192,24
060372739022,393.7,330.8,43.2,534,455,79
060372739021,564.0,478.6,65.8,562,485,77
060372739024,608.2,511.8,67.5,577,501,76
060372733003,452.8,398.7,27.2,527,502,25
060372733002,359.1,326.7,15.0,326,307,19
060372732004,494.6,430.9,33.1,534,494,40
060372736002,320.4,287.5,20.1,343,312,31
060372736003,252.5,226.6,15.8,234,213,21
060372736004,478.5,427.8,29.6,506,458,48
060372738003,309.8,265.2,28.6,313,288,25
060372738002,462.8,399.4,42.4,445,399,46
060372741002,449.9,365.2,57.2,485,392,93
060372736001,283.7,253.2,17.5,284,267,17
060371393011,541.9,363.3,154.0,729,442,287
060371349051,1215.7,842.3,315.1,603,421,182
060371349042,430.0,303.6,102.0,425,298,127
060371340021,251.0,197.3,45.2,291,202,89
060371349041,997.0,737.0,212.9,730,554,176
060371340022,764.0,524.7,196.5,527,357,170
060371342011,344.0,236.3,88.5,432,263,169
060371348004,405.8,296.9,84.3,390,272,118
060371348003,496.1,357.1,109.7,388,267,121
060371348005,289.3,208.2,64.0,269,192,77
060371347203,342.6,254.8,67.3,365,258,107
060371347102,649.8,454.5,156.9,418,302,116
060371347202,594.3,426.0,133.1,496,351,145
060371347101,589.8,449.4,106.2,338,232,106
060371341042,522.1,383.0,112.8,591,417,174
060371349013,421.7,288.6,114.5,443,306,137
060371349011,588.4,401.9,159.1,498,358,140
060371348001,560.6,413.2,103.7,565,388,177
060371330002,678.8,508.1,139.2,490,344,146
060371348002,633.0,463.4,118.0,518,373,145
060371330003,441.0,333.7,80.2,378,275,103
060371330001,543.4,406.5,112.0,423,310,113
060371393012,474.6,296.0,155.8,415,264,151
060371349012,284.4,192.5,75.4,356,238,118
060371347201,447.2,316.6,106.0,424,277,147
060371398011,1854.1,1206.5,580.6,1965,1250,715
060371398021,2071.6,1301.8,696.5,2212,1371,841
060371397031,1171.3,691.6,437.2,1380,797,583
060372623011,1192.8,816.6,319.1,1250,821,429
060371397023,918.3,668.1,211.2,858,546,312
060371397021,648.6,475.3,144.2,656,447,209
060371394023,351.2,226.0,111.7,340,197,143
060371394022,433.9,274.3,142.2,387,222,165
060371394021,743.5,477.8,232.7,668,417,251
060371395021,694.9,441.3,220.6,698,449,249
060371394011,316.9,189.0,111.4,293,191,102
060371394012,682.7,470.4,180.9,536,391,145
060371393022,734.0,545.4,150.8,728,571,157
060371393032,454.3,323.0,106.3,377,276,101
060379108121,190.6,43.2,141.1,206,73,133
060379108052,1248.8,326.7,862.9,717,231,486
060379102051,614.8,246.2,350.0,518,216,302
060379108041,1691.7,443.4,1192.2,45,22,23
060379104011,1797.4,999.7,686.2,1368,794,574
060379104012,911.0,538.7,321.6,719,401,318
060379104042,692.1,478.1,166.0,607,386,221
060379104041,337.8,231.8,82.7,331,218,113
060379102082,1137.2,627.2,418.0,904,488,416
060379102072,741.8,439.3,264.0,674,349,325
060379104031,415.6,293.5,92.6,221,150,71
060379104021,354.6,256.0,71.0,342,259,83
060379107071,1348.0,910.6,357.2,1218,800,418
060379105052,468.9,329.6,112.8,409,273,136
060379105043,149.2,107.2,31.9,131,90,41
060379105051,381.6,268.2,91.8,328,207,121
060379105042,551.0,391.8,124.1,452,323,129
060379104022,314.4,227.0,63.0,184,136,48
060379105011,268.2,206.4,45.4,195,144,51
060379105012,345.7,251.5,73.3,215,174,41
060379105013,281.4,216.5,47.6,191,143,48
060379105041,373.4,267.7,79.8,367,231,136
060379105021,381.6,274.7,82.9,305,196,109
060379105022,410.8,295.3,88.7,325,219,106
060379106011,385.2,279.6,83.8,361,229,132
060374303025,466.3,264.3,164.7,529,301,228
060374303021,435.5,246.8,153.8,466,245,221
060374303024,635.9,370.7,220.0,621,368,253
060374311004,347.5,237.2,85.6,264,186,78
060374310011,408.6,266.7,118.0,381,250,131
060374309011,604.6,413.6,148.0,552,346,206
060374310013,676.5,453.9,165.7,531,335,196
060374311003,440.5,318.0,93.7,294,234,60
060374310012,665.9,439.3,167.8,554,383,171
060374303022,985.6,558.8,359.3,832,461,371
060374303023,556.0,306.1,209.6,497,275,222
060374303013,659.8,344.8,275.0,788,391,397
060374303011,486.6,249.3,206.8,589,302,287
060374303012,3.6,1.6,1.7,0,0,0
060374303014,1348.9,666.0,582.0,1278,639,639
060374310022,738.6,420.4,259.3,716,427,289
060374310021,824.9,477.6,282.0,809,489,320
060374302001,538.0,244.0,263.0,532,223,309
060379301011,38.0,23.1,14.4,101,61,40
060374004042,616.0,191.2,384.6,562,182,380
060374602001,555.0,453.3,67.7,614,531,83
060374603014,1138.3,864.0,210.3,1074,847,227
060374604011,437.0,365.0,51.0,481,420,61
060379108051,1009.2,277.4,674.7,273,92,181
060379108131,889.7,225.1,618.6,956,297,659
060378002032,1565.6,923.5,546.8,1751,1025,726
060379108132,977.0,277.4,643.0,812,269,543
060371883002,653.0,507.9,117.1,615,450,165
060379102073,900.4,427.4,421.9,847,404,443
060379102071,779.2,447.1,288.5,610,365,245
060371853201,541.0,471.9,47.5,477,419,58
060371853102,373.3,323.4,28.0,299,251,48
060371853101,658.8,571.0,51.4,445,397,48
060371853202,433.0,375.3,34.2,263,237,26
060371990002,331.6,278.7,30.2,258,212,46
060371990001,296.5,256.5,21.7,204,172,32
060371852021,455.4,393.1,34.9,451,385,66
060371992012,633.4,528.7,55.3,487,409,78
060371990003,476.8,400.8,43.3,292,229,63
060371994003,481.0,406.9,38.3,442,377,65
060371852023,380.7,329.2,28.3,385,328,57
060371994002,360.3,302.1,32.4,299,259,40
060371852022,615.5,527.4,54.3,564,499,65
060371852042,288.4,248.4,22.5,318,277,41
060371852041,535.7,444.9,62.2,650,469,181
060371863022,915.4,776.7,92.9,725,595,130
060371863023,676.7,566.0,79.6,552,450,102
060371851003,966.6,833.8,79.0,833,710,123
060371851001,878.2,695.4,145.6,863,673,190
060371993002,873.4,730.5,78.2,768,669,99
060371992022,394.1,329.0,38.2,330,288,42
060371991102,458.6,382.9,46.2,376,310,66
060371992021,415.1,346.8,41.0,399,336,63
060371994001,367.0,307.1,35.6,265,219,46
060371851002,1115.8,948.1,91.5,950,828,122
060371991101,455.0,376.1,47.4,314,265,49
060371993001,719.1,598.3,73.2,576,470,106
060371835201,497.8,428.2,34.6,496,406,90
060371835202,588.3,503.3,41.0,336,288,48
060371838201,454.8,375.6,47.5,270,228,42
060371838101,510.8,438.1,39.2,330,284,46
060371838102,558.9,470.0,49.6,407,327,80
060371838202,454.0,373.1,46.9,331,275,56
060371862011,1090.9,877.2,157.1,858,617,241
060371861003,910.0,676.6,175.0,826,596,230
060371862022,450.1,356.1,70.3,347,240,107
060371862021,310.5,244.2,51.7,369,262,107
060371862031,1003.7,821.5,128.2,786,614,172
060371834021,382.4,321.1,43.4,316,243,73
060371834011,510.5,433.7,50.1,510,400,110
060371813003,743.5,555.0,145.8,761,515,246
060371813001,516.9,394.7,94.9,506,362,144
060371814003,875.4,683.5,143.8,577,419,158
060371813002,467.2,341.4,101.1,422,299,123
060379200261,134.5,51.6,77.2,140,50,90
060379200331,217.5,91.4,113.2,203,87,116
060379108081,898.1,398.8,434.6,773,347,426
060379108101,1211.4,495.8,650.1,1322,600,722
060379200341,1186.8,568.1,559.5,1070,535,535
060379200373,298.9,212.6,62.2,184,141,43
060379200372,563.4,400.9,117.2,590,432,158
060379200371,524.7,293.5,188.6,410,216,194
060379200381,719.5,455.5,211.1,535,329,206
060379200382,462.7,276.2,151.3,482,274,208
060379200411,890.8,490.6,349.8,765,415,350
060379200431,2878.9,1557.5,1186.4,1832,905,927
060379200391,973.2,444.7,468.3,914,427,487
060379200342,399.7,207.0,167.1,243,116,127
060379108091,1313.3,394.9,856.8,1246,402,844
060379200401,1341.1,581.9,662.4,1181,561,620
060379108071,1479.7,763.4,617.9,1095,546,549
060379108072,1087.2,499.5,518.5,1319,615,704
060379108082,910.5,398.7,446.9,723,324,399
060373001004,776.3,457.9,257.3,903,471,432
060373001003,698.6,424.2,221.7,746,410,336
060373001002,718.2,424.5,255.9,613,317,296
060374606001,720.6,402.5,275.0,822,390,432
060373002002,423.4,252.4,149.2,518,287,231
060373001001,948.9,547.8,340.9,910,505,405
060373003011,767.2,433.8,290.9,796,440,356
060373003014,390.5,220.8,148.0,407,206,201
060379200312,1267.9,603.6,599.9,1119,549,570
060379200313,570.2,250.6,300.6,594,276,318
060379200423,497.4,255.4,220.8,450,194,256
060379200422,1024.2,596.5,367.1,942,584,358
060379200424,618.8,327.6,256.1,548,289,259
060379200361,318.4,172.4,123.6,326,151,175
060379200362,239.3,129.6,92.9,103,67,36
060379200364,333.2,180.4,129.3,279,150,129
060379200363,230.0,124.6,89.3,334,163,171
060379200292,408.4,201.5,183.5,484,249,235
060379200293,317.2,156.3,142.7,132,75,57
060379200311,253.3,156.0,79.8,257,140,117
060379200351,626.0,374.3,213.4,610,392,218
060379200352,358.0,214.0,122.6,349,212,137
060379200355,792.1,469.4,277.7,689,399,290
060379200354,364.9,204.1,132.4,369,200,169
060379200353,447.5,250.3,162.4,327,191,136
060371896001,846.3,722.1,72.5,843,747,96
060371896002,413.2,346.1,43.9,479,443,36
060371897012,539.5,437.2,82.6,531,441,90
060371895002,947.2,781.9,103.5,1028,892,136
060371941011,1527.9,1254.2,192.5,1698,1429,269
060371941021,680.7,515.3,129.6,663,472,191
060371897021,1135.4,943.0,133.4,1246,1087,159
060371437001,1323.0,1038.4,223.8,1208,940,268
060371437002,909.4,731.6,140.3,720,588,132
060371431003,1264.1,955.7,232.6,882,627,255
060371431002,838.6,584.1,205.3,633,414,219
060371431001,508.4,353.4,126.3,569,373,196
060371436042,882.2,695.7,132.8,551,447,104
060371927002,259.1,213.8,31.0,138,109,29
060373200001,0.0,0.0,0.0,0,0,0
060371897013,843.6,665.1,126.1,761,598,163
060371897011,419.4,328.7,74.7,416,333,83
060375719003,842.3,560.3,219.1,792,526,266
060371896003,609.0,529.5,60.1,587,521,66
060371924104,549.7,459.1,70.5,441,349,92
060371924103,368.3,306.3,47.7,318,270,48
060371908011,385.3,324.4,40.5,323,275,48
060371918101,374.6,326.9,26.2,214,198,16
060371908012,463.0,364.9,73.1,331,276,55
060371918102,287.0,249.2,21.5,221,204,17
060371909023,215.2,182.6,21.5,181,159,22
060371909021,426.8,362.2,42.6,375,310,65
060371909022,400.9,340.2,40.0,302,267,35
060371924101,492.9,419.2,52.1,525,435,90
060371924102,464.1,402.4,39.7,306,257,49
060371917101,238.6,203.2,25.3,253,188,65
060371917102,527.3,449.2,55.9,384,308,76
060371917201,421.7,360.5,39.3,337,270,67
060371924202,656.7,557.2,68.6,480,342,138
060371924201,425.3,360.8,44.4,289,227,62
060371917202,287.4,246.1,25.5,231,192,39
060371909013,254.3,213.7,27.0,212,172,40
060371909012,473.4,392.1,56.6,328,282,46
060371909011,157.2,132.1,16.7,132,108,24
060371910001,353.0,263.5,61.3,192,159,33
060371902011,676.1,536.8,79.9,419,356,63
060371902012,357.1,297.8,36.2,257,219,38
060371910002,636.2,526.0,66.1,389,347,42
060371910003,282.0,230.7,32.5,165,142,23
060371895001,1128.9,966.4,98.6,1224,1081,143
060371903013,660.4,471.7,154.5,433,346,87
060371903012,848.1,631.4,170.1,707,607,100
060371905101,692.2,535.8,109.3,452,401,51
060371905102,409.0,334.1,50.3,345,306,39
060371903011,654.0,506.8,109.7,437,380,57
060371925101,420.8,353.8,48.9,369,248,121
060371925102,511.0,431.0,58.4,352,275,77
060371916102,548.0,471.1,45.9,477,387,90
060371926102,221.1,186.8,20.2,176,144,32
060371925202,419.1,365.2,35.6,326,241,85
060371925201,609.1,526.9,53.2,502,410,92
060371926202,380.6,327.0,31.9,323,259,64
060371916101,674.0,572.0,63.0,410,331,79
060371066481,735.8,605.2,98.4,613,489,124
060371066043,164.4,137.0,19.8,91,77,14
060371066042,726.3,562.6,126.9,555,414,141
060371066492,517.7,405.5,91.1,489,346,143
060371066482,256.4,206.1,40.3,105,81,24
060371070201,1051.6,862.7,128.4,877,689,188
060371065203,426.7,331.5,72.1,321,255,66
060371065202,614.7,474.4,107.0,530,401,129
060371065102,684.4,497.7,144.4,540,377,163
060371064061,1268.2,824.1,378.1,1260,751,509
060371065201,658.7,487.0,136.6,618,445,173
060371064062,342.7,249.7,74.7,337,245,92
060371064051,383.5,306.2,60.3,344,265,79
060371064052,448.7,349.2,78.1,341,268,73
060371060101,1286.4,894.9,336.4,1167,775,392
060371066491,398.4,309.9,66.9,352,260,92
060371095003,440.6,331.8,78.7,338,271,67
060371091002,669.6,482.1,152.2,619,421,198
060373203003,295.8,246.9,32.1,220,182,38
060373203001,719.8,614.3,68.5,585,489,96
060373203006,309.4,266.8,29.4,266,227,39
060373203002,191.6,166.4,16.2,162,138,24
060373203004,298.7,254.5,33.6,212,177,35
060373203005,206.7,176.1,23.3,213,185,28
060371070202,347.8,279.6,47.5,336,271,65
060371070101,932.9,770.2,124.6,706,557,149
060373202012,465.3,348.8,86.9,292,236,56
060373202021,609.6,447.3,120.9,666,477,189
060371064032,349.9,279.5,49.6,254,208,46
060371064033,414.4,333.7,55.2,294,230,64
060373202022,453.4,363.8,67.7,435,340,95
060373202023,286.3,232.6,39.5,260,206,54
060373202013,297.7,242.2,40.8,206,170,36
060373202011,234.7,192.1,30.9,153,128,25
060373202024,313.1,256.2,41.3,321,259,62
060371043102,424.7,386.5,19.4,343,315,28
060371043101,296.3,269.5,13.6,216,195,21
060371064031,406.9,321.5,62.3,333,254,79
060373201001,645.8,508.9,100.0,454,345,109
060373201002,502.2,395.1,77.8,445,334,111
060373201003,629.2,499.6,92.7,433,337,96
060371061141,1084.6,889.6,133.7,879,691,188
060371064063,353.4,261.3,71.0,273,200,73
060371064053,369.5,298.4,54.8,242,214,28
060371064082,124.9,103.1,14.7,46,39,7
060371064081,508.5,419.8,59.8,373,309,64
060371064072,191.5,158.1,22.5,156,122,34
060371064071,415.2,338.8,50.9,226,186,40
060371060201,763.5,576.9,141.1,670,482,188
060371061131,788.5,570.8,169.0,508,367,141
060371060202,1213.0,888.8,256.6,1087,747,340
060371193421,705.3,583.0,81.6,450,343,107
060371193101,515.4,418.4,68.5,343,280,63
060371203002,439.1,328.5,86.3,358,250,108
060371203003,424.3,329.1,74.6,364,265,99
060371203001,328.8,242.7,73.7,244,171,73
060371204004,510.4,380.1,109.3,423,307,116
060371203004,601.7,480.3,96.9,401,297,104
060371199003,261.8,200.9,48.7,243,173,70
060371204003,337.1,258.7,62.6,269,194,75
060371199004,245.4,193.8,40.1,214,163,51
060371204002,209.5,160.8,38.9,135,95,40
060371197002,559.1,422.2,113.3,277,187,90
060371204001,712.8,539.3,138.2,490,361,129
060371197001,447.2,302.5,114.2,442,291,151
060371197003,573.7,441.4,111.8,457,329,128
060371198003,339.0,278.9,43.9,253,205,48
060371198005,365.9,296.0,51.6,308,248,60
060371198004,484.4,398.6,62.7,334,267,67
060371194004,466.5,375.8,70.2,402,303,99
060371192011,380.6,305.6,58.4,269,201,68
060371194001,285.7,226.4,47.1,228,171,57
060371194003,446.7,373.8,52.6,351,280,71
060371198001,373.2,301.5,52.9,313,252,61
060371194002,445.8,366.0,56.3,361,290,71
060371190024,476.8,387.8,65.1,271,228,43
060371198002,410.5,324.8,63.9,397,278,119
060371193102,433.4,348.6,61.5,357,272,85
060371096013,457.2,344.7,86.5,447,339,108
060371096012,435.6,305.0,112.3,337,225,112
060371096011,471.0,335.8,112.1,423,289,134
060371096014,490.7,361.1,102.9,415,289,126
060371192013,579.3,496.4,56.0,468,379,89
060371190025,430.0,364.9,44.3,319,272,47
060371192024,333.0,271.1,42.7,303,230,73
060371192021,259.0,210.9,33.3,89,71,18
060371192023,475.5,405.5,47.4,366,303,63
060371192022,347.5,296.5,34.6,292,249,43
060371094002,429.5,333.2,70.6,289,210,79
060371094001,450.1,339.1,84.6,412,318,94
060371095002,571.3,473.6,67.8,443,367,76
060371095001,363.7,301.4,43.2,322,281,41
060371192012,377.5,308.4,48.5,343,272,71
060371190022,387.6,324.9,43.1,265,210,55
060371190021,360.5,302.9,39.4,303,258,45
060371044031,454.0,394.8,37.1,199,173,26
060371044042,408.9,355.6,30.2,337,288,49
060371044032,320.9,284.4,23.5,267,225,42
060371045001,256.6,221.5,21.6,158,133,25
060371045002,514.0,449.6,40.9,101,90,11
060371048221,571.9,478.7,59.3,268,205,63
060371044012,435.3,384.3,30.2,335,297,38
060371044011,362.7,315.5,28.7,247,221,26
060371043103,447.5,389.4,36.9,352,310,42
060371044041,305.8,265.4,21.0,271,236,35
060371043204,217.2,193.9,13.1,184,167,17
060371092002,524.9,352.1,144.7,489,292,197
060371092003,344.8,236.6,90.0,180,124,56
060371092001,336.0,230.6,87.7,304,216,88
060371066041,118.4,91.4,22.1,123,93,30
060371096041,265.3,192.6,58.2,283,194,89
060371091001,334.7,226.8,91.8,428,262,166
060371175201,540.7,451.0,66.1,326,262,64
060371174071,337.2,283.1,38.0,236,188,48
060371175101,568.9,477.0,66.3,413,320,93
060371174051,357.2,302.8,36.7,196,160,36
060371172011,556.5,438.9,87.5,425,334,91
060371171012,777.2,590.2,144.7,571,411,160
060371171011,633.3,466.9,131.7,451,319,132
060371173011,681.0,406.0,229.0,653,399,254
060371098001,451.3,288.4,143.5,439,279,160
060371172022,493.6,325.8,143.6,391,249,142
060371172021,651.6,429.6,186.7,547,339,208
060371098002,384.6,258.4,100.7,374,252,122
060371098004,513.8,345.3,134.6,437,284,153
060371097002,814.4,547.8,199.7,769,503,266
060371097003,419.7,294.0,101.8,427,263,164
060371093001,450.4,283.3,141.9,343,214,129
060371093002,578.5,377.0,169.8,483,307,176
060371097001,629.9,445.2,152.5,507,324,183
060371172012,423.9,323.6,84.4,365,253,112
060371171022,542.5,406.3,111.8,488,336,152
060371096033,482.7,350.4,105.8,359,255,104
060371171021,481.6,345.1,106.9,436,309,127
060371096032,516.3,367.1,113.1,435,308,127
060371096031,570.1,399.1,125.0,474,333,141
060371096042,373.7,269.9,81.8,366,241,125
060371096043,508.5,359.4,122.6,444,281,163
060371094003,409.0,298.8,86.7,261,187,74
060371200301,458.1,381.6,44.3,208,159,49
060371200201,499.8,411.9,58.6,392,310,82
060371873001,883.0,784.8,59.7,770,661,109
060371200202,320.0,260.5,45.1,171,143,28
060371201061,508.3,416.3,73.7,356,276,80
060371201041,366.3,297.0,50.9,291,219,72
060371201071,434.0,361.3,48.0,319,246,73
060371201051,472.4,371.2,76.8,373,291,82
060371201082,382.1,315.7,45.8,359,290,69
060371201031,440.0,363.5,52.7,189,160,29
060371193401,497.1,409.6,58.3,238,194,44
060371201081,286.9,236.4,33.7,268,212,56
060371193201,867.0,727.0,91.0,562,454,108
060371199002,634.3,497.4,106.0,465,338,127
060371201052,304.8,235.5,54.2,272,189,83
060371199001,458.2,367.0,69.5,324,253,71
060371193411,684.0,527.0,120.0,551,390,161
060371255011,734.7,604.1,83.8,115,97,18
060371255012,672.5,551.7,79.9,613,495,118
060371254012,960.9,783.2,107.1,290,238,52
060371253202,1064.1,877.3,123.0,193,160,33
060371253201,701.7,581.5,70.7,417,327,90
060371253103,809.5,676.6,77.7,109,94,15
060371256001,479.4,336.1,121.9,453,318,135
060371253102,354.6,279.1,51.1,355,275,80
060371253101,454.2,358.5,67.6,295,229,66
060371243003,575.5,461.4,74.4,3,1,2
060371243001,334.8,272.3,40.4,223,187,36
060371243002,477.7,383.7,61.3,44,35,9
060371241041,500.4,399.1,66.1,7,4,3
060371241042,207.9,165.8,27.5,89,76,13
060371241032,334.1,264.3,49.5,7,6,1
060371242012,381.6,299.1,60.5,67,51,16
060371241051,315.1,248.9,47.8,146,116,30
060371241052,362.0,285.8,54.9,2,2,0
060371242032,436.7,363.3,47.8,182,153,29
060371241021,387.6,320.9,43.8,249,202,47
060371241022,402.7,330.4,48.2,281,225,56
060371242031,194.2,161.5,21.2,141,113,28
060371241031,192.1,151.1,30.5,203,171,32
060371242013,224.5,176.6,35.6,207,156,51
060371232051,328.0,278.4,32.9,228,189,39
060371232061,691.6,562.2,91.9,552,460,92
060371232052,187.6,159.3,18.8,128,100,28
060371232032,178.4,151.8,16.8,122,105,17
060371232031,278.3,236.9,26.1,199,171,28
060371232041,496.3,404.4,64.5,343,295,48
060371224202,696.2,587.1,81.6,536,431,105
060371224201,461.4,384.3,53.7,435,355,80
060371219001,544.0,450.9,63.0,490,418,72
060371230102,419.8,355.5,41.5,311,261,50
060371221201,583.8,485.4,66.8,438,353,85
060371221202,755.0,619.6,100.3,602,475,127
060371231043,463.8,355.4,82.1,128,98,30
060371231041,373.0,292.9,55.9,317,252,65
060371231042,511.8,403.7,74.0,249,195,54
060371242011,414.4,319.5,70.8,257,190,67
060371231031,535.1,416.8,85.7,648,465,183
060371231032,707.3,539.2,131.3,211,164,47
060371230202,339.1,283.0,35.7,278,236,42
060371230101,492.0,418.3,47.4,401,327,74
060371230201,548.2,453.3,60.2,431,355,76
060371274001,183.7,147.7,26.6,104,79,25
060371274004,270.8,217.8,39.2,178,144,34
060371174043,794.0,549.0,189.0,739,502,237
060371173012,608.4,398.4,173.7,604,383,221
060371173013,422.3,287.2,111.0,487,313,174
060371174042,445.8,263.2,157.4,423,234,189
060371174041,494.2,291.8,174.6,436,264,172
060371273001,656.7,488.0,133.6,541,396,145
060371174081,452.4,361.9,66.8,339,265,74
060371175302,582.8,462.0,85.7,470,365,105
060371175301,383.8,305.1,56.5,228,190,38
060371275202,229.5,195.7,23.0,130,115,15
060371200101,281.5,235.3,32.2,271,228,43
060371275201,284.2,242.4,28.5,142,119,23
060371200102,435.8,356.5,56.4,328,256,72
060372612001,1495.9,1036.3,391.4,1644,1207,437
060372621001,388.3,269.1,105.4,369,242,127
060372621002,348.7,240.8,97.3,345,204,141
060372612002,732.7,502.0,205.3,890,604,286
060377007002,358.1,162.3,183.6,480,208,272
060372621003,909.6,614.6,256.1,1136,716,420
060372611022,1490.9,1015.1,418.8,1927,1271,656
060371417003,208.0,147.6,50.8,329,242,87
060371416001,769.3,556.2,174.6,1088,777,311
060371417002,523.6,377.7,127.4,964,691,273
060371417001,964.2,744.5,190.0,478,353,125
060371439022,1000.0,778.0,180.8,867,658,209
060371415001,1656.2,1192.1,396.0,1766,1165,601
060371414002,629.3,419.5,182.1,649,408,241
060371414001,731.9,541.3,150.2,701,549,152
060371414003,1038.1,709.7,271.8,1024,686,338
060371390011,668.5,514.2,115.9,573,441,132
060371284004,521.9,399.9,89.6,385,300,85
060371413023,1596.5,1227.0,302.8,1330,993,337
060371413041,890.6,684.5,162.9,883,687,196
060371413022,635.5,492.0,112.6,631,475,156
060371413021,659.7,514.5,118.8,519,395,124
060371413031,1397.0,1056.8,261.2,1230,940,290
060371288012,899.6,686.1,166.2,832,626,206
060371289103,812.3,609.3,161.1,534,396,138
060371288011,537.0,406.2,100.4,462,363,99
060371289101,679.5,498.3,146.3,584,431,153
060371288022,674.0,547.0,94.4,637,508,129
060371288021,765.9,610.4,112.5,668,518,150
060371284003,430.2,329.7,73.8,427,335,92
060371276052,538.3,452.5,59.0,390,318,72
060371276051,164.7,138.5,18.0,208,159,49
060371276061,261.7,204.3,40.0,342,275,67
060371276062,700.3,546.7,107.0,514,404,110
060371276031,496.3,374.9,90.2,233,187,46
060371276041,673.9,500.8,130.0,681,510,171
060371276032,204.5,149.4,41.8,228,183,45
060371283021,720.1,564.1,111.7,520,440,80
060371277112,230.2,178.7,37.4,291,214,77
060371277111,720.6,535.3,141.9,640,478,162
060371278063,327.3,258.2,54.2,279,227,52
060371278062,264.7,208.8,43.8,209,182,27
060374072001,528.1,420.6,81.6,570,452,118
060374072002,380.4,303.0,58.7,347,276,71
060374071013,287.9,237.2,40.0,265,213,52
060374071014,525.1,432.8,73.0,462,375,87
060374083011,1090.6,842.4,192.9,999,730,269
060374070022,572.4,467.3,76.1,484,400,84
060374078021,701.1,531.7,129.5,627,487,140
060374082021,327.9,245.6,66.6,244,165,79
060374070021,484.0,388.0,70.0,404,304,100
060374070011,338.8,278.9,41.6,289,240,49
060374047031,118.9,97.9,14.2,38,30,8
060374081381,369.3,317.5,33.7,247,209,38
060374047032,611.0,503.1,73.0,481,405,76
060374047013,242.1,200.5,30.0,223,176,47
060374047012,272.2,227.3,33.2,278,226,52
060374047021,589.8,479.2,74.3,531,397,134
060374047022,452.7,371.2,56.7,420,322,98
060374047014,230.9,185.8,29.8,222,185,37
060374047011,629.0,502.6,81.7,565,434,131
060374070012,578.6,469.3,81.3,489,383,106
060374047023,321.3,263.4,40.3,300,233,67
060374071022,612.2,500.1,81.1,488,374,114
060374071011,286.5,224.3,47.5,276,205,71
060374071012,262.2,208.3,41.3,238,177,61
060374071021,427.6,336.4,69.6,441,335,106
060374069013,485.0,377.5,80.7,449,342,107
060374073011,361.6,285.6,56.6,338,245,93
060374069022,286.6,227.6,44.3,254,204,50
060374070013,667.6,546.1,87.8,562,449,113
060374069012,608.6,475.7,98.4,530,417,113
060374069021,483.4,373.1,82.0,549,414,135
060374048022,421.2,334.3,69.0,434,335,99
060374048013,385.8,307.0,63.6,381,300,81
060374069011,293.6,200.9,75.6,290,189,101
060374048031,422.3,340.5,57.2,400,293,107
060374048021,648.1,515.6,94.7,532,417,115
060372622001,1973.3,1315.6,564.9,1837,1112,725
060372622002,526.8,372.0,123.6,600,384,216
060371416003,652.5,505.4,116.9,772,553,219
060371416002,1018.7,779.6,197.8,567,419,148
060375440013,407.8,321.0,67.6,315,235,80
060375440011,238.9,189.2,38.3,224,171,53
060375433062,541.2,388.8,132.7,554,383,171
060379800251,0.0,0.0,0.0,2,1,1
060375440014,414.8,333.7,61.1,383,302,81
060375724001,468.7,397.8,49.1,474,410,64
060375723021,303.3,257.3,31.1,274,227,47
060375721001,297.3,197.6,79.9,382,256,126
060375720022,954.8,703.7,200.0,748,573,175
060375722013,872.0,613.5,206.1,826,571,255
060375718001,716.6,455.1,216.4,803,428,375
060375718002,684.6,430.7,210.5,718,424,294
060375717013,749.0,594.0,116.0,528,396,132
060375433051,1126.9,861.5,212.2,1120,842,278
060375704022,413.1,376.3,26.5,520,478,42
060375432021,202.7,190.3,6.0,226,222,4
060375432022,265.4,249.2,7.8,213,200,13
060375432024,237.1,217.1,11.0,258,245,13
060375424021,419.6,386.3,17.9,363,354,9
060375424022,263.9,239.3,11.7,323,313,10
060375424023,374.6,340.6,16.6,362,350,12
060375717011,404.5,328.0,53.2,397,311,86
060375703042,461.9,382.3,54.3,382,322,60
060375717012,468.5,377.8,64.9,422,325,97
060375703043,291.1,239.3,35.7,235,197,38
060375703012,254.5,206.0,37.5,283,223,60
060375704042,517.2,443.2,46.4,421,375,46
060375704021,556.8,465.7,62.8,486,425,61
060375704032,319.9,281.7,21.2,322,292,30
060375704033,378.2,332.3,27.0,219,197,22
060375704031,315.2,270.1,28.9,214,193,21
060375704023,443.3,360.9,56.5,367,314,53
060375704041,410.2,350.8,37.8,446,406,40
060375720021,551.4,370.4,147.7,495,301,194
060375720023,493.6,331.6,132.3,527,338,189
060375722012,327.6,243.0,66.3,355,272,83
060375720014,684.4,474.2,162.9,634,448,186
060375720012,623.5,440.4,142.7,623,432,191
060375719004,732.6,464.1,210.5,677,423,254
060375718003,367.9,235.8,105.1,317,196,121
060375717043,403.0,312.3,66.8,329,254,75
060375715024,311.8,204.8,87.8,203,151,52
060375715023,676.2,478.4,161.6,624,461,163
060375717032,287.4,235.4,40.1,345,264,81
061110084021,1132.8,480.5,588.2,975,475,500
061110085003,1559.7,706.2,751.4,1393,643,750
061110084022,748.8,292.1,411.3,798,313,485
061110084013,987.5,418.4,510.4,684,352,332
061110084011,983.3,436.5,488.3,920,460,460
061110085001,1306.3,548.0,679.1,1367,586,781
061110082021,628.6,315.5,273.9,942,497,445
061110084023,422.6,166.2,231.1,476,208,268
061110084012,624.7,272.8,317.1,664,316,348
061110084024,368.6,160.9,187.1,390,177,213
061110083051,1917.0,800.9,1002.5,2042,931,1111
061110083032,1267.9,608.0,577.7,1024,506,518
061110083022,979.1,497.9,423.0,1554,806,748
061110082012,869.4,418.5,400.5,786,371,415
061110083063,575.7,298.4,244.4,960,518,442
061110083062,311.7,161.6,132.3,285,164,121
060371132351,853.0,482.8,318.6,779,480,299
060371132311,846.7,471.7,321.6,823,442,381
060371344241,789.1,497.3,251.3,890,515,375
061110083041,971.9,443.1,465.0,424,204,220
061110083031,484.1,226.2,225.3,692,350,342
061110083043,822.8,348.3,423.8,800,358,442
061110083042,984.1,418.5,505.4,947,467,480
060371344231,925.7,525.7,357.1,925,518,407
060371344232,922.0,522.0,351.0,919,538,381
060371343023,587.9,360.2,188.9,563,329,234
060371343021,392.3,240.9,129.2,393,242,151
060371343022,739.8,454.9,246.8,718,439,279
060371132321,1080.8,651.6,376.6,1185,667,518
060371132312,305.0,173.2,113.5,310,160,150
060379800231,4.9,2.7,1.9,13,6,7
061110075121,1804.0,818.5,851.8,1341,698,643
060371132371,1382.9,771.4,543.4,1053,603,450
060371132112,960.7,546.6,361.3,1097,660,437
060371132111,815.3,450.0,319.1,1094,555,539
061110083061,323.1,134.7,169.2,333,141,192
061110083021,1273.1,605.1,582.2,1109,523,586
060378001022,1288.1,1016.6,182.7,1274,1069,205
060378001021,1223.4,923.6,209.4,1510,1191,319
060378001012,1556.5,1013.6,462.1,1619,1042,577
060378001011,1551.1,1053.6,439.1,1518,973,545
060371375041,713.9,447.2,234.7,1140,705,435
060371374012,791.8,547.3,208.8,747,508,239
060371374013,930.1,624.4,255.7,918,643,275
060371374021,1225.1,834.2,331.0,1229,814,415
060371380003,930.6,637.2,249.5,875,622,253
060371380001,1070.7,724.9,290.4,1196,809,387
060371373021,941.5,625.8,277.4,1026,632,394
060371373022,1429.7,928.5,441.4,1514,929,585
060371352031,1159.5,711.9,393.5,1227,783,444
060371352032,432.2,266.0,143.8,437,272,165
060371373011,1237.6,768.2,410.1,1242,748,494
060371352012,377.2,223.1,134.4,383,228,155
060371352023,842.4,527.4,270.5,848,533,315
060371352033,763.8,484.4,244.7,690,424,266
060371352021,531.5,329.8,172.3,556,328,228
060371352022,658.2,410.8,211.0,665,426,239
060371344211,2116.9,1327.8,692.8,2156,1339,817
060371344242,784.2,492.0,272.6,739,470,269
060371344222,1516.7,938.0,503.5,1521,857,664
060371352011,885.3,578.5,256.0,798,528,270
060371351022,635.8,382.1,219.7,646,414,232
060371351023,516.0,308.5,182.0,463,296,167
060371372013,654.2,413.7,200.0,709,445,264
060379304011,1251.4,800.4,395.2,1252,819,433
060371344221,776.5,469.8,262.8,716,448,268
060371351021,528.2,332.1,163.6,518,327,191
060371343034,696.3,452.4,207.7,690,452,238
061110075072,386.2,123.2,244.7,566,184,382
061110075131,934.8,310.8,570.6,955,330,625
061110075141,997.8,481.0,470.6,612,316,296
061110075111,890.0,498.5,353.2,854,448,406
061110075065,899.0,391.1,451.5,716,321,395
061110075063,554.1,249.3,265.4,530,275,255
061110080041,793.4,356.6,380.0,667,338,329
061110080043,363.6,165.3,172.1,340,156,184
061110080012,633.1,295.2,298.6,725,358,367
061110080011,674.7,313.1,319.3,713,329,384
061110080022,1109.1,482.4,559.3,878,437,441
061110079042,502.5,222.4,245.9,501,219,282
061110079045,379.7,166.7,187.3,331,158,173
061110079043,686.2,303.7,335.9,734,306,428
061110079044,275.1,120.8,135.7,215,110,105
061110075122,1318.7,578.1,659.7,1079,519,560
061110080021,700.1,299.3,358.8,706,351,355
061110081012,1475.7,660.0,719.1,645,330,315
061110080023,356.0,164.0,171.2,185,111,74
061110082011,750.5,345.7,361.0,646,321,325
061110075112,339.3,181.4,130.6,289,168,121
061110079031,2334.9,1029.8,1168.2,2251,1050,1201
061110085002,1548.3,594.7,859.9,1514,650,864
061110082023,850.5,426.8,370.5,766,416,350
061110082022,561.2,281.6,244.5,567,317,250
060378003293,1127.6,708.3,344.2,882,519,363
060378002041,1087.9,668.0,359.6,832,516,316
060378002022,2482.3,1539.8,815.2,2695,1664,1031
060378002021,535.2,364.8,145.1,227,131,96
060378003271,951.0,551.6,352.5,745,441,304
060378003241,527.3,331.4,171.9,863,516,347
060378003272,488.9,279.7,184.6,579,323,256
060378003273,812.4,464.6,306.2,841,514,327
060378003324,805.4,496.5,279.6,821,478,343
060378003281,678.3,370.7,256.6,619,359,260
060378003292,1510.5,870.7,539.8,1200,671,529
060378003282,528.5,310.2,187.9,382,241,141
061110074053,691.1,405.8,250.9,826,508,318
060378002042,1510.9,948.6,506.4,1574,959,615
060378002031,1103.6,639.6,407.7,1140,585,555
060371352035,494.0,284.0,191.0,519,290,229
060371352034,444.0,310.0,123.0,432,293,139
060371352036,340.0,224.0,98.0,386,251,135
060378002043,1189.4,789.2,355.9,1227,815,412
060371374022,728.7,495.4,194.4,783,507,276
060371374023,790.0,550.4,197.2,715,501,214
061110077003,666.9,333.9,281.9,727,364,363
061110077002,705.1,353.1,298.1,477,281,196
061110077001,1032.9,508.5,452.6,923,473,450
061110075064,1200.6,422.1,716.5,1242,479,763
061110075091,900.3,485.8,370.7,839,442,397
061110075061,563.5,205.1,330.0,1120,518,602
061110075062,753.7,334.8,378.9,964,392,572
061110075073,1989.5,896.0,982.3,2019,906,1113
061110075052,956.7,393.2,504.8,944,436,508
061110075051,770.7,329.3,390.1,520,247,273
061110078002,404.7,209.1,173.7,534,270,264
061110078001,681.3,351.9,292.3,569,306,263
061110079013,707.7,348.2,306.3,654,335,319
061110079012,413.0,208.3,174.7,353,194,159
061110080051,657.0,309.0,300.6,629,311,318
061110080052,380.3,179.8,171.7,392,198,194
061110080044,377.6,177.3,171.1,224,120,104
061110080042,483.4,223.0,225.7,509,254,255
061110076142,1032.9,511.5,443.9,1090,555,535
061110079011,831.4,431.1,342.4,790,413,377
061110079041,781.5,348.3,380.1,640,296,344
061110005001,586.5,349.4,206.5,712,421,291
061110003021,695.0,395.6,267.7,633,320,313
061110003033,637.8,367.9,239.9,600,313,287
061110003041,341.6,149.4,165.5,349,158,191
061110004001,263.3,162.0,91.2,538,293,245
061110051003,1036.2,441.6,539.7,885,383,502
061110003023,913.5,579.2,279.7,754,517,237
061110003031,527.5,339.4,160.9,538,373,165
061110003032,589.1,379.1,179.7,591,375,216
061110003043,266.8,171.7,81.4,247,165,82
061110003022,840.6,453.0,337.1,1157,615,542
061110003042,754.0,482.5,233.4,502,326,176
061110076141,644.3,361.5,250.7,622,343,279
061110002002,355.3,259.9,72.9,237,181,56
060378003301,544.6,327.0,181.6,143,80,63
060378004101,1102.2,707.2,305.3,1226,754,472
060378003291,598.8,300.2,262.5,305,169,136
061110072022,567.0,280.3,258.1,1032,459,573
061110071002,1036.3,569.1,407.5,863,461,402
061110059062,1231.2,653.7,518.9,1402,776,626
061110071001,576.9,365.8,183.9,368,213,155
061110059072,586.8,311.6,254.3,670,338,332
061110059071,1044.8,574.2,430.5,670,367,303
061110059073,860.5,462.1,344.4,1401,770,631
061110074022,1534.3,809.5,651.6,981,439,542
061110059061,706.5,395.5,279.6,795,424,371
061110071003,644.6,384.1,228.4,606,355,251
061110075082,1248.3,687.5,476.5,1203,655,548
061110075092,1254.4,702.1,479.5,1289,710,579
061110072021,1423.4,698.5,651.5,1825,894,931
060378003262,555.8,301.3,212.1,580,342,238
060378004061,652.9,416.5,196.4,775,512,263
060378003251,907.4,495.9,371.1,1019,563,456
060378003252,1132.0,594.4,484.9,1146,565,581
060378003261,888.2,489.5,342.6,1109,645,464
060378003243,820.6,520.6,256.6,955,577,378
060378003242,993.2,589.7,341.4,911,543,368
060378003325,763.4,477.0,248.1,790,470,320
060378003311,329.6,178.1,135.2,380,214,166
060378003322,670.9,377.9,249.3,610,360,250
060378003323,354.6,197.6,133.9,366,223,143
061110074021,1408.8,673.1,663.5,1803,809,994
061110074023,769.4,377.1,351.1,1060,581,479
060378003244,1247.1,749.7,440.0,1043,641,402
060378003326,698.1,433.4,239.7,761,444,317
061110074033,1393.6,830.3,490.2,1273,749,524
061110074052,1180.1,711.3,399.5,952,583,369
060378003321,762.7,446.1,275.7,664,378,286
061110074051,1338.1,805.1,463.2,1646,1021,625
061110074061,1196.1,733.3,400.8,1314,776,538
061110074032,1096.8,672.4,367.5,1067,670,397
061110074031,599.1,367.3,200.7,661,415,246
061110066001,763.7,371.0,349.2,862,432,430
061110063021,954.5,479.3,426.7,616,318,298
061110065002,879.1,460.0,355.9,742,389,353
061110063022,848.5,436.7,369.7,850,417,433
061110066002,1042.0,490.4,491.9,997,466,531
061110066003,358.1,171.5,165.7,399,177,222
061110075101,1291.9,667.3,556.9,1175,593,582
061110059113,846.0,423.5,373.6,960,510,450
061110059063,796.8,370.2,378.5,820,364,456
061110059112,477.0,251.3,197.5,409,230,179
061110059092,814.0,407.5,359.4,824,419,405
061110059091,1146.0,578.9,518.6,976,548,428
061110069001,493.8,298.0,170.5,599,356,243
061110069002,1081.1,584.7,437.7,1043,563,480
061110067002,1381.1,773.3,530.5,1315,703,612
061110053032,1553.4,751.0,691.8,1681,848,833
061110053043,898.0,458.6,389.1,514,274,240
061110053042,801.7,412.2,346.9,381,213,168
061110053031,3109.2,1531.7,1365.4,2978,1443,1535
061110053062,1590.8,721.1,768.8,1618,764,854
061110053041,1643.9,858.6,718.0,2350,1293,1057
061110053061,1124.9,511.9,538.1,1185,539,646
061110052021,423.9,181.1,218.9,368,158,210
061110052022,1125.7,509.6,541.2,1136,524,612
061110051001,330.4,133.0,176.6,461,181,280
061110063013,578.1,324.0,224.9,816,465,351
061110063012,1748.7,895.3,749.5,1544,815,729
061110076072,1875.0,912.5,861.7,1869,892,977
061110076122,916.4,442.7,420.2,893,410,483
061110008004,556.2,323.0,206.1,562,311,251
061110007021,613.7,399.5,177.2,533,344,189
061110007022,667.9,433.8,193.9,667,409,258
061110008002,1178.1,746.7,368.9,1321,794,527
061110009033,546.9,304.8,194.5,461,284,177
061110009021,236.2,124.5,91.3,327,194,133
061110007013,455.5,323.7,107.5,313,232,81
061110007011,800.5,545.7,215.9,536,371,165
061110007012,500.8,348.2,127.1,393,263,130
061110006002,233.6,175.6,45.2,242,171,71
061110008001,413.7,253.4,137.8,307,196,111
061110006001,305.3,184.9,103.9,246,168,78
061110006003,523.3,413.4,82.2,389,312,77
061110006004,270.3,210.4,47.5,207,180,27
061110010021,756.9,430.6,267.8,830,486,344
061110004004,419.9,367.5,37.1,381,326,55
061110004003,971.8,616.6,309.4,749,505,244
061110004002,408.6,228.9,159.1,429,232,197
060378004062,302.7,183.9,101.1,297,193,104
060378004063,360.1,219.2,119.8,244,143,101
060379901000,0.0,0.0,0.0,0,0,0
060378004084,790.5,510.7,238.5,1014,622,392
060378004083,818.4,510.5,269.6,836,539,297
060378003263,1295.9,703.7,521.8,1070,525,545
060378004082,1511.7,1004.1,402.2,1536,1044,492
060378004081,513.8,324.3,161.2,559,366,193
061110052052,1422.7,696.0,644.9,1681,779,902
061110055023,742.9,454.0,226.2,604,366,238
061110055022,738.1,451.0,224.8,474,284,190
061110052051,1663.2,653.5,924.3,1666,672,994
061110052041,1242.4,523.7,644.6,1208,507,701
061110055032,985.5,426.4,491.0,884,374,510
061110055041,1047.1,486.4,483.8,1155,509,646
061110052042,825.5,394.0,374.9,862,403,459
061110052032,1125.0,495.6,543.0,1203,570,633
061110051002,240.5,133.1,93.9,439,250,189
061110055021,630.0,314.0,267.0,634,329,305
061110054031,985.2,590.5,318.5,915,538,377
061110055042,1132.9,530.2,518.5,1146,591,555
061110054012,1250.1,539.2,621.3,1153,552,601
061110052031,1345.4,641.1,615.7,1399,692,707
061110052033,541.3,254.5,251.3,592,273,319
061110054011,883.4,380.7,439.4,932,453,479
061110054042,874.8,409.5,395.5,884,456,428
061110054041,1069.0,524.0,461.0,1123,557,566
061110047041,57.8,32.2,22.2,58,36,22
061110047171,457.7,361.6,70.0,432,305,127
061110049021,560.1,490.4,44.7,447,402,45
061110057001,807.0,532.0,203.0,268,182,86
061110050021,454.0,369.6,64.4,387,289,98
061110055031,599.1,302.2,260.3,271,149,122
061110013021,716.8,408.7,268.0,682,382,300
061110008003,803.4,544.1,234.0,785,509,276
061110012012,974.9,551.6,362.0,793,404,389
061110016021,957.1,559.2,324.5,905,564,341
061110016022,487.7,285.0,166.6,540,317,223
061110015024,752.4,460.4,246.1,1026,596,430
061110015023,624.7,386.0,198.7,664,420,244
061110015022,639.0,390.9,205.3,643,429,214
061110015021,1074.9,643.8,372.8,1222,788,434
061110015031,1445.7,861.8,489.8,1084,629,455
061110020002,525.8,331.6,155.5,596,401,195
061110020001,545.2,343.4,161.5,508,327,181
061110019003,253.6,174.2,62.6,308,194,114
061110019002,639.7,429.9,166.4,696,469,227
061110027001,666.2,422.4,193.6,652,460,192
061110019001,355.7,228.7,102.0,330,227,103
061110019005,303.3,190.5,91.1,342,219,123
061110019004,513.1,318.1,158.9,611,350,261
061110018002,1213.6,715.6,417.3,1065,608,457
061110018001,387.3,232.9,132.7,412,237,175
061110018003,562.2,336.7,194.3,615,359,256
061110018004,551.8,322.5,198.6,599,356,243
061110017002,435.9,232.0,177.3,567,307,260
061110016011,512.7,276.9,202.3,413,258,155
061110017001,2037.1,1052.9,860.3,1930,1018,912
061110029052,1170.5,777.4,326.8,949,636,313
061110029051,1111.5,738.6,309.2,1319,825,494
061110029011,1675.2,1015.3,558.6,1715,987,728
061110029012,874.8,532.7,297.4,732,469,263
061110033005,379.6,265.4,91.3,259,193,66
061110033004,577.8,412.3,131.5,616,444,172
061110033003,356.6,246.5,88.1,247,193,54
061110033002,701.1,505.8,157.1,783,523,260
061110033001,473.8,343.4,106.4,315,221,94
061110030112,626.1,489.8,104.8,503,370,133
061110030111,843.8,629.6,170.1,770,574,196
061110030101,889.6,648.9,190.9,898,625,273
061110030131,835.5,553.4,234.6,801,491,310
061110030132,749.0,491.0,196.0,711,453,258
061110030121,138.9,84.3,45.7,84,63,21
061110031001,1822.0,1343.0,384.0,1618,1193,425
061110015072,880.1,485.5,331.8,833,507,326
061110015073,676.6,391.6,236.6,630,389,241
061110015063,891.5,470.6,353.3,1041,569,472
061110014021,1109.8,584.3,452.0,1172,616,556
061110015071,461.4,237.1,179.0,322,191,131
061110015032,591.2,339.2,208.8,567,371,196
061110015033,366.4,200.4,139.0,320,195,125
061110015061,895.9,453.9,383.6,958,528,430
061110015062,536.3,282.1,212.8,583,345,238
061110014012,1209.0,608.9,515.7,1244,639,605
061110014011,810.6,428.5,318.9,789,456,333
061110014023,783.9,427.7,305.5,871,479,392
061110031002,3093.8,2326.1,612.8,2447,1757,690
061110010013,315.2,147.7,147.3,260,159,101
061110011011,1303.4,686.5,522.7,1368,777,591
061110011012,818.6,427.8,315.9,766,422,344
061110010012,595.9,293.5,261.4,567,308,259
061110011022,806.9,390.6,353.1,782,424,358
061110011021,1124.2,597.3,451.5,1135,642,493
061110010022,757.9,394.5,301.8,744,406,338
061110010023,1261.9,719.6,447.3,1087,649,438
061110010024,672.1,418.5,202.1,671,444,227
061110009011,1070.3,736.2,258.7,1195,791,404
061110009012,421.8,277.7,116.6,393,257,136
061110036122,1013.8,558.6,404.5,958,556,402
061110036123,1206.3,618.4,500.8,1180,680,500
061110036092,903.1,377.6,477.1,1037,452,585
061110043051,110.0,36.0,63.0,184,97,87
061110036091,1528.4,799.7,645.4,1402,810,592
061110036093,1188.5,561.6,549.3,915,468,447
061110040004,340.7,266.5,57.5,370,245,125
061110040003,403.5,315.7,68.3,312,242,70
061110040001,429.3,343.6,63.8,351,274,77
061110045042,737.1,505.7,196.6,670,403,267
061110045041,561.5,419.1,114.3,394,275,119
061110040002,411.5,330.5,59.8,317,275,42
061110047111,386.6,279.0,88.1,316,222,94
061110047102,634.3,457.7,144.6,432,293,139
061110047112,488.1,352.3,111.3,573,328,245
061110039002,884.5,729.7,115.9,724,547,177
061110091003,83.0,76.0,3.0,26,19,7
061110047162,523.7,432.4,68.9,563,443,120
061110047152,692.6,512.0,152.4,599,429,170
061110047151,699.7,512.2,158.9,603,424,179
061110047103,221.3,163.7,48.7,259,172,87
061110047101,485.1,368.1,98.4,402,289,113
061110047042,331.6,257.0,62.3,270,217,53
061110039001,692.5,587.3,77.1,618,522,96
061110050032,1112.9,867.4,188.1,872,672,200
061110091002,233.7,187.1,29.8,190,154,36
061110047161,548.9,436.1,87.6,498,362,136
061110091001,251.0,217.0,19.6,263,236,27
061110032011,312.6,270.1,24.4,200,181,19
061110032012,360.8,312.0,28.0,314,288,26
061110091004,231.2,200.0,17.9,276,247,29
061110047172,621.4,496.5,96.6,346,263,83
061110049022,540.9,474.6,42.3,537,477,60
061110025003,474.1,245.5,198.7,454,255,199
061110028001,898.4,559.5,275.4,702,473,229
061110028005,293.7,190.5,79.1,254,176,78
061110028004,739.9,480.4,199.0,706,502,204
061110028003,528.4,342.0,145.9,659,444,215
061110028002,593.1,372.4,178.2,676,461,215
061110027002,1282.1,787.4,406.4,1312,817,495
061110050041,2865.1,1882.1,785.0,847,577,270
061110009022,830.8,533.8,237.0,777,542,235
061110009031,1351.3,909.9,356.6,1187,837,350
061110009034,682.0,454.4,185.5,775,509,266
061110009032,616.4,425.3,149.9,637,447,190
061110012011,1186.4,604.8,500.0,1260,641,619
061110050031,892.0,690.0,155.5,904,694,210
061110049011,2155.0,1567.0,457.0,1579,1146,433
061110014022,1110.0,580.9,459.3,966,561,405
061110013011,834.3,493.3,290.4,575,321,254
061110013013,1252.0,730.1,442.6,1314,864,450
061110012023,1652.4,869.7,681.1,1753,909,844
061110012022,1492.8,760.8,639.6,1460,757,703
061110012021,991.8,480.5,449.3,1040,541,499
061110013012,663.9,347.8,261.4,550,322,228
061110013014,1017.5,533.0,400.7,969,535,434
061110046001,143.0,38.0,83.0,272,117,155
061110038011,357.8,290.6,50.8,247,211,36
061110038021,643.5,527.4,83.5,470,374,96
061110041011,629.4,514.6,81.2,458,372,86
061110043044,478.1,306.9,134.4,385,248,137
061110043043,752.3,477.6,228.9,510,317,193
061110036053,730.7,463.9,205.0,618,427,191
061110036052,1249.4,799.1,375.0,1203,736,467
061110036051,1454.0,962.0,412.0,1316,857,459
061119901000,0.0,0.0,0.0,0,0,0
061110044004,1053.0,603.0,380.0,756,463,293
061110044001,558.5,379.2,137.6,395,288,107
061110042001,593.0,402.7,146.2,707,499,208
061110044002,626.7,425.6,154.5,674,442,232
061110044003,323.6,219.8,79.8,304,217,87
061110045061,384.8,295.5,67.4,199,144,55
061110045051,529.2,407.6,93.2,396,298,98
061110045063,192.8,156.6,26.9,215,157,58
061110045062,195.7,159.0,27.3,100,76,24
061110042003,564.7,386.3,141.6,509,346,163
061110042002,490.0,337.2,121.1,470,322,148
061110089002,518.2,416.5,73.5,485,376,109
061110089001,328.7,268.9,42.0,323,254,69
061110041013,539.0,422.3,83.3,411,306,105
061110041012,591.6,463.6,91.5,466,360,106
061110043042,708.5,446.9,225.1,273,156,117
061110043041,540.1,340.6,171.6,1132,689,443
061110088001,1199.3,901.7,236.6,1122,804,318
061110088002,796.7,616.3,140.4,577,444,133
061110036081,1076.6,767.4,232.4,1128,794,334
061110086002,657.8,499.6,119.3,516,427,89
061110086001,816.6,573.9,184.1,660,484,176
061110086003,141.4,112.3,22.9,144,117,27
061110038012,864.0,737.9,88.3,638,538,100
061110037002,669.7,551.0,82.9,597,487,110
061110037001,803.8,706.0,68.6,785,684,101
061110087001,517.2,385.7,100.6,568,423,145
061110087002,856.0,616.8,185.0,549,378,171
061110087003,369.1,269.7,76.3,287,217,70
061110086004,234.5,187.2,37.5,194,152,42
061110045032,691.5,527.5,127.2,513,366,147
061110045031,302.1,230.5,55.6,215,163,52
061110063011,1330.0,755.4,512.3,1620,836,784
061110076071,1508.8,731.2,691.7,1595,763,832
061110053052,1441.3,548.4,794.3,1462,541,921
061110076091,1481.2,717.7,652.9,1548,790,758
061110076101,1248.6,555.2,609.2,1461,683,778
061110076061,859.9,426.6,388.0,693,323,370
061110076112,161.7,99.7,50.9,266,166,100
061110076121,823.3,524.2,243.7,788,514,274
061110076111,1207.0,845.5,285.7,706,546,160
061110059064,429.9,230.7,171.6,19,8,11
061110059111,766.0,394.0,321.0,834,465,369
061110070001,621.4,392.8,185.5,651,389,262
061110070002,616.2,389.4,183.9,572,341,231
061110068003,460.6,259.2,167.4,459,256,203
061110068002,732.0,367.1,316.3,718,360,358
061110067001,385.5,166.1,196.4,419,215,204
061110072013,550.3,262.6,256.1,468,217,251
061110072011,1040.1,504.2,479.9,573,265,308
061110072012,930.4,438.2,441.8,1044,479,565
061110068001,604.6,291.7,281.0,595,276,319
061110065001,638.8,322.5,275.9,493,254,239
061110064003,546.4,280.5,242.8,439,222,217
061110064002,1092.6,574.1,461.7,1194,627,567
061110064001,1209.3,590.8,557.5,1068,510,558
061110064005,629.6,340.4,248.5,600,320,280
061110064004,517.5,273.9,214.9,515,262,253
061110076102,1589.4,705.1,773.3,1518,713,805
061110076132,1028.7,444.4,520.6,966,418,548
061110075081,796.7,415.8,337.0,848,440,408
061110075071,1376.2,630.0,678.0,1258,563,695
061110075142,832.4,399.3,393.1,986,491,495
061110075102,1068.9,606.5,410.3,1061,574,487
061110075103,1041.7,590.0,401.0,1255,655,600
061110075143,1577.1,699.3,770.2,1489,709,780
061110076144,1068.5,575.8,425.9,645,389,256
061110076131,1081.9,534.0,488.3,705,373,332
061110076143,656.2,325.0,282.0,827,439,388
060371134224,445.9,283.1,134.6,441,302,139
060371134221,631.6,414.7,175.2,689,441,248
060371341041,719.3,487.1,189.8,534,350,184
060371341031,732.8,519.0,178.2,632,387,245
060371134222,694.7,486.8,158.5,407,315,92
060371134223,444.6,284.3,129.8,449,278,171
060371132342,1023.2,684.6,276.4,657,450,207
060371134212,793.1,527.3,213.4,812,558,254
060371341012,937.5,620.5,271.1,956,599,357
060371341011,711.9,474.1,206.3,562,357,205
060371316004,408.5,296.7,89.4,366,264,102
060371134013,724.7,480.9,197.2,640,421,219
060371134012,613.6,410.2,164.5,636,411,225
060371316002,511.9,378.4,103.6,417,295,122
060371316003,380.5,282.6,75.6,333,247,86
060371134011,774.3,560.4,169.7,674,428,246
060371133012,994.0,647.0,297.0,689,388,301
060371133032,731.7,458.4,230.2,622,377,245
060371133211,1057.0,761.0,238.0,921,617,304
060371133222,983.0,589.4,338.7,902,543,359
060371133221,973.5,580.1,351.4,1018,593,425
060371133031,1160.8,712.1,388.6,1119,615,504
060371131022,809.7,423.0,348.8,808,402,406
060371131021,883.3,491.0,349.2,842,460,382
060371112043,757.7,399.0,330.2,874,473,401
060371082012,1285.0,777.5,441.9,1311,761,550
060371082021,2476.0,1612.0,764.6,1317,795,522
060371082011,1102.9,705.1,365.1,1049,644,405
060371316001,652.9,428.6,187.1,510,338,172
060371310102,913.9,683.1,175.7,791,534,257
060371153021,1056.5,793.5,204.6,655,485,170
060371154041,404.8,289.6,93.4,350,233,117
060371310101,613.1,454.9,122.3,430,291,139
060371372012,354.0,231.8,100.9,303,222,81
060371372011,1120.9,759.1,296.5,1055,802,253
060371374011,457.6,314.2,120.2,348,251,97
060371375022,778.4,551.0,193.6,811,586,225
060371375023,844.2,564.6,236.3,892,613,279
060371375021,488.0,356.2,112.3,404,288,116
060371380002,500.9,344.7,128.1,455,320,135
060371371031,729.9,533.5,155.9,524,384,140
060371371032,1350.1,955.5,331.1,965,671,294
060371371041,843.9,579.7,224.8,909,629,280
060371371042,526.1,342.1,158.1,439,268,171
060371351131,833.0,577.0,208.0,777,567,210
060371351113,328.5,216.7,95.2,348,246,102
060371351141,820.3,558.5,230.3,806,575,231
060371351112,488.3,317.4,144.6,521,346,175
060371343033,484.4,326.7,127.0,489,283,206
060371351111,351.3,239.3,86.3,392,282,110
060371343032,508.6,347.3,124.4,375,252,123
060371343031,357.3,246.6,85.4,255,184,71
060371351142,576.3,421.6,126.1,543,401,142
060371349031,1322.0,1009.8,225.9,664,506,158
060371345202,339.0,268.4,50.1,275,217,58
060371345201,702.6,527.2,127.2,545,414,131
060371345221,882.0,683.0,135.0,658,511,147
060371340012,135.0,108.4,18.8,199,133,66
060371340011,494.9,381.6,83.5,376,301,75
060371345211,496.0,386.3,80.1,219,174,45
060371342012,295.5,215.5,61.4,361,221,140
060371342013,445.3,322.9,94.0,395,263,132
060371375011,1385.8,918.8,401.2,1163,754,409
060371375012,555.1,371.5,153.2,351,231,120
060371154042,540.2,386.4,124.6,460,333,127
060371153012,1192.8,766.6,361.2,1249,782,467
060371152022,704.2,501.8,163.2,726,500,226
060371152023,536.2,395.4,109.0,448,309,139
060371152021,720.3,489.5,178.4,574,400,174
060371152011,1075.3,740.3,257.4,737,511,226
060371314002,984.0,757.0,168.0,738,549,189
060371314001,1017.0,761.0,205.0,810,577,233
060371154031,780.0,554.0,193.0,628,443,185
060371313004,384.2,284.3,77.7,308,218,90
060371313003,622.5,463.7,122.4,531,387,144
060371313002,436.1,326.9,83.4,293,215,78
060371313001,363.4,272.4,69.5,269,189,80
060371151041,360.3,233.2,105.2,524,326,198
060371153011,655.2,425.4,187.8,634,365,269
060371133011,401.9,210.4,166.6,413,198,215
060371112041,1347.6,806.0,467.3,1286,734,552
060371152013,578.5,425.8,118.5,628,436,192
060371112051,691.7,442.6,203.1,645,407,238
060371112053,437.2,293.1,127.4,390,248,142
060371112042,1038.1,659.9,323.8,1099,667,432
060371112063,468.1,279.3,166.2,470,285,185
060371112064,431.5,252.9,159.2,460,254,206
060371152012,637.5,445.2,144.5,645,443,202
060371112052,293.8,196.9,85.6,251,166,85
060371112065,512.9,296.2,195.2,495,274,221
060371113014,425.4,301.1,92.4,282,216,66
060371113012,470.6,333.1,102.3,364,275,89
060371312001,610.1,419.0,157.2,530,372,158
060371312002,576.9,394.9,150.7,545,356,189
060371154012,869.0,582.0,241.0,781,532,249
060371312003,365.0,251.3,93.2,338,223,115
060371154011,855.0,563.0,249.0,872,551,321
060371320011,493.8,342.8,114.1,459,315,144
060371320012,402.2,279.2,92.9,357,251,106
060371320013,553.4,390.7,122.0,492,345,147
060371320023,619.7,428.7,145.9,724,489,235
060371319003,559.9,415.0,111.4,461,344,117
060371319004,433.5,322.5,85.5,331,241,90
060371320021,417.4,279.8,107.7,370,261,109
060371319002,477.5,350.8,94.9,366,259,107
060371319001,441.6,324.6,87.6,361,270,91
060371320022,296.8,219.2,57.5,245,177,68
060371321011,567.0,418.5,110.5,581,427,154
060371321013,481.0,355.1,93.6,450,320,130
060371321012,457.2,337.2,89.4,295,227,68
060371321023,939.9,690.9,195.1,901,654,247
060371343061,847.4,601.8,200.9,802,594,208
060371343041,445.7,290.8,131.3,275,173,102
060371343042,718.4,471.1,209.2,783,465,318
060371132322,855.3,500.8,309.3,763,449,314
060371132372,423.4,234.1,166.3,505,298,207
060371343051,645.6,500.3,111.6,375,286,89
060371132333,766.6,519.4,204.0,728,471,257
060371132331,412.5,303.5,83.4,287,226,61
060371132332,495.1,364.3,100.1,352,265,87
060371132341,439.4,268.5,146.5,367,224,143
060371134211,278.3,217.9,42.9,237,190,47
060371134213,450.9,353.0,69.6,407,325,82
060371132131,1163.0,664.8,441.3,1126,645,481
060371132121,569.4,314.3,224.6,557,323,234
060371132132,637.3,404.7,191.7,561,367,194
060371133212,870.0,552.0,275.0,743,449,294
060371132122,719.0,396.7,273.8,674,407,267
060371131012,942.2,535.4,347.1,988,526,462
060371131011,824.8,441.0,334.4,850,448,402
060371341032,738.2,464.5,236.8,725,442,283
060290038081,785.7,181.6,566.4,803,215,588
060290038082,966.3,318.5,587.5,845,265,580
060290005051,931.1,200.7,687.5,1123,235,888
060290005071,1490.1,334.5,1096.1,1658,426,1232
060290005061,905.4,262.1,584.2,739,228,511
060290005052,1118.8,229.7,836.8,1176,256,920
060290005041,1104.0,170.0,883.0,1149,240,909
060290005032,996.3,157.5,803.7,1059,194,865
060290005042,840.7,238.8,557.7,705,203,502
060290004001,294.0,85.4,185.9,223,90,133
060290004003,316.3,86.5,207.7,327,122,205
060290002006,313.6,81.6,208.9,314,121,193
060290002007,370.7,95.7,246.7,343,112,231
060290004002,279.5,79.9,178.4,274,104,170
060290003004,137.1,36.9,90.1,207,89,118
060290002005,207.1,50.3,136.6,218,72,146
060290006002,179.2,97.8,69.5,84,59,25
060290006003,163.5,99.4,49.8,173,108,65
060290006001,667.7,286.1,352.2,607,276,331
060290006004,354.0,215.0,105.3,346,232,114
060290003002,245.2,70.1,156.0,227,86,141
060290003003,191.8,58.6,115.7,216,94,122
060290002004,181.0,48.0,124.2,167,56,111
060290002003,186.5,51.3,129.8,189,67,122
060290002002,233.6,67.0,153.3,195,82,113
060290003001,261.2,74.6,172.4,363,116,247
060290002001,217.6,58.4,143.7,214,80,134
060290032025,445.6,196.6,234.1,336,94,242
060290062011,493.5,227.8,245.4,490,222,268
060290064031,128.7,99.5,22.9,171,110,61
060290064041,198.5,148.6,42.1,173,134,39
060290064042,160.9,129.4,24.8,150,112,38
060290064034,174.4,134.0,26.8,85,66,19
060290064033,196.0,150.6,30.1,245,176,69
060290063011,316.1,238.1,64.9,390,269,121
060290032024,517.3,190.1,302.9,546,201,345
060290032023,561.3,278.3,256.7,361,170,191
060290032022,1131.3,829.9,236.4,639,459,180
060290031222,319.1,234.9,64.7,253,165,88
060290031223,312.8,226.3,68.1,214,135,79
060290031032,271.9,181.8,74.6,198,128,70
060290031214,357.4,245.5,94.7,306,200,106
060290031031,174.5,111.3,56.1,153,83,70
060290031215,254.8,170.1,71.9,258,165,93
060290031033,171.8,109.0,53.4,140,88,52
060290024001,1631.1,956.7,598.8,1298,694,604
060290030002,138.3,99.0,32.8,89,64,25
060290026003,243.0,182.0,50.7,261,193,68
060290030004,367.8,252.9,96.6,405,259,146
060290026002,216.8,165.8,41.1,238,158,80
060290031213,260.3,177.3,64.8,265,161,104
060290030003,95.3,66.9,24.6,155,109,46
060290031212,259.3,176.7,64.6,258,158,100
060290026001,185.7,138.0,39.3,145,93,52
060290030001,98.4,71.0,22.7,92,49,43
060290030006,134.6,91.9,35.7,128,96,32
060290025004,250.0,199.3,38.6,169,151,18
060290025005,286.3,232.8,40.4,293,233,60
060290021003,158.5,141.2,11.6,184,158,26
060290025003,392.0,341.2,29.9,354,316,38
060290025001,225.0,181.0,36.2,196,168,28
060290025002,167.1,127.5,32.5,239,194,45
060290022004,167.9,149.7,12.3,149,137,12
060290022003,158.2,141.1,11.7,158,143,15
060290020002,280.9,238.2,30.0,443,398,45
060290020003,315.7,268.6,31.9,325,288,37
060290020001,244.8,204.2,31.8,265,234,31
060290020004,398.3,330.7,52.4,305,250,55
060290016001,317.1,192.4,95.3,212,123,89
060290007005,260.7,122.4,123.0,261,136,125
060290013002,127.7,94.9,24.5,132,99,33
060290013006,133.6,94.3,32.2,112,77,35
060290021002,111.4,99.3,8.2,120,106,14
060290022005,164.2,144.5,13.5,180,162,18
060290022001,162.2,141.8,14.1,183,168,15
060290021001,82.9,72.5,7.2,63,56,7
060290021004,136.2,119.1,11.8,93,71,22
060290022002,120.9,105.6,10.5,136,120,16
060290023021,246.2,198.2,38.9,202,145,57
060290023022,207.2,166.8,32.8,176,128,48
060290015002,127.6,94.6,25.9,135,110,25
060290015001,221.3,164.1,44.9,186,133,53
060290015003,143.8,109.2,27.4,158,128,30
060290013004,111.2,78.8,26.9,84,70,14
060290013005,100.5,75.1,19.1,69,56,13
060290012023,151.4,117.8,22.9,129,109,20
060290012022,225.2,175.0,34.6,194,142,52
060290013003,184.8,144.9,27.6,136,112,24
060290013001,186.9,149.3,27.8,202,159,43
060290014003,366.8,223.5,118.8,325,214,111
060290014002,174.0,128.7,35.7,113,80,33
060290014004,482.9,354.3,104.1,394,284,110
060290023014,401.5,285.1,88.5,397,262,135
060290012024,83.4,64.6,13.1,60,42,18
060290012021,121.9,93.5,19.4,96,80,16
060290012011,270.0,195.7,55.0,356,242,114
060290012012,206.0,149.3,42.0,116,80,36
060290011021,458.5,279.3,144.1,458,221,237
060290023013,220.2,163.4,40.4,186,136,50
060290011032,223.2,158.1,46.7,152,108,44
060290011031,149.4,105.8,31.3,164,104,60
060290011033,172.3,122.1,36.1,142,103,39
060290023012,524.0,364.2,133.1,438,319,119
060290023011,657.0,446.7,180.9,609,368,241
060290009052,396.6,204.0,171.3,353,180,173
060290009051,330.4,170.0,142.7,407,177,230
060290009042,435.1,218.3,196.2,501,233,268
060290063031,354.2,282.8,55.0,346,249,97
060290063032,339.6,269.0,48.6,289,213,76
060290063012,286.4,212.9,61.8,227,161,66
060290063042,208.5,168.9,33.8,219,157,62
060290063043,88.8,72.0,14.4,98,60,38
060290063041,206.6,166.7,34.2,244,184,60
060290010003,208.6,73.3,125.2,234,80,154
060290007004,448.3,202.5,219.7,488,223,265
060290007003,410.5,155.4,232.7,489,189,300
060290014001,221.1,163.6,45.2,159,122,37
060290007002,370.5,162.0,185.6,347,171,176
060290007001,428.1,175.3,222.9,437,192,245
060290008005,234.8,112.4,107.6,259,116,143
060290008004,323.7,155.0,148.4,332,164,168
060290008003,310.8,154.1,137.7,352,185,167
060290008002,392.6,210.7,159.4,418,218,200
060290008001,266.0,142.8,108.0,317,138,179
060290038072,419.0,71.6,325.6,486,95,391
060290018023,655.8,271.1,344.8,807,296,511
060290018021,392.9,182.8,186.4,272,129,143
060290018013,715.7,299.2,373.0,897,413,484
060290018022,1158.5,382.1,704.6,1287,460,827
060290018011,279.8,144.2,120.2,332,156,176
060290018012,626.3,316.6,275.0,737,325,412
060290028143,455.0,242.0,185.0,469,251,218
060290029003,504.7,269.4,203.9,520,244,276
060290029004,336.4,181.8,131.2,346,175,171
060290027005,190.3,103.1,77.9,230,107,123
060290028133,375.6,225.4,114.5,356,213,143
060290028131,384.0,186.0,179.0,420,191,229
060290028121,342.5,155.4,157.7,331,151,180
060290019013,262.0,118.8,125.7,249,119,130
060290028122,313.1,142.0,144.6,367,149,218
060290028123,320.5,206.8,87.7,315,224,91
060290027003,530.7,278.5,224.1,534,250,284
060290027002,222.8,114.3,95.1,215,100,115
060290027004,190.0,101.8,78.9,215,101,114
060290019012,346.1,156.0,168.1,420,177,243
060290029002,526.0,330.0,171.0,548,295,253
060290029001,391.0,218.8,136.9,413,213,200
060290030005,224.6,150.9,61.1,226,122,104
060290031211,407.0,269.0,116.0,316,170,146
060290027001,193.0,97.4,80.6,172,95,77
060290019023,215.4,113.3,83.3,264,146,118
060290017004,243.5,117.0,109.1,281,121,160
060290019014,234.5,113.9,99.9,237,125,112
060290019011,376.7,177.9,168.2,363,185,178
060290019024,496.2,252.2,197.4,417,231,186
060290019022,235.0,122.7,91.2,209,132,77
060290016002,196.7,103.6,79.0,134,74,60
060290017003,711.0,259.5,404.8,802,274,528
060290017002,524.8,222.3,266.4,464,202,262
060290017001,356.4,144.6,185.5,446,177,269
060290019021,217.0,118.0,77.0,260,148,112
060290038091,897.4,127.7,741.8,846,115,731
060290032021,979.5,732.6,189.4,767,533,234
060290031143,617.3,284.5,293.8,503,261,242
060290031144,584.9,262.1,296.5,549,239,310
060290031121,531.0,236.0,263.0,527,232,295
060290031132,396.5,218.3,160.3,380,207,173
060290031131,583.0,336.6,214.5,621,329,292
060290031153,416.3,254.1,135.4,433,257,176
060290031151,391.4,244.2,122.8,394,240,154
060290031152,309.7,184.8,106.0,311,195,116
060290031224,533.0,323.0,182.0,526,268,258
060290031221,490.0,355.0,109.0,429,291,138
060290028192,880.0,379.0,443.0,1012,405,607
060290028172,675.8,330.2,299.2,639,311,328
060290028171,288.7,128.8,136.9,370,177,193
060290028173,369.5,174.0,167.8,367,190,177
060290028161,600.1,301.9,258.1,634,301,333
060290028162,344.0,187.8,137.6,276,122,154
060290028041,815.5,248.8,542.7,946,319,627
060290028042,850.5,270.2,555.3,823,247,576
060290028071,944.1,218.6,695.4,1037,248,789
060290028163,465.8,240.2,196.4,521,266,255
060290028152,550.6,288.7,221.6,557,278,279
060290028151,573.0,308.6,227.2,612,303,309
060290028141,293.1,161.6,114.7,416,194,222
060290028142,303.2,167.1,118.6,249,134,115
060290028132,163.2,97.4,50.4,207,120,87
060290028124,143.2,98.0,34.2,175,114,61
060290038092,2661.9,482.6,2075.0,2395,529,1866
060290038093,1759.0,453.0,1241.0,1477,404,1073
060290038131,4056.4,1125.1,2747.9,3609,1068,2541
060290032031,1145.6,242.7,848.8,1231,350,881
060290032062,859.5,592.9,239.1,452,283,169
060290031231,2262.6,1182.4,944.6,1302,685,617
060290028202,488.9,211.5,255.6,387,178,209
060290028203,810.1,319.5,432.4,816,352,464
060290028204,539.0,214.0,288.0,448,206,242
060290028201,636.0,263.0,338.0,591,251,340
060290028182,888.5,311.1,530.6,970,342,628
060290028181,944.5,327.9,567.4,966,340,626
060290028073,336.8,126.8,193.5,286,117,169
060290028072,375.2,141.2,215.5,352,136,216
060290028061,727.0,345.0,344.0,646,286,360
060290028074,564.9,170.4,372.6,642,174,468
060290038121,799.5,255.8,503.4,716,217,499
060290038122,581.5,210.2,335.6,653,252,401
060290038112,485.4,93.0,368.7,443,117,326
060290038123,340.9,80.8,242.4,285,72,213
060290032061,1545.0,925.7,538.2,1327,674,653
060290032051,966.0,588.0,334.0,908,492,416
060290031234,790.7,450.2,292.3,775,382,393
060290031241,466.4,229.3,207.0,463,212,251
060290031242,619.6,304.6,275.0,568,265,303
060290031244,291.7,125.1,145.2,289,127,162
060290031243,377.3,161.9,187.8,365,175,190
060290031141,378.6,169.4,192.1,472,209,263
060290031123,383.0,192.0,170.0,399,185,214
060290031122,524.0,292.0,201.0,591,349,242
060290032052,1014.0,567.2,394.8,828,468,360
060290032053,767.0,455.0,275.0,483,318,165
060290031232,1003.0,457.0,488.0,405,212,193
060290028212,440.7,172.2,250.1,479,167,312
060290028213,697.4,268.5,378.0,716,272,444
060290028211,598.9,231.3,331.9,609,239,370
060290028085,690.2,312.6,341.5,572,278,294
060290028084,565.5,181.8,352.6,705,230,475
060290031235,517.1,242.6,237.6,464,235,229
060290031236,614.9,287.4,284.4,548,285,263
060290031233,429.3,207.8,192.7,499,221,278
060290028191,707.0,289.0,391.0,763,293,470
060290028111,2099.0,676.0,1331.0,2281,670,1611
060290038102,739.4,162.0,545.4,738,140,598
060290038101,683.6,145.0,510.6,712,154,558
060290028081,669.7,223.2,407.1,756,248,508
060290028082,590.6,167.3,391.8,703,186,517
060290028083,788.0,345.0,390.0,615,289,326
060290064032,170.6,128.1,34.6,121,88,33
060290064013,196.0,158.3,29.7,221,164,57
060290064012,212.2,173.2,29.9,166,118,48
060290064015,204.3,167.1,28.3,197,150,47
060290064014,192.7,155.6,29.2,147,109,38
060290064011,177.9,128.4,43.4,206,135,71
060290011022,137.9,97.7,34.5,129,73,56
060290011023,219.4,155.4,54.9,187,109,78
060290011024,197.7,140.0,49.5,228,150,78
060290009062,332.0,185.3,122.4,400,194,206
060290009061,670.0,354.1,264.0,699,313,386
060290011012,337.2,223.3,90.6,353,187,166
060290011011,575.9,317.2,225.3,506,229,277
060290009071,605.0,296.0,271.7,628,270,358
060290010002,769.7,442.2,274.7,677,328,349
060290010001,892.6,512.8,326.8,646,317,329
060591104013,642.6,352.4,251.1,648,353,295
060591103021,529.8,301.6,200.4,528,287,241
060591105002,802.3,551.6,202.6,535,329,206
060591103023,918.9,527.8,325.6,858,509,349
060591106062,389.4,269.5,98.2,430,269,161
060591106032,334.4,245.1,70.7,193,141,52
060591106034,266.8,198.9,53.0,220,149,71
060591106071,261.9,156.6,92.7,353,180,173
060591106061,544.6,353.9,160.1,361,255,106
060590869022,387.6,244.7,120.1,543,276,267
060590869021,261.8,164.8,79.8,345,188,157
060590869023,990.5,549.2,397.2,726,361,365
060590869034,450.0,243.0,175.1,497,258,239
060590869032,398.0,215.0,154.9,237,123,114
060590869033,327.4,199.8,106.7,415,212,203
060590869031,562.2,341.9,184.0,302,171,131
060590870011,243.8,147.9,81.0,145,82,63
060590870012,608.2,365.1,213.5,501,275,226
060590877012,656.7,398.0,224.4,634,337,297
060590868032,787.2,461.4,287.5,748,362,386
060591104022,338.0,233.6,84.8,335,187,148
060591104021,486.3,268.6,189.5,476,249,227
060591104023,603.7,420.0,143.2,476,308,168
060590868034,221.1,133.0,73.5,316,153,163
060590868033,604.6,361.9,207.0,718,414,304
060591104012,572.0,300.1,234.8,463,234,229
060590868012,438.9,251.4,167.0,446,256,190
060590868013,469.8,273.9,165.5,345,197,148
060590878051,1166.0,759.1,350.0,807,472,335
060590870013,755.8,459.5,260.7,594,308,286
060590870024,688.0,407.0,239.0,609,336,273
060590870022,589.1,359.2,203.2,471,236,235
060590870021,346.5,196.6,129.5,406,195,211
060590870023,678.4,384.9,253.5,449,266,183
060590871011,461.1,264.5,173.0,526,270,256
060590868031,437.3,304.4,107.7,481,294,187
060590871013,235.2,163.8,57.9,258,136,122
060590871012,594.5,413.8,146.4,327,212,115
060590868022,642.3,429.4,177.7,407,239,168
060590868021,555.5,377.2,148.4,509,279,230
060590868023,408.2,266.5,118.9,456,246,210
060591104011,630.6,368.3,227.7,634,317,317
060591105003,439.9,310.9,105.3,450,304,146
060590868011,440.8,260.6,159.0,404,211,193
060375300062,378.5,254.7,94.6,289,214,75
060375301024,592.3,462.7,101.3,520,407,113
060375301023,455.8,358.4,77.5,390,293,97
060375300061,786.7,571.2,169.4,763,547,216
060375300052,806.4,547.0,221.6,924,587,337
060375300051,1089.5,737.8,291.3,1086,687,399
060374828003,781.2,544.4,187.1,780,547,233
060374828001,363.4,255.5,83.1,436,287,149
060374828002,409.5,289.1,91.7,439,327,112
060374826002,871.5,603.0,232.0,920,570,350
060375301021,331.7,257.9,57.7,418,312,106
060375301022,439.0,344.6,75.7,418,314,104
060375300042,1069.8,800.9,206.7,1051,804,247
060375300031,694.9,467.2,193.7,821,533,288
060375300032,647.8,430.0,186.5,707,465,242
060374826001,625.9,401.5,199.7,702,456,246
060374825221,652.5,488.0,124.4,602,434,168
060374825223,442.2,344.1,79.2,336,262,74
060374826004,629.1,408.6,189.5,672,435,237
060374826003,450.5,317.0,112.7,410,259,151
060374822011,265.9,184.6,66.1,249,160,89
060374822012,236.0,170.6,54.0,237,160,77
060374821013,636.1,448.0,158.1,593,372,221
060374821011,281.0,199.8,67.7,380,283,97
060374822013,287.5,190.8,77.5,267,166,101
060374822022,369.2,249.4,103.5,372,244,128
060374817142,179.7,117.8,55.6,200,108,92
060374817141,311.3,204.2,96.4,340,207,133
060374816053,230.4,169.8,51.0,248,172,76
060374816051,255.8,187.9,56.8,284,191,93
060374816052,361.0,273.0,74.0,363,232,131
060374816062,434.2,317.4,98.0,393,268,125
060374816061,388.7,283.5,90.2,367,258,109
060374815004,268.6,188.2,67.2,274,191,83
060374816063,229.3,167.0,53.5,258,180,78
060374817111,272.4,188.3,70.9,270,163,107
060374817112,307.6,212.7,80.1,335,210,125
060374815002,235.3,164.9,58.8,249,153,96
060374815001,328.3,226.0,87.9,389,245,144
060374825213,751.3,568.4,137.8,811,582,229
060374825211,393.5,288.7,80.8,388,296,92
060374822021,171.6,117.9,44.2,247,166,81
060374817122,385.9,274.7,91.6,454,307,147
060374822023,311.0,213.8,80.1,236,162,74
060374825212,389.4,301.8,70.4,403,280,123
060375301011,597.1,493.9,74.1,393,312,81
060375300041,329.2,225.4,90.2,293,214,79
060375005001,1015.8,818.1,139.8,964,752,212
060375004044,380.0,279.2,77.5,289,189,100
060374338021,548.8,422.9,91.9,459,346,113
060374825222,420.0,328.0,78.0,413,300,113
060374824022,1089.5,798.5,236.9,1104,748,356
060375004043,571.0,451.5,88.3,518,401,117
060375004042,439.8,332.1,81.8,381,280,101
060375004041,585.3,442.2,118.6,515,363,152
060375004032,831.7,625.1,155.9,973,704,269
060374825032,354.9,287.6,49.7,429,325,104
060374825031,257.0,205.4,36.3,311,226,85
060374824021,734.6,583.7,110.7,632,469,163
060374823013,243.3,183.9,46.8,174,113,61
060374823012,186.5,142.3,33.5,227,143,84
060374814022,524.6,363.3,135.5,492,319,173
060374814023,254.1,188.8,51.3,280,178,102
060374823011,101.4,73.5,22.6,136,89,47
060374824013,355.5,274.8,63.6,346,243,103
060374824012,186.5,144.2,33.4,198,141,57
060374336011,278.2,194.1,68.2,293,189,104
060374336021,522.0,402.0,98.0,567,383,184
060374824011,154.3,107.6,37.8,191,125,66
060374336012,873.5,662.3,171.0,959,681,278
060374813002,424.6,305.2,101.1,399,271,128
060374813001,372.4,274.9,84.1,440,304,136
060374337003,304.9,248.8,39.5,253,195,58
060374335011,324.5,285.8,24.9,207,165,42
060374329013,211.5,156.6,47.5,224,139,85
060374329012,357.8,264.8,78.0,240,162,78
060374329011,511.7,378.5,109.3,471,302,169
060375003001,1393.0,868.3,450.2,1430,865,565
060375004031,645.3,498.8,118.9,634,487,147
060374337002,288.4,233.5,38.9,291,232,59
060374337001,236.7,192.5,30.0,305,240,65
060374084023,1272.5,848.2,360.0,1188,729,459
060374083031,1729.2,1265.8,370.7,1634,1187,447
060374338022,554.1,441.5,84.9,510,394,116
060374338013,515.2,416.1,74.2,473,385,88
060374338012,198.6,167.3,22.3,211,169,42
060374335031,398.1,325.5,50.8,335,271,64
060374340041,443.6,351.3,66.0,494,381,113
060374340042,322.1,249.1,56.4,249,204,45
060374340031,409.9,340.0,47.8,258,209,49
060374339022,393.5,307.3,62.4,365,292,73
060374335043,251.2,205.4,33.1,211,163,48
060374331021,458.3,349.4,92.3,334,247,87
060374334012,183.7,152.0,22.9,222,165,57
060374335041,304.2,256.6,34.3,235,192,43
060374335032,138.4,117.8,14.8,123,105,18
060374331012,284.2,227.8,46.2,418,298,120
060374334011,337.7,289.6,29.8,272,233,39
060374335042,193.1,157.3,25.8,115,85,30
060374331022,381.7,289.9,78.2,315,224,91
060374329022,289.5,215.4,61.9,288,192,96
060374329021,221.3,165.2,46.6,160,108,52
060374329023,432.6,321.9,92.6,445,293,152
060374331011,205.7,164.9,33.4,185,131,54
060374327002,313.5,251.1,46.4,336,255,81
060374338011,299.9,244.0,37.8,127,104,23
060374334022,337.5,282.8,37.0,271,225,46
060374338014,195.3,171.9,16.1,128,104,24
060374334032,282.0,236.2,28.4,257,201,56
060374332002,179.4,134.3,34.5,146,109,37
060374334021,227.6,187.2,24.6,212,161,51
060374332003,310.8,227.1,63.5,348,257,91
060374332004,620.1,459.6,122.3,518,387,131
060374323001,304.8,209.4,80.2,432,289,143
060374328011,156.4,128.6,18.9,137,107,30
060374327003,333.4,266.3,50.2,368,272,96
060374328012,372.3,303.2,48.0,274,210,64
060374334031,220.0,179.2,26.6,236,180,56
060374332001,250.3,194.0,43.9,243,175,68
060374327001,617.8,486.8,97.4,485,382,103
060375019003,420.3,261.9,129.6,470,273,197
060375019001,574.9,329.4,210.7,553,302,251
060375020052,401.9,267.3,111.9,339,208,131
060375019002,460.3,260.2,173.6,467,256,211
060375017003,502.3,306.5,167.6,433,244,189
060375017004,397.1,242.9,131.7,386,219,167
060375018023,494.3,312.7,143.0,539,332,207
060375002023,425.6,240.9,162.4,380,204,176
060375033012,434.7,261.1,146.1,363,226,137
060375033013,386.9,229.7,129.5,373,221,152
060375033014,324.1,196.6,109.3,285,166,119
060375017002,474.7,287.3,160.8,422,225,197
060375017001,499.7,288.8,184.3,505,253,252
060375002024,544.4,286.9,230.9,565,234,331
060375016003,573.3,324.3,217.8,493,236,257
060375016004,495.0,279.2,188.5,426,216,210
060375018021,432.4,264.7,142.6,490,275,215
060375018022,293.2,190.7,84.0,268,186,82
060375016002,481.5,301.2,150.6,425,283,142
060375016001,1293.1,780.6,423.6,1438,799,639
060375015034,378.8,263.7,79.6,350,238,112
060375015033,591.1,371.7,173.1,569,357,212
060375014001,412.2,277.9,97.1,398,292,106
060375015042,360.4,249.0,86.3,376,246,130
060375016005,381.7,218.9,139.5,387,215,172
060375015011,1231.0,778.7,379.9,1185,703,482
060374085033,1455.3,829.0,553.7,1691,895,796
060375002022,365.3,161.5,176.3,338,138,200
060375002021,371.0,164.7,179.1,397,139,258
060375002012,1038.9,467.7,503.7,1042,482,560
060375002011,1000.1,400.9,545.0,1121,430,691
060375002025,911.5,418.0,440.2,898,343,555
060375002013,1148.8,545.6,535.8,1144,504,640
060375001003,329.4,130.0,184.2,399,138,261
060374086291,514.3,316.9,175.5,564,314,250
060374085031,728.6,424.1,267.6,696,372,324
060374084022,597.0,352.9,219.4,681,364,317
060374085052,480.9,309.4,147.2,594,328,266
060374084021,567.0,371.4,172.8,588,350,238
060374085032,506.4,312.8,173.2,524,268,256
060374085042,631.2,394.4,197.6,648,386,262
060374086253,687.1,413.9,246.1,643,353,290
060374086251,494.7,293.8,180.2,622,344,278
060374086252,468.0,276.5,169.6,514,278,236
060374085051,572.3,366.2,173.9,524,317,207
060374085041,457.8,305.5,133.7,496,331,165
060374085043,371.3,247.8,108.4,373,232,141
060374085011,946.8,680.9,219.2,876,640,236
060374340032,353.3,289.9,44.5,302,237,65
060374083012,195.6,153.4,32.0,252,207,45
060374340012,430.4,357.0,50.6,472,386,86
060374339023,253.2,200.8,36.2,233,178,55
060374339021,193.1,154.0,26.6,200,153,47
060374339012,207.8,166.2,27.9,113,87,26
060374339013,246.2,202.0,27.9,161,132,29
060374340033,238.4,200.9,26.3,239,185,54
060374340011,312.3,257.4,37.5,280,216,64
060374334033,163.8,136.8,16.0,93,74,19
060374339011,386.6,304.7,53.3,293,226,67
060374326011,203.9,157.0,36.2,255,179,76
060374333042,442.4,345.8,77.6,318,225,93
060374333021,213.4,166.3,36.2,175,134,41
060374333041,337.8,263.3,61.1,323,240,83
060374326012,425.2,317.5,83.3,420,291,129
060374324021,628.0,474.0,121.0,595,429,166
060374333051,400.7,310.6,61.9,338,257,81
060374333072,123.4,105.7,13.7,85,65,20
060374333071,360.7,281.8,61.9,380,272,108
060374333073,143.5,123.0,15.9,91,64,27
060374333063,100.6,86.2,11.1,61,45,16
060374333061,93.5,80.1,10.3,85,66,19
060374333052,266.3,206.4,41.1,259,194,65
060374333062,468.6,364.5,81.6,356,254,102
060374326022,377.7,287.7,69.3,389,273,116
060374326023,333.8,245.1,70.0,370,253,117
060374084012,628.4,454.4,142.5,656,463,193
060374084011,742.6,530.6,171.8,702,494,208
060374082022,235.2,165.2,59.6,181,127,54
060374071023,357.0,293.9,44.2,367,289,78
060374827014,660.6,499.7,126.3,676,505,171
060374827013,215.0,167.5,36.2,173,135,38
060375304002,817.9,649.6,125.1,730,569,161
060375319013,533.5,461.1,45.9,481,424,57
060375319011,395.3,339.6,36.4,291,253,38
060375319012,339.0,289.7,32.9,303,269,34
060375318001,428.3,378.4,31.7,371,327,44
060375318002,544.7,483.1,39.8,541,471,70
060375303021,407.4,344.9,44.4,390,325,65
060375302021,519.2,419.4,70.3,527,421,106
060375302023,465.6,387.4,57.0,527,435,92
060375318003,298.0,265.5,21.5,292,268,24
060375302041,465.4,363.4,72.4,295,224,71
060375302042,614.1,506.0,72.9,450,376,74
060375319021,266.3,229.3,23.5,280,246,34
060375302022,691.2,564.7,92.8,539,437,102
060374827012,305.7,238.6,51.4,310,236,74
060374827011,239.5,185.2,41.2,245,178,67
060374820022,866.3,603.6,223.0,700,483,217
060374820023,633.0,449.0,153.1,690,391,299
060374820024,319.8,219.5,86.2,389,223,166
060374827021,430.9,319.3,89.1,509,345,164
060374827022,395.5,301.9,69.9,431,314,117
060374821021,675.1,486.5,159.3,664,442,222
060374821022,403.7,280.6,103.5,365,253,112
060374820012,337.7,223.4,102.4,262,155,107
060374820011,859.6,574.6,253.4,1283,821,462
060374820021,454.0,309.0,126.6,510,316,194
060374819014,936.1,694.6,183.4,920,651,269
060374819021,1123.1,844.6,218.6,1056,752,304
060374819013,778.1,579.4,154.4,809,597,212
060374808022,955.7,732.9,177.8,985,724,261
060374808021,270.8,212.1,47.0,221,166,55
060374819011,425.4,309.2,83.9,386,288,98
060374819012,284.6,206.8,56.1,299,209,90
060374821012,423.8,299.7,104.5,387,278,109
060374818003,244.5,168.7,60.6,273,173,100
060374818001,246.7,163.2,70.6,233,143,90
060374818002,455.3,303.4,127.5,533,325,208
060374809031,780.6,549.5,190.6,898,594,304
060374817132,165.7,112.8,43.3,176,111,65
060374817131,370.3,252.2,96.7,362,223,139
060375302032,339.8,264.1,55.3,445,340,105
060375302031,549.7,438.7,85.4,500,386,114
060375315021,232.0,209.7,13.8,220,191,29
060375315022,158.0,143.7,8.9,88,83,5
060375315023,151.5,137.7,8.5,99,86,13
060375315024,188.4,171.0,10.8,145,135,10
060375315031,384.8,333.8,32.4,303,259,44
060375315032,271.1,236.5,19.6,199,164,35
060375316022,240.0,207.6,20.1,210,172,38
060375317023,384.0,332.0,32.4,349,304,45
060375316023,386.6,338.2,29.1,299,265,34
060375316021,280.6,244.0,22.4,283,256,27
060375317021,177.8,153.8,15.0,182,159,23
060375317024,299.1,258.0,26.0,241,204,37
060375315042,419.6,364.3,32.4,352,311,41
060375316041,464.3,406.3,29.6,425,367,58
060375316042,351.8,308.8,20.5,311,261,50
060375310003,658.5,577.1,49.4,556,488,68
060375310002,267.5,235.3,19.8,240,211,29
060375310001,531.7,458.9,43.5,430,383,47
060375315041,568.2,500.7,34.5,511,441,70
060375316031,225.5,197.3,15.3,204,185,19
060375305001,434.4,379.5,29.2,368,331,37
060375305004,309.9,273.0,19.9,298,265,33
060375305002,244.0,215.0,15.7,193,167,26
060375308011,313.0,268.6,20.3,79,68,11
060375307001,630.0,531.0,59.0,97,86,11
060375308012,300.3,257.7,19.5,44,37,7
060375308013,520.6,438.1,49.5,93,79,14
060375309021,489.6,418.1,41.7,363,305,58
060375309013,286.3,247.5,21.0,168,143,25
060375308014,331.1,279.0,29.8,88,77,11
060375308021,497.9,423.3,45.0,5,5,0
060375308022,381.2,331.9,28.5,288,244,44
060375309022,598.1,523.7,42.1,590,511,79
060372014023,382.3,312.6,46.7,440,348,92
060372014021,643.1,528.2,75.2,767,591,176
060372014022,385.1,314.8,47.1,400,331,69
060372017002,585.6,479.7,66.2,383,325,58
060372014011,777.2,652.9,75.0,681,564,117
060372014012,819.5,674.9,91.2,464,392,72
060375306021,483.6,412.8,44.4,450,377,73
060375306012,278.5,242.7,21.1,87,80,7
060375306011,645.0,557.1,53.9,393,347,46
060372016011,766.5,646.1,75.1,718,575,143
060372016023,315.3,263.9,34.9,257,211,46
060372016022,273.8,228.7,31.9,194,162,32
060372016021,521.6,435.2,56.2,443,346,97
060372017001,554.9,456.7,55.3,677,565,112
060372017003,554.1,452.6,62.7,391,311,80
060375361021,525.2,387.9,109.3,555,366,189
060375361023,537.4,377.3,136.0,423,257,166
060375342032,384.7,341.2,28.8,291,252,39
060375342023,271.7,238.3,22.4,190,160,30
060375342021,452.1,398.8,34.9,363,294,69
060375342031,296.0,259.9,26.1,197,165,32
060375037031,600.2,371.9,213.5,547,271,276
060375037032,1497.1,714.0,702.9,1673,727,946
060375037033,1353.7,739.1,561.6,1378,628,750
060590017073,466.0,280.8,165.9,516,257,259
060590017072,557.0,335.2,194.1,503,291,212
060590017071,1135.7,564.7,517.3,991,437,554
060375037022,1287.9,628.5,575.4,1322,650,672
060375037011,873.6,467.9,355.1,876,447,429
060375035021,364.1,189.4,154.8,323,166,157
060375037012,1000.4,527.2,411.8,923,449,474
060375034013,498.2,261.9,210.5,497,250,247
060375037021,1012.1,498.4,461.6,983,496,487
060375035011,323.9,205.7,104.5,354,219,135
060375035024,485.3,257.0,200.8,422,226,196
060375034015,600.4,318.7,251.7,571,270,301
060375034014,473.7,264.8,175.5,380,183,197
060375034012,744.7,377.6,323.4,802,370,432
060375034011,596.0,276.0,295.0,604,267,337
060590013012,581.4,290.2,256.6,692,300,392
060590013014,389.9,205.1,158.0,333,144,189
060590013015,653.9,390.8,220.2,613,345,268
060590013013,458.6,220.9,206.9,496,262,234
060590013011,470.1,236.7,203.0,466,242,224
060590011023,414.5,201.6,183.0,440,193,247
060590011032,479.6,260.1,188.4,469,244,225
060590011022,416.9,190.2,199.8,393,178,215
060590011021,372.0,169.8,178.2,342,159,183
060590011014,450.1,193.1,234.8,431,176,255
060590011012,451.0,194.4,234.0,444,198,246
060590011013,472.7,208.1,238.5,422,191,231
060375026013,657.2,513.3,111.0,591,441,150
060375026012,315.4,243.8,54.2,313,236,77
060375026014,477.2,385.0,73.1,455,362,93
060375027001,664.6,504.3,124.9,560,415,145
060375027003,577.6,430.3,115.9,499,365,134
060375026011,1017.8,805.3,155.8,915,693,222
060375027002,406.6,311.3,71.0,417,319,98
060375027005,549.1,421.0,95.6,618,489,129
060375026015,429.3,349.7,61.0,337,256,81
060375024023,704.1,570.7,94.5,676,528,148
060375024013,711.2,583.8,91.8,665,549,116
060375023011,541.4,396.0,100.9,519,404,115
060375024011,683.7,533.0,116.2,543,433,110
060375007004,495.7,394.2,73.4,516,392,124
060375024012,418.8,341.5,57.3,353,277,76
060375008004,813.0,641.0,132.0,661,518,143
060375025002,637.0,530.1,72.1,630,510,120
060375024021,301.9,243.0,40.9,323,245,78
060375024022,416.3,335.1,56.4,378,293,85
060375008002,372.0,303.2,56.7,342,281,61
060371278032,623.0,494.1,94.9,456,359,97
060371278031,372.6,294.4,57.8,323,232,91
060371279102,586.9,455.0,96.4,433,326,107
060371272202,740.3,576.1,125.8,714,516,198
060371272201,337.2,275.1,44.5,228,175,53
060371272101,241.5,197.1,31.9,151,125,26
060371279101,355.0,273.3,59.5,355,277,78
060371279202,437.6,343.1,69.5,438,354,84
060371271022,779.6,616.3,130.8,621,475,146
060371271021,277.2,214.0,50.4,237,170,67
060371286011,916.5,704.5,151.3,602,487,115
060371286021,379.1,293.5,64.0,485,391,94
060371282201,480.5,342.8,108.6,384,283,101
060371282202,461.5,329.2,104.4,384,298,86
060371281012,326.2,247.6,60.3,328,249,79
060371281011,659.2,500.9,121.8,589,456,133
060371236022,173.5,132.5,31.5,324,258,66
060371236023,209.8,160.1,38.1,376,274,102
060371236013,523.0,390.5,104.7,571,402,169
060371236021,508.1,396.8,89.0,469,369,100
060371236011,316.2,246.9,55.4,248,189,59
060371236012,762.9,540.2,185.4,642,475,167
060371235201,657.0,466.9,148.0,639,501,138
060371235102,518.1,385.5,105.3,397,310,87
060371279201,595.0,469.3,92.8,494,382,112
060371271042,451.1,342.9,86.0,331,258,73
060371271041,498.2,382.6,86.0,501,384,117
060371271031,570.0,445.3,80.9,485,402,83
060371235101,639.5,493.0,118.6,543,416,127
060377007001,518.5,302.3,199.8,604,327,277
060377007003,788.4,402.4,359.5,875,395,480
060377006004,529.0,251.0,260.0,686,291,395
060377009023,819.3,570.2,219.6,791,535,256
060372611012,743.9,527.6,187.3,829,567,262
060372611021,430.5,302.6,115.2,426,271,155
060377006002,658.8,390.2,249.8,773,436,337
060377006001,608.1,321.3,267.6,717,354,363
060377006003,406.3,239.0,155.4,431,226,205
060377006005,425.8,248.4,164.1,512,269,243
060372611011,1062.5,885.4,144.5,847,706,141
060371439021,954.4,772.3,146.7,784,628,156
060371439012,738.1,610.1,98.9,538,430,108
060371439011,1437.0,1087.3,306.1,1472,1056,416
060377005013,691.1,586.8,86.6,720,618,102
060377005012,466.3,390.9,58.8,482,429,53
060377004003,1045.0,906.3,108.9,1076,914,162
060377004004,593.0,511.1,64.8,559,471,88
060377005011,1009.8,862.1,119.1,904,766,138
060377005022,456.0,390.8,46.2,518,439,79
060377005021,1921.4,1631.2,223.0,1723,1489,234
060377004002,310.1,270.7,30.8,345,301,44
060377004001,960.9,822.9,109.6,951,779,172
060371943001,404.7,316.5,81.0,556,414,142
060371943002,404.9,320.9,75.5,516,418,98
060371942002,487.8,398.0,70.9,678,557,121
060371942001,1390.7,1175.5,165.0,1333,1120,213
060371943003,676.9,598.1,58.5,536,470,66
060371944022,687.9,601.7,68.0,593,513,80
060371944021,613.4,538.3,59.6,580,503,77
060371944023,569.8,491.5,61.9,626,503,123
060371944011,751.4,624.2,97.3,697,570,127
060371944012,545.1,468.4,54.7,409,344,65
060377003003,908.4,785.0,95.6,759,651,108
060377003001,1044.8,921.0,88.8,940,823,117
060377003004,1008.7,854.9,118.3,1054,869,185
060377002003,382.6,319.9,45.1,336,282,54
060377002004,273.5,233.4,29.6,285,238,47
060377002005,1078.3,947.9,92.9,908,804,104
060371920021,405.9,341.1,47.0,453,398,55
060371920022,372.6,313.9,42.1,370,306,64
060371920023,562.4,437.8,94.0,616,477,139
060377002002,450.5,375.9,53.8,378,307,71
060377002001,1478.7,1294.5,131.4,1704,1481,223
060377001023,843.6,673.1,123.5,716,548,168
060377001012,726.9,588.1,110.4,643,528,115
060377003002,699.6,603.4,72.2,604,525,79
060371898001,916.8,770.9,106.7,884,761,123
060371898003,792.9,672.2,83.7,598,525,73
060371898002,473.3,399.9,53.1,574,487,87
060371941022,646.2,445.6,162.8,734,568,166
060371438004,571.0,451.3,94.6,234,173,61
060371438003,1069.0,839.7,182.4,301,238,63
060375036022,1185.8,521.4,595.8,1244,506,738
060375036021,714.1,335.7,332.1,738,336,402
060375031063,457.0,317.3,111.9,373,228,145
060375031051,476.9,331.2,116.8,442,296,146
060375031062,201.4,138.8,51.3,201,143,58
060375031052,501.7,345.8,127.9,473,321,152
060375031061,545.0,353.0,164.0,538,341,197
060375036012,381.6,214.6,142.1,405,230,175
060375036013,397.4,223.4,147.9,388,213,175
060375035013,963.8,583.7,313.0,911,506,405
060375035012,781.6,469.6,267.7,742,445,297
060375033022,1011.9,675.2,273.6,849,511,338
060375032011,701.0,412.0,238.3,637,336,301
060375032012,652.6,406.9,203.7,680,437,243
060375032013,388.4,242.1,121.3,334,185,149
060375032021,642.2,450.1,151.0,688,464,224
060375033023,477.0,296.0,147.0,463,301,162
060375033021,624.9,396.6,191.2,545,309,236
060375036011,1003.8,508.3,437.8,902,434,468
060375035023,519.7,288.0,196.2,518,276,242
060375035022,355.6,195.5,137.0,332,195,137
060375033011,413.4,253.7,140.1,416,237,179
060375034023,497.1,281.6,179.9,473,254,219
060375034021,719.4,388.4,284.5,679,361,318
060375034022,680.6,375.0,259.7,707,367,340
060591106043,1146.4,615.8,467.2,991,531,460
060375038013,224.2,115.1,94.4,242,125,117
060375038023,1133.8,604.4,462.3,1053,547,506
060375038014,379.2,194.7,159.6,506,229,277
060591106042,530.4,268.9,241.3,715,364,351
060591106044,571.3,308.7,241.4,577,254,323
060591106041,728.9,394.6,315.1,745,378,367
060375038012,368.0,196.0,151.2,317,189,128
060375038011,430.0,229.0,176.8,494,234,260
060591106054,430.8,233.8,182.2,469,218,251
060591106053,430.6,241.3,171.9,335,169,166
060591106052,556.2,314.2,218.7,525,261,264
060591106055,492.9,266.9,205.4,513,216,297
060590017043,836.0,442.9,357.4,917,412,505
060591106051,339.3,184.0,140.5,338,162,176
060372048101,477.2,425.6,32.0,160,139,21
060372041202,335.0,296.7,25.6,118,104,14
060372041201,284.9,252.3,21.8,96,79,17
060372039003,268.2,233.3,19.9,272,233,39
060372039001,260.1,226.2,17.2,217,196,21
060372039002,252.4,219.5,16.6,209,191,18
060372041102,196.0,172.2,16.1,76,66,10
060372041103,265.3,233.1,21.8,2,2,0
060372041101,306.8,269.6,25.2,1,1,0
060372038004,331.9,288.4,23.6,216,192,24
060372038001,250.9,218.1,16.6,201,175,26
060372038002,299.6,260.4,20.6,245,217,28
060372038003,368.7,320.7,22.4,164,150,14
060372060323,563.1,467.6,56.6,297,242,55
060372060321,296.0,246.9,30.1,111,98,13
060372060322,483.9,408.9,45.4,96,80,16
060372060311,965.6,823.6,83.4,506,455,51
060372035003,256.4,218.2,21.0,240,209,31
060372035002,267.5,228.7,21.0,276,223,53
060372035001,176.3,148.1,15.9,162,130,32
060371997001,478.1,415.3,30.2,478,410,68
060371997002,584.4,503.0,45.2,351,307,44
060371999001,306.8,262.1,29.0,223,192,31
060372036003,534.7,466.8,36.6,473,409,64
060372036002,363.7,317.4,25.5,151,133,18
060372036001,296.6,258.9,21.0,227,191,36
060379800101,42.2,34.5,4.8,51,42,9
060371998004,392.2,334.3,36.3,284,256,28
060371998003,265.9,227.6,24.5,222,189,33
060371998001,202.1,171.6,21.2,186,155,31
060371999002,189.8,162.2,18.5,213,175,38
060371998002,305.8,261.2,29.9,290,252,38
060372037203,239.4,208.1,14.1,81,72,9
060372037202,190.1,165.0,12.3,3,3,0
060372037201,485.9,421.2,34.7,132,119,13
060372037102,367.6,324.6,19.6,185,170,15
060372033001,455.1,385.8,47.0,294,237,57
060372031002,421.3,362.4,37.2,315,279,36
060372031003,403.8,356.5,24.8,16,14,2
060372037101,332.7,298.9,15.3,162,149,13
060372032001,762.9,677.0,43.8,593,530,63
060372032002,304.4,267.6,20.0,139,124,15
060372031001,162.0,143.1,9.9,121,110,11
060371991201,506.3,427.4,50.9,289,240,49
060371992011,212.2,174.1,19.6,144,120,24
060371991202,462.8,385.6,33.7,316,268,48
060375313024,311.7,279.7,15.1,241,211,30
060375313022,148.5,133.3,7.2,97,85,12
060375313025,181.8,163.1,8.8,176,154,22
060375313012,243.4,211.8,16.0,163,145,18
060375312022,577.1,508.1,38.0,452,408,44
060375313014,271.4,235.6,17.9,234,215,19
060375313013,307.8,270.8,20.2,205,183,22
060375312012,510.2,441.9,37.1,523,456,67
060375312021,380.7,329.1,27.8,317,291,26
060375313021,205.8,179.2,15.4,130,121,9
060375313023,476.2,414.8,35.6,339,296,43
060375312011,571.9,512.3,37.7,458,418,40
060375313011,278.5,246.4,18.2,334,302,32
060375311022,229.4,204.8,13.9,207,187,20
060375311011,220.3,196.7,13.3,197,174,23
060375311014,220.3,196.7,13.3,177,156,21
060375311012,338.7,301.4,17.9,315,280,35
060375309011,260.6,228.8,14.8,209,179,30
060375311013,395.6,350.7,19.1,296,257,39
060375309012,324.1,284.4,18.1,182,155,27
060375311021,607.2,546.9,36.3,478,433,45
060590993072,544.7,239.0,268.6,567,277,290
060590992432,993.7,410.8,519.3,899,427,472
060590992202,812.3,352.8,404.7,530,256,274
060590992201,564.1,283.6,241.8,705,390,315
060590993053,820.4,382.2,384.2,646,361,285
060590993062,514.6,243.2,235.4,507,287,220
060590993061,719.6,334.8,337.5,770,408,362
060590993063,461.0,216.5,213.4,393,222,171
060590993056,501.9,237.0,232.2,530,289,241
060590993052,411.3,189.1,192.4,473,247,226
060590993055,392.6,180.5,183.7,322,188,134
060590992431,1327.0,586.0,659.0,1352,675,677
060590992451,822.0,347.0,422.0,804,369,435
060590992452,828.7,350.6,427.8,933,444,489
060590992353,930.1,408.7,459.4,610,323,287
060590992354,470.3,207.8,230.8,528,252,276
060590994134,701.0,350.0,307.0,679,347,332
060590992442,1233.0,552.0,645.0,1273,580,693
060590992372,1029.3,454.1,509.8,990,485,505
060590992441,1196.0,469.0,634.0,1253,532,721
060590992392,640.0,263.0,344.0,662,255,407
060590992371,883.7,405.9,426.2,897,477,420
060590992463,375.6,149.0,204.8,360,159,201
060590992461,602.3,238.9,328.4,659,310,349
060590992462,1004.1,404.1,536.8,1057,437,620
060590992142,401.0,171.0,202.0,396,181,215
060590995061,674.1,268.6,360.8,509,257,252
060590995131,848.3,310.8,493.1,867,334,533
060590995021,247.0,126.0,107.9,533,237,296
060590995111,492.1,228.8,232.6,513,269,244
060590995132,458.0,157.7,279.0,446,180,266
060590995121,774.9,387.2,346.8,715,405,310
060590995041,1474.9,729.2,658.2,1700,834,866
060590995123,377.0,196.6,159.0,343,183,160
060590994172,949.0,430.3,455.5,852,438,414
060590995142,869.4,367.2,450.3,923,367,556
060590995082,448.8,175.3,248.9,363,193,170
060590994171,1221.1,554.5,584.3,1223,611,612
060590994163,1050.5,525.8,460.2,835,496,339
060590994162,486.3,222.1,231.1,396,243,153
060590994082,1306.6,600.3,612.3,1112,520,592
060590994161,699.4,319.5,332.3,620,369,251
060590994153,716.5,282.7,391.9,752,317,435
060590994151,696.6,285.9,373.7,823,290,533
060590995143,627.0,242.3,350.9,850,255,595
060590995084,614.6,213.1,373.5,631,254,377
060590995083,558.1,215.7,312.3,343,191,152
060590994081,591.6,246.8,306.0,606,261,345
060590995141,781.3,279.5,464.5,880,272,608
060590995144,388.3,133.5,237.4,402,157,245
060590995145,524.4,180.3,320.7,628,181,447
060590995081,774.0,298.0,419.0,750,337,413
060590994083,427.3,191.5,205.9,420,214,206
060590996034,699.1,310.8,345.9,681,308,373
060590994071,1349.2,583.4,675.9,1341,591,750
060375744004,711.1,371.5,280.8,696,347,349
060375744005,417.3,245.4,145.7,430,229,201
060375743002,470.6,258.1,181.7,427,216,211
060375743004,310.5,174.1,117.7,350,182,168
060375743001,481.2,263.9,185.8,494,247,247
060375741002,621.5,346.1,227.2,666,363,303
060375741001,441.9,271.1,138.4,452,260,192
060375745004,878.8,496.5,322.7,861,485,376
060375745001,971.0,516.1,380.2,980,555,425
060375744003,513.2,286.0,190.9,513,275,238
060375745002,1194.3,683.4,431.4,1196,696,500
060375745003,544.4,288.1,223.9,602,304,298
060379800061,0.0,0.0,0.0,0,0,0
060375744002,520.5,282.9,206.0,535,277,258
060375744006,488.2,292.9,163.5,456,270,186
060375740005,926.6,514.5,344.2,864,472,392
060375740003,538.9,295.3,200.8,546,313,233
060375744001,402.2,231.5,140.7,377,222,155
060375740004,549.7,309.4,203.5,529,284,245
060590993083,1131.2,443.6,643.4,1307,477,830
060590993082,1180.5,413.7,706.0,1190,422,768
060590993081,1012.3,354.7,603.7,1043,331,712
060590993101,810.6,375.9,387.0,969,453,516
060590993102,841.1,397.2,374.5,888,473,415
060590993091,899.4,407.5,459.7,788,389,399
060590993103,441.2,200.9,203.2,429,221,208
060590993112,809.1,347.0,404.2,770,392,378
060590993113,415.8,179.8,202.6,436,229,207
060590993111,618.2,264.2,312.5,609,317,292
060590993092,796.6,306.2,430.0,1014,460,554
060590993093,870.2,417.4,399.7,835,424,411
060590993051,354.5,155.6,175.6,265,147,118
060590993054,332.0,145.8,164.4,361,208,153
060590992204,574.0,235.9,302.8,427,222,205
060590992203,743.5,309.3,387.5,920,401,519
060590992391,544.8,225.1,279.0,502,220,282
060590993071,746.5,306.3,372.2,747,359,388
060590993064,587.6,260.0,278.6,574,324,250
060590993065,472.5,214.5,225.1,436,230,206
060375361041,176.4,145.9,18.5,166,129,37
060375361042,449.5,368.7,54.6,364,301,63
060375361044,127.9,101.3,17.2,107,88,19
060375361043,305.1,269.7,22.4,255,206,49
060375361033,599.9,506.0,65.5,535,447,88
060375361032,861.2,706.2,112.2,752,606,146
060375400004,456.2,405.2,29.8,413,370,43
060375362001,572.7,417.7,120.0,464,307,157
060375362005,467.4,365.7,73.9,309,241,68
060375362002,597.1,467.9,94.3,482,372,110
060375361022,193.2,149.6,35.3,149,110,39
060375362003,386.1,317.9,53.6,376,289,87
060375715042,331.6,255.5,58.3,348,280,68
060375714003,252.3,153.8,81.1,184,131,53
060375714004,562.7,339.5,185.3,606,354,252
060375741004,645.2,348.8,250.3,619,328,291
060375736015,0.0,0.0,0.0,0,0,0
060379800181,0.5,0.3,0.1,8,5,3
060375736014,0.0,0.0,0.0,0,0,0
060375734021,1.1,0.7,0.3,221,142,79
060375741005,586.8,321.8,224.9,556,310,246
060375713003,760.0,439.4,267.2,690,348,342
060375713002,513.3,304.7,178.8,566,253,313
060375714002,313.5,187.7,107.0,313,195,118
060375714001,631.8,387.6,204.7,606,371,235
060375713001,630.6,370.1,225.7,664,348,316
060375713004,371.7,214.5,131.6,360,211,149
060375707013,290.7,185.4,87.2,360,219,141
060375707012,875.3,610.0,219.5,722,529,193
060375707021,656.7,429.2,193.2,645,389,256
060375736013,425.8,236.2,161.6,425,227,198
060375736012,452.0,247.6,172.1,451,245,206
060375736011,897.1,478.5,344.1,890,480,410
060375712005,464.9,260.7,167.7,494,274,220
060375712004,494.2,286.8,164.9,370,212,158
060375712003,470.2,250.7,187.7,436,253,183
060375712007,736.0,421.2,258.9,690,368,322
060375712006,450.8,245.0,169.1,445,252,193
060375712002,533.7,279.8,219.6,484,245,239
060375712001,723.2,443.8,230.0,690,426,264
060375707022,485.2,326.9,132.0,467,274,193
060375706031,366.1,297.9,50.4,376,317,59
060375701002,660.2,476.0,150.6,503,364,139
060375701001,378.8,271.2,92.1,457,281,176
060375707014,387.4,230.8,135.0,370,231,139
060375707015,874.4,586.5,237.2,893,548,345
060375702041,370.0,291.7,58.7,377,281,96
060375702042,649.0,520.1,95.5,442,362,80
060590994062,1327.2,585.7,658.9,1320,555,765
060590994061,921.6,376.2,489.8,983,389,594
060590996052,902.0,436.3,413.6,970,388,582
060590996042,1002.7,442.9,500.9,938,402,536
060590996022,713.3,298.1,361.7,713,310,403
060590996031,1262.4,566.6,616.2,1136,556,580
060590996051,994.5,448.4,481.1,958,422,536
060590996021,615.0,299.9,273.5,628,315,313
060590996041,839.0,350.6,425.5,882,367,515
060590994052,682.9,297.1,345.9,678,299,379
060590994112,637.6,327.9,267.1,523,294,229
060590994111,274.4,141.1,114.9,413,197,216
060590994102,513.0,204.0,286.0,515,194,321
060590997031,473.2,249.2,196.9,342,158,184
060590994101,606.3,323.7,247.0,447,236,211
060590997033,695.0,325.2,320.4,675,302,373
060590997022,937.7,453.6,416.2,929,451,478
060590994103,721.7,444.2,237.2,536,319,217
060590996014,410.3,231.5,164.5,577,242,335
060590997013,415.2,235.5,157.9,403,162,241
060590996012,911.0,518.6,361.2,700,338,362
060590999032,517.9,325.1,165.8,333,159,174
060590994133,1129.5,528.1,543.8,1007,519,488
060590992351,488.0,198.8,261.1,453,200,253
060590992352,413.0,168.2,220.9,456,192,264
060590994022,509.3,278.3,194.6,529,309,220
060590994024,309.2,221.0,70.7,192,127,65
060590994021,340.7,243.5,77.9,126,95,31
060590994113,431.8,243.8,153.3,500,321,179
060590994114,365.2,206.2,129.7,189,107,82
060590992121,395.9,198.6,167.4,449,247,202
060590992123,369.9,185.6,156.4,319,200,119
060590992122,458.6,208.9,215.1,482,247,235
060590992124,428.4,195.1,200.9,426,215,211
060590992422,810.5,337.2,422.7,749,320,429
060590992312,929.1,389.2,486.5,946,412,534
060590992311,992.9,392.5,539.3,1068,415,653
060590992313,1078.5,479.4,543.4,1089,459,630
060590992331,857.0,374.0,428.0,905,380,525
060590992342,1028.3,436.8,531.8,1127,474,653
060590992332,770.5,342.5,383.6,767,332,435
060590992341,673.5,299.5,335.4,707,263,444
060590992412,770.5,455.5,269.8,767,401,366
060590992411,880.0,432.1,390.1,904,410,494
060590997023,724.0,468.2,220.8,750,317,433
060590879011,323.5,205.6,104.2,298,155,143
060590878022,656.1,449.9,180.5,622,398,224
060590878032,498.3,354.1,125.3,332,192,140
060590878023,807.5,473.3,288.3,669,373,296
060590878031,575.2,405.9,132.2,477,265,212
060590881051,783.4,497.8,253.6,782,387,395
060590880012,500.0,287.0,188.1,478,235,243
060590880013,591.5,331.8,228.3,498,251,247
060590879021,487.8,319.7,137.3,415,255,160
060590880011,445.8,241.7,178.2,472,183,289
060590881052,599.0,335.0,226.0,584,285,299
060590882012,545.3,300.6,220.9,547,251,296
060590880022,735.2,438.1,258.5,691,366,325
060590882011,351.4,202.3,133.9,301,144,157
060590880021,698.0,392.6,274.9,694,319,375
060590882013,370.0,206.3,147.3,305,138,167
060590878052,282.5,203.5,60.4,109,69,40
060590878053,386.7,264.4,91.8,329,165,164
060590878062,377.2,263.4,96.6,256,162,94
060590878063,467.0,288.0,150.0,454,252,202
060590878061,364.3,255.9,91.3,342,205,137
060590877034,431.1,291.9,119.1,380,221,159
060590877033,338.3,226.8,95.0,367,213,154
060375725002,441.1,348.4,64.8,484,382,102
060375723012,472.5,377.9,70.5,284,215,69
060375440021,257.4,185.4,61.8,219,140,79
060375440023,345.8,250.4,80.3,344,233,111
060375440022,399.4,293.2,83.9,352,256,96
060375440012,370.8,289.9,61.7,322,254,68
060375723011,538.0,438.1,69.7,461,347,114
060375723023,507.1,433.0,49.0,404,329,75
060375726003,411.9,311.5,71.6,360,266,94
060591102031,1252.7,614.1,568.1,1123,579,544
060591100101,1167.0,513.3,577.4,1242,574,668
060591100102,619.8,267.8,315.5,664,266,398
060590881011,569.2,364.0,168.4,626,357,269
060591100103,361.4,152.8,188.1,362,160,202
060590879023,650.6,417.3,191.2,492,322,170
060590879012,848.6,595.4,212.9,554,312,242
060590878013,298.2,174.8,106.5,372,194,178
060590878011,705.5,412.3,261.0,647,347,300
060590878012,655.7,384.4,234.1,537,294,243
060590878021,646.3,357.6,251.2,633,330,303
060591101131,1186.0,577.3,534.1,1049,482,567
060590998022,886.0,564.0,273.0,839,423,416
060590998021,643.4,361.2,255.1,656,240,416
060590998012,696.8,437.2,233.7,746,344,402
060590998031,569.9,357.6,191.2,471,193,278
060590888023,465.0,297.0,148.0,444,199,245
060590998013,494.1,315.3,151.5,386,180,206
060590998011,392.9,250.7,120.5,380,202,178
060590881061,753.7,418.2,296.3,657,359,298
060590881042,547.0,297.7,213.1,476,262,214
060590879022,444.2,286.3,135.3,360,206,154
060590881041,695.5,403.4,252.0,844,382,462
060590881062,698.8,446.2,210.0,661,352,309
060590888022,370.3,211.9,134.0,477,232,245
060590888024,237.7,136.1,86.0,184,90,94
060590888015,342.7,242.3,89.5,347,166,181
060590888014,476.3,336.7,124.5,447,214,233
060590881072,954.1,629.0,277.3,775,377,398
060590998033,639.6,389.0,216.3,700,304,396
060590998032,499.8,312.9,156.5,457,184,273
060590997011,940.7,540.5,353.3,999,440,559
060590888021,355.0,219.0,117.0,354,179,175
060590889051,463.6,286.7,155.0,462,185,277
060590889053,445.8,279.6,148.9,418,166,252
060590888011,413.0,273.0,125.0,383,202,181
060590887021,838.9,532.9,257.9,922,393,529
060590888013,434.3,273.0,136.6,378,156,222
060590881071,710.0,412.0,272.0,642,296,346
060591106035,410.4,298.2,88.8,343,213,130
060591106033,389.6,255.8,111.2,343,198,145
060590018013,305.0,158.6,130.8,274,148,126
060590018012,341.9,201.8,121.0,230,114,116
060591106073,292.1,189.6,78.7,383,218,165
060591106072,452.7,300.3,120.7,408,268,140
060591106031,505.2,335.1,134.6,241,140,101
060590018011,473.6,284.7,164.6,377,229,148
060590018014,158.0,113.0,31.0,157,117,40
060590867011,500.7,357.5,109.9,360,227,133
060590019032,494.4,293.9,168.5,432,243,189
060590018024,225.0,154.7,56.9,247,159,88
060590018025,269.0,185.0,68.1,137,91,46
060590867012,566.5,403.2,125.0,460,288,172
060591102011,1019.8,617.6,343.2,887,487,400
060590018022,521.4,316.2,170.3,530,280,250
060590758131,1261.1,446.6,753.1,1150,379,771
060590018023,469.5,276.8,159.5,342,199,143
060590019012,483.0,272.0,174.6,418,237,181
060590019011,532.8,289.3,201.3,520,289,231
060590018021,358.8,230.4,107.1,327,210,117
060375039022,353.9,168.6,165.1,313,164,149
060375039012,743.4,380.3,318.4,744,368,376
060375039024,565.6,290.3,232.8,664,326,338
060375040013,124.1,57.2,57.4,394,179,215
060375039021,506.2,217.9,253.8,386,198,188
060375039023,636.0,340.0,252.0,628,337,291
060375040022,434.1,219.4,179.5,409,197,212
060375040023,299.7,151.5,123.9,337,174,163
060375040024,328.5,156.1,149.2,325,147,178
060375041013,292.1,197.9,74.6,277,172,105
060375040025,634.5,295.1,296.5,636,313,323
060375040021,463.5,216.8,219.5,567,260,307
060375041011,916.4,599.5,265.7,878,557,321
060375040012,1087.3,521.3,490.3,987,376,611
060375040011,604.5,319.2,240.0,515,267,248
060375039011,464.9,238.8,191.8,454,228,226
060375038022,485.1,263.6,198.6,458,258,200
060375038021,445.6,238.2,178.1,485,260,225
060590997012,390.0,228.3,141.1,392,163,229
060590992421,624.5,316.8,263.3,628,303,325
060590992242,754.1,347.3,360.7,641,287,354
060590997032,1090.1,515.5,511.5,1031,441,590
060590992241,833.6,396.9,386.4,973,400,573
060590997021,912.3,514.3,352.1,924,382,542
060590889052,825.7,518.8,278.1,905,363,542
060590992221,340.8,212.6,115.9,301,103,198
060590889014,521.4,346.0,155.3,471,227,244
060590889041,295.5,189.0,95.8,380,155,225
060590889042,518.3,334.5,164.7,567,228,339
060590999061,963.7,430.6,484.9,1007,436,571
060590999062,677.7,314.6,329.4,723,303,420
060590999023,581.4,351.3,197.2,491,237,254
060590999031,425.0,248.8,154.1,470,223,247
060590999051,509.3,258.4,219.2,479,226,253
060590999052,566.7,287.6,243.8,620,271,349
060591100044,887.2,352.2,486.0,942,380,562
060591100042,487.8,184.8,272.0,485,186,299
060590999033,770.3,394.0,335.4,703,291,412
060590999021,499.8,241.3,227.9,501,226,275
060590999022,643.9,311.0,293.6,660,308,352
060591100043,604.6,250.4,315.0,591,260,331
060591100041,594.4,223.6,341.0,584,231,353
060590996011,426.2,289.3,111.6,483,224,259
060590996013,314.8,213.7,82.4,236,102,134
060590999045,288.4,183.0,90.8,295,128,167
060590999044,248.1,157.4,78.1,233,102,131
060590999042,397.4,252.1,125.2,467,232,235
060590999041,283.8,161.2,108.3,291,133,158
060590999043,392.1,204.8,167.6,378,169,209
060591100031,634.4,231.3,365.4,635,246,389
060591100032,929.9,397.1,481.6,946,393,553
060591100012,823.3,343.8,428.5,756,357,399
060591100151,761.0,312.5,401.9,755,326,429
060591100112,696.0,299.0,355.0,760,331,429
060591101143,803.4,369.3,380.8,806,370,436
060591102032,883.0,435.0,377.0,944,470,474
060591100111,842.8,411.5,384.7,865,393,472
060372976011,429.0,262.3,139.8,348,254,94
060372975002,356.1,206.6,128.5,477,303,174
060372975001,684.5,422.2,220.3,678,475,203
060372975004,572.0,328.3,207.4,658,411,247
060372976022,639.7,399.3,197.6,515,366,149
060372976013,304.9,181.1,97.9,387,244,143
060372976023,512.8,309.4,162.6,493,322,171
060379800311,159.9,85.9,59.9,119,60,59
060372976012,308.3,192.3,93.9,319,217,102
060379903000,0.0,0.0,0.0,1,1,0
060372976021,333.1,191.6,109.6,240,169,71
060372972011,710.0,483.8,182.2,576,413,163
060372971202,435.6,314.0,93.0,378,282,96
060372972012,408.8,285.7,96.2,406,285,121
060372969011,523.6,382.1,105.6,455,363,92
060372969012,448.4,316.7,99.9,409,315,94
060372971201,383.7,283.2,74.6,309,241,68
060372969021,376.6,273.2,82.7,321,247,74
060372971102,532.4,395.2,101.4,416,331,85
060372966003,257.0,184.6,55.6,284,206,78
060372966002,381.8,274.2,82.5,206,162,44
060372966001,382.7,288.9,72.2,295,237,58
060372965001,400.2,318.4,59.0,337,278,59
060372962101,184.0,146.9,27.7,138,113,25
060372965002,492.5,387.1,70.9,448,359,89
060372962102,153.6,123.2,23.8,158,129,29
060372965003,279.7,219.9,40.3,311,249,62
060372971101,585.4,444.1,91.8,497,387,110
060372962203,345.5,271.9,55.0,219,170,49
060372962202,454.0,358.7,71.9,330,261,69
060372962201,169.1,134.3,26.6,132,111,21
060372962103,226.4,181.6,35.0,223,181,42
060379800141,24.6,16.5,6.8,79,43,36
060379800151,254.0,145.2,97.1,12,5,7
060379800011,0.0,0.0,0.0,1,1,0
060372951032,971.9,565.3,354.2,1015,625,390
060372951031,1508.2,886.4,542.6,1082,649,433
060372933062,690.3,397.9,249.7,786,472,314
060372949002,356.1,292.3,43.8,298,247,51
060372949001,374.0,305.5,46.7,177,149,28
060372943021,441.4,353.1,59.1,368,289,79
060372943022,616.7,496.8,85.1,614,475,139
060372948102,322.6,272.5,32.3,212,171,41
060372948301,411.6,349.1,40.4,313,266,47
060372948302,199.5,167.5,20.8,231,191,40
060372948202,217.6,182.8,22.4,142,124,18
060372948201,266.7,232.0,22.6,205,173,32
060372948101,257.5,224.0,21.8,222,192,30
060372947013,209.4,178.3,21.8,174,149,25
060372944213,220.6,164.3,44.3,114,85,29
060372944102,676.4,510.6,130.9,778,565,213
060372944101,397.8,301.7,76.0,491,375,116
060372944212,192.6,145.5,37.2,109,86,23
060372945101,419.9,341.4,54.7,376,310,66
060372943012,380.4,292.4,67.4,362,274,88
060372943011,486.3,376.0,83.7,405,306,99
060375436023,697.0,505.2,150.5,713,494,219
060375436021,1242.7,871.6,297.9,930,602,328
060375436042,669.3,465.6,160.1,789,474,315
060375436041,1227.5,850.1,319.9,1322,793,529
060372945102,477.0,390.9,56.7,337,278,59
060372942002,565.4,446.2,90.9,475,361,114
060372942001,355.4,280.4,55.9,331,247,84
060372942003,471.5,372.1,74.1,379,292,87
060372945201,363.3,293.2,50.4,354,284,70
060372945202,465.6,375.8,64.6,314,243,71
060372946102,782.3,634.8,106.4,517,421,96
060372946101,347.0,285.6,41.6,390,306,84
060375437031,1344.0,977.9,308.6,1280,860,420
060375437023,217.6,159.6,44.7,255,180,75
060375437024,412.4,302.3,88.1,394,266,128
060372653011,2288.0,2001.0,155.0,3810,3113,697
060372672003,483.5,384.8,72.5,564,434,130
060372672002,937.4,745.6,141.1,894,675,219
060372672001,1447.4,1154.0,212.1,1357,1064,293
060372655202,437.8,351.9,63.0,463,352,111
060372655201,501.2,403.0,71.6,477,363,114
060372656012,917.4,718.9,158.8,863,638,225
060372656022,765.5,550.9,185.3,769,515,254
060372656021,485.4,345.2,121.9,614,401,213
060372671001,1060.8,841.0,159.7,939,706,233
060372671004,370.9,294.5,55.9,438,334,104
060372671003,1169.6,915.4,205.1,1069,803,266
060372656011,471.7,368.3,83.6,567,423,144
060372657002,874.7,667.5,170.8,911,665,246
060372657001,997.8,737.8,221.8,1017,691,326
060372657003,570.0,423.8,120.9,561,418,143
060372652024,680.6,519.4,136.5,689,507,182
060372652012,220.3,163.9,49.7,193,155,38
060372652011,989.4,758.2,191.5,939,651,288
060372652022,183.6,136.7,39.9,221,141,80
060372651002,606.1,444.1,136.9,766,498,268
060372651001,599.7,429.7,143.2,590,397,193
060372764003,446.2,305.0,116.0,439,282,157
060372780012,717.9,479.6,191.1,630,410,220
060372765001,757.0,588.2,119.0,1252,889,363
060372764004,367.9,244.5,103.2,450,302,148
060372765002,602.9,437.5,129.1,367,237,130
060372764005,348.5,245.6,86.5,367,240,127
060372764002,544.1,364.1,146.4,523,308,215
060372764001,515.9,346.9,137.8,517,300,217
060372756033,585.8,458.4,97.4,616,445,171
060372756031,403.3,311.5,70.8,363,267,96
060372770002,627.9,434.1,154.5,561,361,200
060372770001,723.5,481.3,200.2,717,424,293
060372780011,597.8,401.8,149.0,528,341,187
060372760003,703.8,495.2,172.9,635,425,210
060372760005,486.1,347.8,116.7,511,338,173
060372770003,757.7,518.4,192.5,672,421,251
060372770005,676.2,447.9,186.5,613,362,251
060372760004,681.3,497.4,155.7,684,463,221
060372760002,688.4,494.8,159.5,686,434,252
060372770004,391.5,270.7,98.4,467,288,179
060372753114,942.5,676.5,203.0,752,528,224
060372752002,542.0,454.0,57.7,476,407,69
060372752001,541.8,454.3,56.5,368,305,63
060372755003,354.6,287.8,44.8,319,254,65
060372755002,381.5,309.6,48.2,360,285,75
060372755001,239.6,199.6,24.7,230,193,37
060373118022,662.9,497.4,117.9,498,360,138
060373118011,617.4,466.6,103.9,485,376,109
060373107032,689.0,497.0,147.0,627,500,127
060373016011,369.3,244.2,100.3,356,289,67
060373016014,349.8,234.5,93.6,263,209,54
060373015023,536.5,370.0,125.9,514,388,126
060373015022,712.2,474.6,190.3,636,508,128
060373108001,396.1,276.9,100.5,298,207,91
060373109001,584.0,398.0,156.4,512,341,171
060373108002,353.6,248.3,86.6,353,216,137
060373106012,803.6,567.1,185.6,730,493,237
060373106021,527.1,347.8,148.0,489,298,191
060373106022,795.9,517.8,228.2,642,387,255
060373107012,220.5,150.7,57.6,164,121,43
060373107021,835.3,571.5,220.3,815,570,245
060373107022,791.8,544.8,200.2,734,528,206
060373107011,694.3,448.1,208.0,581,390,191
060373103002,340.9,186.0,133.7,408,210,198
060373103001,370.1,216.0,131.3,383,197,186
060373103003,328.8,171.8,134.1,351,180,171
060373102013,491.3,288.4,171.6,409,282,127
060373102012,716.2,425.9,252.2,732,441,291
060373101001,731.1,377.3,311.7,881,386,495
060373103004,395.8,200.3,172.1,439,254,185
060373104001,364.8,190.8,146.8,353,199,154
060373107023,840.5,594.9,195.8,731,540,191
060373102011,338.4,213.6,107.8,332,205,127
060373102014,735.3,496.6,194.8,633,442,191
060373107031,876.7,614.5,204.1,796,582,214
060373102021,671.3,389.4,238.2,643,411,232
060373102022,867.4,566.9,244.5,778,542,236
060373102023,376.4,231.2,126.4,354,218,136
060371927001,743.6,643.2,61.5,573,468,105
060371926101,364.0,310.3,32.3,259,216,43
060371914201,628.4,534.3,52.1,339,285,54
060371914202,307.2,265.7,24.3,253,209,44
060371914101,559.6,482.3,48.5,392,315,77
060371914102,652.6,564.1,49.3,404,344,60
060371913011,182.0,156.2,18.6,206,170,36
060371913012,652.7,560.3,66.7,451,373,78
060371959031,592.1,516.7,43.6,472,403,69
060371959032,355.4,310.1,26.2,313,269,44
060371958021,357.6,303.0,36.1,298,232,66
060371958032,567.0,492.7,39.3,477,419,58
060371958031,681.7,600.3,41.2,632,560,72
060371958042,615.3,521.3,53.9,654,539,115
060371959022,571.5,509.7,29.1,544,492,52
060371959021,547.5,488.3,27.9,473,427,46
060371959011,1098.0,958.0,53.0,898,780,118
060371954002,781.1,700.4,48.3,670,582,88
060371954003,572.0,509.7,37.6,582,523,59
060371913021,665.9,531.3,94.1,502,383,119
060371913022,171.3,108.5,49.0,134,97,37
060371953003,916.0,765.0,88.0,722,634,88
060371912011,573.2,381.4,153.3,389,301,88
060371891011,571.8,483.4,52.3,469,406,63
060371952023,697.9,595.2,68.3,604,521,83
060371891012,475.7,399.6,52.7,389,336,53
060371892012,728.5,626.4,71.1,689,632,57
060371891013,437.2,372.5,31.7,374,325,49
060371952012,742.0,650.4,53.7,621,527,94
060371891022,659.6,576.0,57.7,572,495,77
060371891023,645.4,550.9,66.7,579,515,64
060371953001,599.1,519.3,52.1,462,393,69
060371952022,529.8,458.6,45.7,530,469,61
060371953002,296.2,257.1,25.8,244,211,33
060371952021,595.5,524.6,46.3,572,506,66
060371882013,562.6,500.8,41.6,530,457,73
060371958041,380.0,319.3,37.2,329,259,70
060371956003,281.8,240.4,23.4,276,234,42
060371956004,413.0,357.2,29.6,304,264,40
060371955001,1036.9,921.1,58.9,929,845,84
060371956002,383.5,326.3,32.8,342,289,53
060371955003,546.1,465.7,49.5,519,432,87
060371954004,747.1,668.6,41.9,725,661,64
060371954001,470.1,416.8,31.9,505,448,57
060371951002,445.7,392.8,36.2,377,335,42
060371957101,527.8,446.6,47.1,400,342,58
060371956001,282.6,239.3,25.3,244,207,37
060371974201,751.0,648.4,54.1,619,537,82
060371955002,739.8,616.8,86.1,641,503,138
060371951001,826.0,726.0,69.4,747,643,104
060371955004,476.0,428.7,29.3,389,334,55
060371951003,640.1,570.3,47.8,707,618,89
060371951004,906.4,819.1,62.4,942,828,114
060371952011,951.5,828.7,78.0,1000,876,124
060371882012,756.9,661.4,65.6,497,429,68
060371882011,787.0,697.3,60.5,752,651,101
060371871012,829.5,675.8,112.4,739,576,163
060379800091,5.5,4.5,0.8,8,7,1
060371891021,602.8,476.8,103.3,569,472,97
060371892021,516.6,384.4,112.1,586,428,158
060371882023,385.0,310.4,63.1,353,277,76
060371882022,510.9,416.4,77.4,534,417,117
060371882021,559.1,459.2,79.5,494,361,133
060371883003,522.0,421.1,81.5,514,391,123
060371883001,642.6,497.4,114.0,609,434,175
060371871021,520.3,427.8,66.7,424,323,101
060371871011,680.2,554.5,91.8,601,449,152
060371871022,934.4,775.0,109.1,674,529,145
060371872002,625.3,533.3,54.9,503,403,100
060371881002,422.7,348.4,47.8,465,368,97
060371881001,862.1,712.4,94.6,643,520,123
060371881003,523.1,434.2,54.6,385,306,79
060373023024,230.4,159.9,61.4,212,154,58
060373024014,313.6,217.6,83.6,236,180,56
060373024012,434.4,314.0,102.4,396,298,98
060373023021,397.1,275.6,105.9,294,238,56
060371974202,766.9,669.4,47.3,632,544,88
060371973003,746.2,651.2,52.5,585,499,86
060371974102,720.5,602.5,69.9,596,520,76
060371974103,523.5,450.2,39.2,477,411,66
060371873002,959.5,866.7,56.9,860,760,100
060371973001,803.0,712.0,43.0,644,563,81
060371974101,797.1,690.2,53.7,715,641,74
060371872001,603.5,500.1,65.8,500,397,103
060372060101,426.5,348.0,48.9,396,308,88
060371977001,842.2,713.9,76.4,570,461,109
060371977003,389.6,304.4,56.7,336,250,86
060371972002,515.9,405.7,76.9,459,353,106
060371972001,530.6,422.2,76.3,433,315,118
060371972003,241.8,197.7,34.0,241,183,58
060371864041,498.2,422.2,47.1,319,263,56
060371864042,308.1,260.3,31.4,201,164,37
060371864032,558.3,461.9,67.8,527,405,122
060371852032,210.0,178.2,18.6,156,135,21
060371852033,279.2,238.5,23.4,236,196,40
060371852031,539.0,473.2,35.0,439,394,45
060373025051,475.5,355.5,87.9,328,242,86
060373025062,395.9,293.0,79.1,525,400,125
060373025053,281.5,210.5,52.1,207,156,51
060371864012,253.1,219.8,23.6,195,154,41
060371864011,593.8,511.0,56.4,412,348,64
060373024013,292.8,213.2,68.6,159,116,43
060373024011,412.9,299.8,96.7,256,187,69
060373024015,211.0,153.7,49.5,107,76,31
060373025052,138.0,91.2,37.8,104,81,23
060373023022,316.1,227.6,73.8,255,187,68
060373023023,317.6,228.6,74.1,200,155,45
060373022023,177.8,117.6,48.8,193,136,57
060373025042,176.0,116.4,48.3,112,82,30
060373022024,133.2,88.1,36.5,83,63,20
060373025033,196.1,121.5,60.6,189,135,54
060373025063,389.6,287.2,79.8,308,243,65
060373025061,181.5,133.8,37.2,127,100,27
060373025043,231.5,151.0,67.7,124,92,32
060373025041,599.5,391.0,175.3,471,354,117
060373025031,329.6,195.7,108.8,329,255,74
060373025032,285.2,169.4,94.2,247,175,72
060373022022,510.6,326.7,160.1,417,325,92
060373022021,366.2,238.3,111.4,304,237,67
060371864031,392.6,321.7,51.1,307,236,71
060371863021,673.5,559.0,84.5,547,412,135
060371863011,268.9,218.3,35.1,315,243,72
060371863013,260.7,219.4,25.9,133,110,23
060371863012,249.6,210.0,24.8,90,68,22
060371861004,342.7,256.7,67.4,350,241,109
060371861001,474.4,361.9,86.5,426,314,112
060371861002,500.3,386.7,86.0,483,334,149
060373021025,388.4,269.1,96.8,490,358,132
060373021024,421.4,292.0,105.0,332,218,114
060373021023,463.2,312.1,125.2,347,238,109
060373021022,398.1,266.9,109.1,375,272,103
060373021033,394.8,251.2,124.8,370,254,116
060373021032,561.3,350.4,182.3,543,390,153
060377010005,578.1,418.9,136.4,575,398,177
060377010003,504.4,361.6,126.1,532,364,168
060372691003,381.4,245.5,115.2,457,291,166
060372690004,932.6,624.7,262.2,779,494,285
060372679012,747.9,520.7,198.7,718,484,234
060377010001,318.4,227.1,81.6,445,316,129
060377010002,511.2,367.2,125.3,520,357,163
060377010004,930.8,667.5,231.9,989,700,289
060372691001,607.4,397.4,190.9,642,406,236
060372695004,502.5,351.9,135.3,561,372,189
060372170011,485.1,339.6,127.8,510,346,164
060377009022,710.6,471.9,211.1,678,444,234
060372691004,538.2,341.6,166.7,534,335,199
060372691002,253.8,151.3,88.7,289,180,109
060377008013,526.8,313.2,191.6,586,304,282
060377008011,1300.5,864.2,395.5,1300,846,454
060377008012,239.4,139.0,94.3,301,156,145
060377009024,704.1,509.7,161.7,758,524,234
060377008023,441.1,270.2,156.2,444,280,164
060377025022,616.1,502.0,81.6,748,600,148
060377025021,639.5,527.1,81.4,751,617,134
060377025023,1021.8,830.6,137.6,962,803,159
060377024001,775.6,630.8,98.0,652,518,134
060377024004,595.3,499.5,66.5,561,440,121
060377024003,377.0,321.0,38.2,316,273,43
060377024005,364.0,310.0,36.8,333,269,64
060372201003,420.7,373.6,33.0,390,356,34
060372360004,530.3,463.9,38.6,501,453,48
060372702003,572.8,484.8,52.8,436,386,50
060372702001,411.1,359.5,30.9,389,338,51
060372702002,392.1,331.6,36.3,445,357,88
060372697003,382.5,317.1,44.3,365,307,58
060372697004,455.5,378.5,53.2,366,293,73
060372697001,726.3,610.3,71.7,590,520,70
060372697002,546.1,473.5,40.7,421,365,56
060372695001,471.8,365.2,96.5,491,354,137
060372695003,725.0,512.2,190.4,799,544,255
060372695002,406.2,337.9,52.7,423,340,83
060372696022,331.1,285.9,35.6,314,273,41
060372696021,663.9,573.1,71.4,626,525,101
060372199022,262.9,232.8,14.2,368,333,35
060372696012,277.1,246.5,14.9,277,253,24
060372696011,323.9,288.1,17.4,220,189,31
060372696013,331.0,294.4,17.8,300,259,41
060372360003,549.7,509.1,26.4,523,504,19
060372360002,723.9,668.1,38.8,771,721,50
060372201001,342.7,307.3,25.1,373,348,25
060372199011,427.4,382.0,23.7,310,283,27
060372199012,426.3,384.8,23.0,333,309,24
060372199021,624.3,558.0,30.6,568,535,33
060372360001,1073.1,977.9,58.2,993,933,60
060372199023,253.9,229.4,11.0,216,205,11
060372703002,388.5,344.5,26.7,409,384,25
060372703001,313.1,277.6,21.5,264,250,14
060372703003,450.0,396.9,25.0,439,408,31
060372183005,487.1,433.2,28.1,433,403,30
060372167003,598.5,536.5,41.6,651,622,29
060372169004,717.6,652.3,42.3,719,675,44
060372169005,486.9,441.2,30.9,469,436,33
060372199013,391.3,356.1,20.6,359,327,32
060372184004,190.9,173.6,9.1,160,153,7
060372184001,522.0,474.7,25.0,503,468,35
060372184002,443.4,401.2,28.0,384,367,17
060372183004,429.0,385.4,25.9,392,365,27
060372183003,388.0,342.8,22.3,339,312,27
060372170023,806.1,605.5,165.8,843,641,202
060372170021,854.3,634.3,175.3,753,574,179
060372170012,414.2,227.9,164.3,374,230,144
060372170013,226.3,124.5,89.8,174,109,65
060377009014,489.3,321.0,149.3,620,366,254
060377009013,405.0,259.6,130.4,457,282,175
060372170022,577.8,449.4,98.5,558,455,103
060372164011,766.9,570.5,159.4,723,514,209
060372164012,905.2,671.9,192.4,825,614,211
060372164021,492.6,371.3,99.9,525,379,146
060372164022,598.3,454.2,116.3,503,356,147
060377009021,578.7,365.7,194.0,598,368,230
060372149011,894.2,682.2,172.7,939,670,269
060377008022,643.3,436.4,174.4,586,399,187
060377009011,390.5,270.1,104.5,315,211,104
060377009012,295.6,204.5,79.1,317,220,97
060377008021,577.9,379.0,178.1,594,407,187
060372149012,412.4,327.7,71.0,357,270,87
060372149021,449.4,357.1,77.3,406,310,96
060372149022,602.0,465.0,122.0,589,446,143
060372167002,598.7,527.0,49.2,583,538,45
060372167001,715.5,638.3,55.0,622,562,60
060372168002,534.4,464.9,50.6,455,398,57
060372168004,430.1,365.2,49.0,422,366,56
060372168003,353.9,307.8,33.5,356,317,39
060372168001,526.1,436.2,69.7,498,443,55
060372163004,587.1,491.7,70.7,486,401,85
060372169003,824.7,743.3,48.8,787,713,74
060372169002,313.3,285.9,17.4,352,329,23
060372171004,506.5,457.2,30.2,566,523,43
060372171003,328.9,302.3,17.1,255,245,10
060372169001,445.7,407.1,23.5,437,405,32
060372171005,439.6,391.3,29.4,455,434,21
060372163003,479.8,406.2,51.4,421,353,68
060372163002,654.7,554.5,70.2,613,516,97
060372163001,827.1,705.4,84.2,922,799,123
060372148003,335.7,276.5,45.8,270,225,45
060372148002,521.3,429.5,71.2,540,452,88
060372147001,498.4,417.2,58.8,414,344,70
060372147003,443.3,370.2,53.2,493,409,84
060372147002,408.4,340.7,49.5,459,366,93
060372148001,643.5,555.9,62.6,542,451,91
060372146003,553.7,466.5,67.1,509,392,117
060371945002,632.4,516.2,98.5,599,477,122
060371945001,465.5,377.5,70.8,408,317,91
060372146002,407.2,333.9,57.3,378,300,78
060372145013,302.3,252.0,34.6,330,280,50
060372151011,798.3,681.5,78.7,624,521,103
060372145011,431.0,359.4,49.3,349,293,56
060372145012,272.8,227.9,36.8,186,132,54
060372146001,383.7,320.6,51.8,416,324,92
060372144002,562.0,501.0,37.2,522,464,58
060372144003,429.7,387.1,22.7,406,364,42
060376512211,1171.3,698.9,381.7,1115,636,479
060376512011,480.4,224.5,220.0,498,233,265
060376511021,653.5,364.9,239.8,642,347,295
060376508002,519.8,324.8,167.3,517,270,247
060376507012,988.7,526.4,400.3,925,452,473
060376508001,881.4,564.4,275.4,1313,714,599
060376506041,534.0,356.0,135.0,506,317,189
060376506023,677.1,434.6,207.7,676,429,247
060376506022,806.5,486.9,275.6,597,377,220
060376506021,500.4,323.7,150.9,481,304,177
060376506042,869.5,588.1,224.9,777,513,264
060376504012,329.0,187.0,122.8,363,198,165
060376504014,454.3,257.9,168.0,447,216,231
060376504013,461.6,262.0,170.2,436,223,213
060376506051,935.0,558.0,317.0,954,558,396
060376504011,504.9,239.2,225.9,498,208,290
060376511022,795.9,442.9,306.9,868,395,473
060376511012,927.7,496.7,373.8,1283,672,611
060376511011,1512.8,788.7,629.9,1493,683,810
060376508003,779.8,492.9,239.2,398,225,173
060376504015,344.2,171.9,145.7,376,165,211
060376509013,619.9,363.8,210.6,619,365,254
060376509011,678.4,425.8,209.2,714,452,262
060376509012,478.5,297.3,149.7,434,278,156
060376505013,535.3,257.5,242.9,509,234,275
060376505012,455.1,215.2,211.8,490,211,279
060376503005,711.7,451.3,213.0,623,404,219
060376040022,565.9,427.0,114.3,484,353,131
060376040023,271.6,204.1,54.2,229,165,64
060376040024,213.1,159.3,41.9,211,142,69
060376040021,343.4,256.7,67.6,241,180,61
060376040012,465.8,338.0,97.4,389,271,118
060376040013,221.8,163.7,44.7,189,139,50
060376041004,369.0,271.3,75.1,361,239,122
060376041005,373.3,262.3,85.7,361,250,111
060376040011,514.4,398.1,93.4,465,350,115
060376041003,428.5,328.0,75.8,291,217,74
060376503004,646.7,387.2,209.1,564,357,207
060376503002,638.4,377.8,216.1,657,366,291
060376503003,650.4,413.4,192.3,420,240,180
060376503001,360.3,207.4,127.7,397,223,174
060376502003,663.9,393.3,226.8,628,311,317
060379800051,0.0,0.0,0.0,2,2,0
060376502001,470.8,257.2,172.1,587,291,296
060376502004,876.3,485.6,331.8,833,463,370
060376502002,417.4,233.9,149.1,442,224,218
060376037022,387.3,239.3,122.8,559,317,242
060376500031,641.8,411.7,187.2,616,366,250
060376500032,366.5,233.8,111.3,316,185,131
060376501021,307.2,176.9,109.1,262,150,112
060376501022,765.8,441.1,271.9,717,390,327
060710020351,1627.9,933.7,594.7,1676,985,691
060710020331,1992.4,985.0,891.1,1716,854,862
060710020311,696.8,380.9,274.2,744,388,356
060710020342,2346.3,1313.1,915.8,1841,1094,747
060710020313,898.6,469.6,381.2,902,440,462
060710020312,1175.2,576.6,532.4,1104,558,546
060710020212,807.5,364.1,402.1,963,453,510
060710020213,635.5,291.9,310.9,614,306,308
060710020211,1029.0,390.0,598.0,727,255,472
060710022071,629.0,412.0,189.0,381,247,134
060710020341,2551.0,1396.3,1029.5,1976,1096,880
060710020372,910.4,574.6,290.3,753,476,277
060710020373,1598.0,1006.4,513.7,1444,881,563
060710020221,2095.2,926.6,1081.6,1676,761,915
060710020222,3633.0,1786.8,1677.9,2788,1332,1456
060710020332,1233.0,573.5,602.6,1199,556,643
060710020294,962.1,421.3,489.8,895,429,466
060710020191,908.9,480.3,369.0,1143,566,577
060710020192,902.1,497.7,354.0,726,455,271
060710022043,688.7,517.4,139.7,564,412,152
060710022042,342.5,257.5,69.3,126,90,36
060710020381,1069.0,720.0,302.0,966,651,315
060710025011,220.0,178.9,30.6,229,191,38
060710024014,245.4,199.7,34.1,221,176,45
060710020382,1127.0,763.0,328.0,1139,767,372
060710020371,467.7,261.0,182.0,380,232,148
060710020251,1247.9,550.2,642.6,1250,566,684
060710020252,1063.5,496.5,511.2,1055,489,566
060710020232,1178.7,580.5,529.2,940,497,443
060710020231,988.3,445.1,498.3,877,452,425
060710020151,845.8,382.6,423.1,1032,431,601
060710020131,791.4,353.5,394.4,648,307,341
060710020132,1415.6,538.5,808.2,1195,514,681
060710020172,1705.8,605.9,1007.8,1918,730,1188
060710020182,1160.6,538.4,550.1,1034,508,526
060710020282,1250.5,551.6,616.7,1105,594,511
060710020272,770.7,370.8,349.7,754,395,359
060710020352,940.9,464.4,416.1,1127,596,531
060710020293,543.1,248.9,264.5,628,316,312
060710020111,1267.1,430.0,771.6,1290,455,835
060710020141,1151.0,369.8,721.5,1119,402,717
060710020112,976.1,317.6,606.2,996,339,657
060710020171,1445.3,498.0,877.9,1488,561,927
060710020181,1388.5,586.8,714.2,1441,621,820
060710021101,2018.9,1305.0,601.4,1614,1018,596
060710020361,3109.3,1876.7,1096.6,2593,1633,960
060710020362,1032.5,587.8,384.1,770,485,285
060710020291,641.2,337.6,262.4,719,372,347
060710020292,665.8,334.4,294.6,764,388,376
060372260021,398.7,328.3,38.3,264,231,33
060372260022,82.3,66.6,8.2,87,76,11
060372063003,520.3,433.4,52.5,327,281,46
060372073021,1213.8,1045.0,92.9,317,294,23
060372063002,542.8,424.7,85.0,330,292,38
060372260012,186.7,162.5,11.9,114,105,9
060372063001,329.0,267.0,43.0,243,222,21
060372062002,716.7,604.6,78.9,609,415,194
060372073022,675.8,586.0,47.2,185,161,24
060372062001,277.6,237.0,31.1,140,121,19
060372060312,620.5,537.7,39.5,374,341,33
060372077101,1648.8,1351.5,204.8,792,598,194
060372073012,1649.7,1389.5,145.8,1251,1093,158
060372075021,1268.9,1031.2,182.1,842,530,312
060372080001,656.5,559.3,52.3,274,219,55
060372080002,684.3,593.7,45.4,528,454,74
060372074001,474.7,396.3,54.0,30,18,12
060372075011,990.7,766.8,157.6,617,445,172
060372071011,609.2,500.4,76.6,511,381,130
060372071031,146.8,120.6,18.4,76,49,27
060372080003,200.2,176.1,11.3,135,118,17
060371975002,522.5,465.4,29.4,383,334,49
060371975003,298.8,260.5,21.7,308,276,32
060371975001,727.5,631.3,55.4,510,438,72
060371976001,218.3,189.7,16.2,135,108,27
060371976002,669.9,581.8,48.6,520,448,72
060371973002,406.7,354.5,30.0,369,313,56
060371977002,248.5,193.8,36.5,193,136,57
060372060201,407.7,337.0,36.7,109,85,24
060372060102,47.7,39.5,4.3,220,175,45
060372071021,502.0,400.7,73.2,260,191,69
060372071032,284.2,226.7,41.8,164,114,50
060379800331,69.9,51.6,12.2,47,34,13
060375760012,1194.7,868.5,246.5,959,732,227
060375766020,0.0,0.0,0.0,0,0,0
060375760011,813.8,596.2,162.3,721,492,229
060375766021,551.6,407.2,106.1,639,432,207
060375766011,1250.4,923.7,244.4,1112,817,295
060375767002,402.6,279.7,89.4,412,285,127
060375772003,602.7,426.9,120.2,615,446,169
060375767001,750.7,555.8,132.1,783,587,196
060375772002,603.2,426.3,124.3,522,356,166
060375758011,250.5,203.6,28.7,193,163,30
060375759014,221.2,178.7,26.2,180,158,22
060375759021,681.0,533.1,94.8,577,466,111
060375759023,605.0,487.4,76.6,478,401,77
060375759013,160.2,125.7,19.2,169,143,26
060375759011,344.4,277.9,41.4,294,248,46
060375759012,240.6,188.9,28.9,198,171,27
060375759022,562.7,443.4,76.2,420,333,87
060372098102,177.4,147.1,18.9,91,77,14
060372095101,139.6,116.5,17.2,117,82,35
060372095102,205.6,171.9,26.1,161,126,35
060372095202,139.5,116.3,16.6,86,62,24
060372095201,214.9,179.0,25.2,218,178,40
060372098101,174.1,144.4,18.6,140,115,25
060372098201,275.1,231.9,26.7,160,132,28
060372094012,195.0,161.8,18.8,182,143,39
060372094011,356.0,295.2,34.2,207,174,33
060372088022,326.8,274.4,29.0,323,262,61
060372088021,496.2,416.6,44.0,337,265,72
060372111202,568.1,463.4,80.8,340,244,96
060372121012,289.7,233.3,41.2,176,124,52
060372122041,271.9,230.1,26.9,286,213,73
060372121021,207.1,165.9,33.1,348,221,127
060372111203,321.6,268.0,38.7,266,206,60
060372111201,291.3,242.8,35.0,223,176,47
060372111221,163.0,129.9,23.4,163,135,28
060372111222,216.1,168.6,34.1,274,202,72
060372113201,197.1,164.5,19.5,211,159,52
060372111211,201.9,163.6,26.4,156,114,42
060372111212,463.4,375.5,60.6,299,242,57
060372087101,832.0,673.0,118.0,687,484,203
060372087202,187.7,157.8,17.6,264,202,62
060372087201,409.3,344.2,38.4,257,212,45
060372086101,469.5,373.9,68.6,401,276,125
060372086202,360.6,294.2,54.2,202,156,46
060372086102,464.1,378.7,69.8,444,304,140
060372086203,371.2,313.4,41.0,414,310,104
060372085021,279.5,235.9,30.9,150,121,29
060372085022,242.5,203.6,26.8,200,151,49
060372085023,222.9,186.4,24.6,197,154,43
060372086201,308.3,244.6,44.8,285,218,67
060372085012,342.2,281.4,42.5,330,229,101
060371958022,467.7,396.3,48.8,337,243,94
060371957103,373.8,317.6,38.8,179,140,39
060372094022,200.5,164.1,22.9,101,78,23
060372094031,226.2,185.1,25.8,266,189,77
060372094021,209.2,171.2,23.9,133,106,27
060372094032,179.1,146.6,20.4,120,86,34
060372093001,349.1,297.8,30.1,222,169,53
060372100101,163.3,139.3,14.1,137,107,30
060372093002,446.7,370.9,48.5,304,239,65
060372100102,145.3,123.8,12.8,143,123,20
060372088011,234.4,194.3,26.3,244,176,68
060372089032,180.3,149.4,20.2,84,65,19
060372088012,126.0,104.4,14.1,108,89,19
060372089021,130.5,111.9,11.9,21,17,4
060372089031,297.3,246.3,33.3,120,97,23
060372089041,171.4,150.4,13.1,240,187,53
060372091022,454.7,370.4,56.4,275,218,57
060372089022,91.4,80.2,7.0,39,29,10
060372091021,250.4,219.7,19.2,165,135,30
060372091041,329.7,285.8,25.2,318,268,50
060372089042,185.1,162.4,14.2,106,79,27
060372092001,520.3,434.7,53.8,345,256,89
060372091031,499.5,431.5,38.1,243,207,36
060372083023,407.9,360.7,33.6,343,255,88
060372083011,311.5,275.4,25.7,84,65,19
060372083021,186.5,161.2,16.6,209,156,53
060372083022,248.8,212.8,23.4,194,153,41
060372084012,378.6,315.4,41.8,334,253,81
060372084011,381.4,317.7,42.1,191,136,55
060372084021,352.6,301.1,34.6,248,188,60
060372085011,326.8,278.0,33.8,235,166,69
060371957102,389.5,326.1,39.1,275,191,84
060372084022,461.5,396.2,42.0,380,297,83
060371957201,650.6,557.5,50.2,478,395,83
060371957202,250.9,215.5,17.8,158,135,23
060372270202,229.0,209.9,9.7,206,191,15
060372270201,336.0,308.1,14.3,291,265,26
060372264203,358.6,325.2,16.0,279,254,25
060372264201,294.9,264.9,13.6,210,190,20
060372264202,305.0,276.5,13.6,226,209,17
060372260011,233.1,203.9,13.8,174,150,24
060372240201,314.1,266.2,30.2,128,106,22
060372270102,227.7,202.7,12.4,176,165,11
060372270101,509.3,453.3,27.6,387,344,43
060372073011,499.4,422.1,45.6,350,273,77
060372079001,377.0,309.4,42.2,219,178,41
060371834022,583.8,450.1,100.0,450,315,135
060371816002,657.2,510.6,108.8,610,438,172
060371816001,1095.3,912.6,130.8,765,632,133
060371862032,526.5,457.6,36.9,446,367,79
060371835103,473.1,391.5,56.7,409,333,76
060371834012,342.7,288.4,36.8,344,266,78
060371835102,390.7,339.9,29.9,317,277,40
060371835101,242.4,207.6,22.0,185,162,23
060371833003,556.0,453.3,73.6,414,317,97
060371836101,381.4,330.4,34.2,270,229,41
060371836201,869.4,754.1,60.2,683,567,116
060371833002,500.4,415.3,55.3,367,280,87
060371833001,206.5,171.4,22.8,203,162,41
060371832223,653.9,546.5,74.8,511,400,111
060371832211,326.9,277.3,33.1,303,246,57
060371832222,633.2,498.2,96.3,611,477,134
060371814001,632.3,533.6,72.7,545,399,146
060371814002,446.7,353.6,68.8,408,294,114
060371810005,1081.7,784.2,237.5,1001,693,308
060371810002,627.9,435.0,160.3,655,439,216
060371810001,595.3,450.5,114.7,528,338,190
060371832221,398.7,318.8,56.3,363,293,70
060371815001,610.1,451.3,115.5,564,396,168
060371815002,778.1,578.1,152.9,677,482,195
060371810004,753.3,557.1,160.3,664,465,199
060372013012,666.6,561.4,67.7,528,450,78
060372013011,510.0,438.0,45.8,497,413,84
060372015032,361.2,307.7,32.5,336,285,51
060372012001,891.5,757.8,89.8,614,531,83
060372013024,554.1,430.9,94.4,748,576,172
060372013021,341.5,266.9,57.1,416,321,95
060372013023,146.2,114.0,24.8,134,102,32
060371837011,416.4,351.8,31.0,352,296,56
060371837013,376.6,318.2,28.0,260,230,30
060372013022,438.9,343.7,73.7,363,270,93
060371837021,671.0,531.8,102.6,573,429,144
060372011101,258.0,214.6,31.0,257,203,54
060371837022,694.8,559.6,92.1,613,465,148
060371837012,398.6,327.7,47.5,287,234,53
060372015041,700.3,584.7,73.1,625,534,91
060372015031,412.3,358.5,34.4,396,347,49
060372015013,955.6,802.9,94.1,826,686,140
060372011102,387.9,325.3,44.0,287,217,70
060372015012,398.4,329.5,43.8,456,363,93
060372011201,617.5,509.6,70.8,403,332,71
060372011103,251.2,210.4,27.0,252,215,37
060372011202,427.8,356.7,46.9,404,317,87
060372015011,320.2,263.5,38.3,288,232,56
060374807021,926.7,654.4,222.4,1014,599,415
060374807022,1218.9,878.6,273.0,1155,791,364
060372011203,295.4,235.8,38.6,342,264,78
060374807042,1591.4,1211.1,284.5,1372,983,389
060374807033,857.6,645.8,160.1,909,660,249
060374807032,315.9,244.3,52.9,308,222,86
060710008084,654.3,315.3,299.2,647,292,355
060710021012,631.6,371.1,224.1,492,308,184
060710021051,797.9,496.6,250.2,682,413,269
060710013081,668.8,476.4,158.4,471,330,141
060710013051,509.7,367.7,114.7,349,243,106
060710013072,454.0,311.3,117.3,393,285,108
060710013071,638.3,449.6,152.1,659,464,195
060710013122,948.0,671.0,227.0,969,628,341
060710013121,503.0,338.0,148.0,430,281,149
060710021011,702.0,490.5,156.1,544,385,159
060710021032,810.4,491.0,256.9,1017,691,326
060710021031,533.8,326.2,181.5,362,229,133
060710020162,868.3,405.5,406.9,784,374,410
060710008081,756.4,367.7,339.9,740,374,366
060710008193,1092.6,497.5,544.5,878,390,488
060710008191,518.0,215.4,285.7,453,160,293
060710008192,868.3,413.8,407.1,836,440,396
060710008123,690.9,278.4,374.5,631,243,388
060710008122,477.5,208.7,241.8,426,202,224
060710020142,1573.1,550.3,952.3,1343,527,816
060710020161,782.4,397.4,336.5,822,411,411
060710020273,740.7,359.8,333.8,740,383,357
060710020152,1004.6,445.7,496.7,1053,519,534
060710008121,818.9,325.8,446.2,854,381,473
060710013111,1226.6,796.4,364.4,1074,679,395
060710021052,336.5,217.7,98.7,277,193,84
060710021053,701.1,391.6,268.9,676,388,288
060710020271,868.5,460.8,354.4,802,398,404
060710021072,638.7,348.1,247.0,638,378,260
060710021071,388.1,250.7,113.2,302,193,109
060710021073,456.9,295.3,133.3,510,319,191
060710020281,961.0,508.0,397.0,800,430,370
060373008002,597.1,343.8,210.3,503,300,203
060373009011,1023.1,567.7,404.1,895,520,375
060373008005,223.9,129.7,80.2,396,214,182
060373009013,1568.5,901.3,595.4,1463,828,635
060374607004,789.9,404.4,338.3,722,334,388
060374607005,868.5,489.2,333.5,880,437,443
060374605022,344.8,197.5,123.4,437,223,214
060374605023,352.8,220.2,110.3,326,172,154
060374605024,385.8,240.8,120.6,436,242,194
060374608001,1159.3,711.1,366.4,1103,622,481
060374608002,849.1,526.1,262.7,933,530,403
060374616002,846.8,691.2,113.6,718,597,121
060374617001,348.2,294.9,36.3,425,371,54
060374609005,395.7,340.4,41.6,333,296,37
060374609004,513.1,443.4,47.0,576,510,66
060374609003,550.0,480.2,33.4,490,446,44
060374609002,590.0,521.7,40.2,485,441,44
060374607002,325.7,189.8,121.8,332,180,152
060374607001,458.4,245.2,186.6,516,242,274
060374607003,417.9,236.7,160.9,461,231,230
060374605026,700.3,425.6,236.8,488,239,249
060374605021,434.7,254.2,152.8,383,198,185
060374605025,464.2,290.1,150.1,363,208,155
060374605013,1187.6,700.7,415.7,1441,751,690
060374610003,622.8,524.3,63.3,572,506,66
060374610004,687.3,576.9,71.3,688,619,69
060374610002,668.2,575.2,53.1,534,496,38
060374603021,495.4,419.4,52.2,522,482,40
060374603022,465.6,403.8,40.8,433,404,29
060374808031,389.9,301.9,67.8,423,308,115
060374808033,384.5,297.2,70.0,505,377,128
060374808034,344.6,267.1,58.5,289,217,72
060374808042,699.7,539.7,115.5,610,435,175
060374808032,348.0,268.9,63.7,256,189,67
060374807041,699.6,531.9,130.6,589,411,178
060374805003,532.9,396.6,107.8,572,371,201
060374808041,816.4,611.8,149.7,736,520,216
060374805002,1076.7,803.4,207.2,1080,727,353
060374809012,387.6,289.5,72.8,405,284,121
060374809011,813.4,608.5,151.2,582,414,168
060374809022,218.1,166.5,37.9,213,165,48
060374809021,653.4,498.6,113.4,593,445,148
060374803032,747.4,560.7,136.7,597,407,190
060374803031,333.5,248.8,62.1,345,233,112
060374810013,414.0,304.0,92.0,366,266,100
060374810012,723.7,480.2,213.2,552,302,250
060374810011,170.6,126.5,35.3,134,82,52
060374804003,864.3,639.0,175.7,866,614,252
060374805001,775.5,572.7,160.5,763,532,231
060374803041,465.1,335.0,99.9,442,287,155
060374803043,260.9,188.0,56.1,282,197,85
060374803042,277.3,216.7,43.1,242,177,65
060374804002,1027.8,691.8,280.1,872,544,328
060374804001,319.3,209.6,93.2,451,247,204
060374805004,604.9,461.7,106.1,655,468,187
060374806006,465.6,333.1,104.2,430,286,144
060374806003,637.3,493.8,107.0,537,386,151
060374806001,589.1,449.2,105.7,614,419,195
060374806005,462.5,355.8,76.5,398,294,104
060374806002,419.2,323.6,69.1,316,236,80
060374806004,1244.7,964.2,193.9,1141,873,268
060374639001,765.9,519.8,197.3,523,316,207
060374637002,844.3,590.6,202.4,495,302,193
060374637001,640.7,385.9,212.5,655,378,277
060374639002,542.3,391.7,115.2,535,376,159
060374640005,721.6,547.9,129.4,648,508,140
060374636024,404.4,328.6,55.3,410,306,104
060374636021,527.1,408.5,87.6,334,271,63
060374641002,477.3,281.4,173.9,566,275,291
060374641001,575.4,339.3,209.6,654,342,312
060374641003,362.8,179.2,160.5,447,180,267
060374640001,606.2,396.4,178.8,667,383,284
060374640003,702.7,507.6,156.4,686,496,190
060374640002,509.0,358.3,119.4,548,332,216
060374640004,598.5,432.1,131.2,682,477,205
060374636023,502.9,410.0,67.2,446,354,92
060374636022,990.1,780.1,152.0,837,649,188
060374636011,331.0,251.9,57.4,309,224,85
060374636014,549.6,436.6,82.2,534,389,145
060374636012,705.7,556.0,112.3,690,524,166
060374636013,1048.4,823.1,158.4,888,696,192
060374635002,625.5,471.7,109.0,530,387,143
060374635003,1094.6,854.9,164.7,1002,774,228
060374816041,279.1,205.1,59.4,314,212,102
060374816042,709.1,503.6,182.0,614,419,195
060374816031,586.9,416.0,141.1,533,369,164
060374810022,705.7,529.3,139.5,581,422,159
060374816032,322.1,222.0,88.9,348,213,135
060374815003,506.8,341.0,147.1,597,398,199
060374803023,575.0,391.2,152.8,490,333,157
060374803022,483.5,322.8,131.6,610,367,243
060374810021,574.2,404.1,142.5,641,454,187
060374811011,496.9,374.1,104.0,414,302,112
060374810023,270.7,188.9,68.5,206,136,70
060374803021,579.7,352.1,188.5,550,343,207
060374802013,694.0,446.7,214.8,756,446,310
060374802011,686.2,422.6,236.0,747,391,356
060374802012,479.3,280.4,178.1,492,274,218
060374811035,260.4,170.7,72.6,360,229,131
060374814012,568.0,375.4,168.3,591,360,231
060374814011,460.0,316.9,120.9,434,278,156
060374811033,426.9,286.9,112.4,343,235,108
060374814013,164.3,117.5,39.2,163,109,54
060374811012,422.7,313.8,90.6,450,295,155
060374802023,396.8,235.4,143.4,446,249,197
060374802021,364.4,231.6,114.7,409,245,164
060374811021,340.5,246.3,76.0,265,179,86
060374811022,158.1,104.6,44.6,103,72,31
060374811023,416.7,301.4,93.1,321,207,114
060374802022,421.4,255.6,142.0,489,247,242
060374800023,544.7,329.0,184.8,597,340,257
060374641006,548.5,299.3,213.3,672,321,351
060374641004,476.6,264.5,179.3,579,263,316
060374641007,394.9,190.7,180.3,473,179,294
060374641005,412.8,214.8,169.7,468,183,285
060374635001,561.8,428.1,91.5,633,478,155
060374634002,713.7,517.7,150.7,694,465,229
060374634003,438.9,314.3,98.0,449,310,139
060374642006,612.7,343.5,229.1,667,300,367
060374642005,344.3,166.2,158.0,412,153,259
060374634004,874.0,653.1,161.7,700,522,178
060374634001,528.3,396.2,94.2,473,339,134
060374633002,389.3,264.4,103.8,463,299,164
060374642002,299.7,169.7,115.8,357,164,193
060374642001,318.5,180.3,123.1,367,152,215
060374633001,664.7,451.6,177.2,566,381,185
060374617002,531.5,406.9,97.1,531,358,173
060374619022,549.8,399.4,109.6,343,264,79
060374619012,217.4,186.6,18.9,210,180,30
060374616003,568.8,488.2,49.5,466,404,62
060374616004,328.4,283.1,28.0,277,243,34
060374619021,152.6,110.8,30.5,163,120,43
060374619013,473.6,394.2,40.6,410,360,50
060374619011,634.6,537.0,56.7,428,362,66
060374620023,305.7,268.7,23.2,232,202,30
060374616001,446.0,385.5,37.2,424,371,53
060710008171,588.6,293.7,265.7,611,325,286
060710008132,1040.2,458.1,531.3,947,411,536
060710008131,1065.6,511.5,502.4,956,528,428
060710008042,1133.2,411.4,655.6,1186,405,781
060710008142,723.7,296.3,392.0,839,332,507
060710008143,440.6,186.9,230.8,443,186,257
060710011041,875.0,446.0,392.0,844,433,411
060710011032,553.9,259.4,260.3,550,239,311
060710011031,563.6,314.8,216.9,528,296,232
060710008261,426.4,228.1,171.7,590,302,288
060710008263,515.6,281.8,201.6,493,273,220
060710008241,400.8,214.3,161.4,235,151,84
060710008262,426.3,240.4,159.4,361,225,136
060710008231,561.0,316.4,209.8,592,322,270
060710008243,333.3,189.2,121.1,443,229,214
060710008242,513.9,291.6,186.7,422,232,190
060710008244,426.8,242.2,155.1,269,175,94
060710008182,557.9,268.2,263.6,646,276,370
060710008183,769.1,369.8,363.4,601,285,316
060710013104,316.5,196.6,102.6,259,168,91
060710012001,616.4,341.7,236.3,524,276,248
060710012003,409.3,243.3,137.4,514,276,238
060710013101,474.0,314.3,135.2,408,272,136
060710012004,293.4,162.6,112.5,361,197,164
060710009042,260.8,153.6,87.9,229,132,97
060710009041,773.0,455.3,260.6,666,428,238
060710009033,372.4,242.6,106.9,266,187,79
060710008082,764.0,405.0,327.0,951,507,444
060710009032,424.0,278.9,119.6,278,189,89
060710009013,410.3,238.8,145.9,362,209,153
060710009031,279.5,183.9,78.8,417,220,197
060710009011,567.0,312.0,219.0,440,285,155
060710009012,516.0,283.9,199.3,537,311,226
060710008181,754.1,324.6,387.8,821,362,459
060710008161,531.0,220.2,289.4,553,195,358
060710008162,939.4,402.3,488.9,917,375,542
060710008184,681.0,282.3,371.1,667,286,381
060710008163,836.6,364.2,424.6,833,374,459
060710008144,504.5,182.2,293.2,496,200,296
060710008201,1003.2,389.9,557.0,1042,403,639
060710008141,516.9,179.4,308.1,535,192,343
060710008083,385.7,209.1,152.2,189,109,80
060710008203,713.2,290.9,393.9,658,272,386
060710008202,585.9,239.0,323.6,590,233,357
060710008041,691.7,237.0,418.6,628,214,414
060710013091,447.7,339.7,86.4,365,267,98
060710013053,227.2,169.3,44.6,100,68,32
060710013052,271.9,201.8,55.0,280,186,94
060374614003,490.2,376.5,94.8,475,347,128
060374614002,414.8,318.5,80.2,399,289,110
060374626001,607.2,438.4,136.5,701,475,226
060374624001,651.4,500.6,113.4,687,509,178
060374626002,637.6,456.9,146.7,624,448,176
060374624002,443.8,346.9,70.6,522,420,102
060374614001,665.0,423.0,202.0,686,400,286
060374613004,685.8,426.5,217.8,625,414,211
060374613005,519.6,322.7,167.4,441,303,138
060374613001,349.7,268.1,62.0,256,200,56
060374612003,505.2,355.8,119.1,551,374,177
060374612002,763.8,519.8,198.4,816,517,299
060374627002,393.7,296.5,69.9,418,302,116
060374627005,446.7,341.4,73.7,525,397,128
060374627001,434.6,316.0,94.5,122,90,32
060374628001,712.3,504.5,172.7,707,473,234
060374628002,605.0,436.5,131.6,600,452,148
060374629003,560.2,392.9,134.9,549,359,190
060374631021,429.6,318.6,86.7,351,247,104
060374625004,634.2,411.4,183.1,471,312,159
060374625003,1017.0,671.6,282.7,1165,780,385
060374625002,638.0,445.3,158.5,649,425,224
060374613003,675.5,426.7,205.1,770,546,224
060374613002,712.3,485.6,188.5,692,463,229
060374625001,672.7,450.7,180.6,627,395,232
060374612001,493.4,338.9,130.9,544,365,179
060374612004,789.6,619.9,125.6,766,570,196
060374601004,617.6,473.9,117.4,544,419,125
060374601003,642.4,498.6,115.5,608,470,138
060374601002,996.9,778.8,168.7,1220,952,268
060374601005,916.3,624.2,237.9,878,562,316
060374601001,597.6,406.5,151.0,594,410,184
060374606004,327.7,169.4,136.5,312,148,164
060373005022,930.3,531.7,335.6,791,466,325
060374606003,691.6,391.7,257.2,785,392,393
060373005011,656.1,391.7,220.3,731,408,323
060373002001,543.5,332.5,180.6,571,324,247
060374606002,677.0,388.8,244.9,689,341,348
060373005023,680.5,401.9,227.1,649,382,267
060374605011,892.9,496.0,339.5,1034,490,544
060374605012,501.1,273.2,194.3,563,258,305
060374604012,0.0,0.0,0.0,0,0,0
060374814021,207.7,140.8,57.1,190,114,76
060374814024,220.9,149.8,60.7,320,204,116
060374814025,248.1,177.8,57.3,232,157,75
060374814026,150.7,108.0,34.8,157,112,45
060374322012,670.2,467.8,179.8,640,431,209
060374003041,1175.8,539.2,561.6,1312,649,663
060374003044,617.3,331.1,239.8,580,292,288
060374004032,927.1,440.3,426.9,740,363,377
060374003021,598.0,269.9,288.6,646,300,346
060374003022,920.5,463.3,410.6,936,463,473
060374016032,703.6,339.6,317.7,737,365,372
060374002073,669.5,289.1,342.0,638,291,347
060374004031,977.6,414.2,510.3,1024,432,592
060374002071,638.5,230.9,385.2,753,283,470
060374002042,1116.1,451.3,600.2,956,381,575
060374002072,1207.8,476.7,663.6,1258,551,707
060374016031,854.3,442.9,354.4,967,500,467
060374016013,706.7,353.4,309.3,685,357,328
060374002041,1475.6,592.2,796.8,1908,786,1122
060374004043,845.5,261.4,535.9,1011,292,719
060374004021,1177.2,424.8,683.1,1245,423,822
060374015001,971.7,539.4,361.9,895,495,400
060374022001,690.7,419.4,227.5,689,450,239
060374022003,1003.1,665.7,288.5,1030,668,362
060374016021,1235.2,624.4,511.3,1191,648,543
060374016022,593.7,317.7,235.1,551,314,237
060374016023,472.1,261.4,176.2,426,254,172
060374016011,647.2,280.1,343.9,576,254,322
060374017032,575.8,379.3,159.3,665,474,191
060374017031,794.2,450.7,287.7,626,392,234
060374021021,619.5,476.2,106.4,584,447,137
060374021022,604.5,462.6,108.6,551,442,109
060374021023,197.1,152.6,32.0,229,172,57
060374021013,400.5,338.0,40.5,350,294,56
060374021011,578.5,456.3,91.7,572,458,114
060374017042,558.0,426.2,103.9,526,435,91
060374017041,617.4,460.0,115.6,414,330,84
060374017012,1140.7,663.9,394.5,1297,783,514
060374017011,840.7,494.7,272.0,728,432,296
060374328023,195.0,153.9,30.2,237,187,50
060374321025,402.9,247.8,137.1,349,216,133
060374328022,193.8,153.0,30.0,148,102,46
060374328021,225.1,177.7,34.9,162,122,40
060374321022,412.5,248.9,142.7,518,300,218
060374321024,251.7,154.8,85.6,298,165,133
060374320003,650.0,351.0,260.0,746,388,358
060374320005,283.1,168.4,100.3,343,184,159
060374319003,432.9,252.8,156.6,408,228,180
060374320004,245.6,146.1,87.0,308,169,139
060374319001,352.1,198.3,132.6,365,209,156
060374319002,400.6,227.2,149.4,387,224,163
060374321021,470.3,278.5,165.0,512,286,226
060374321013,409.9,239.8,147.6,475,252,223
060374316002,541.2,298.8,209.6,628,293,335
060374316003,321.3,176.0,130.1,367,173,194
060374323003,356.4,265.4,72.0,388,278,110
060374321012,556.1,320.6,206.1,511,250,261
060374323002,295.0,223.7,55.3,283,203,80
060374324023,436.7,348.8,63.6,351,246,105
060374324022,375.1,300.2,54.2,370,257,113
060374315011,285.7,186.7,84.9,336,202,134
060374315022,474.1,267.9,185.5,494,246,248
060374315023,251.9,148.5,90.7,126,75,51
060374321011,422.9,257.9,143.9,494,251,243
060374324011,511.7,386.4,100.0,345,240,105
060374320001,659.8,416.8,208.1,463,265,198
060374320002,257.0,162.4,81.1,400,232,168
060374315012,528.7,326.5,174.2,535,324,211
060374315013,466.9,296.7,143.4,508,317,191
060374315021,402.3,222.7,159.0,528,267,261
060374316001,417.4,228.1,171.4,488,248,240
060374317004,308.5,162.8,132.2,418,185,233
060374317005,673.1,392.1,256.2,645,303,342
060374317003,319.6,170.8,135.3,402,189,213
060374318001,574.4,328.3,217.6,516,286,230
060374317002,382.2,209.4,157.3,450,217,233
060374307212,415.9,252.6,141.0,554,289,265
060374307013,438.8,247.6,165.9,434,226,208
060374307012,871.2,531.3,289.7,772,425,347
060374631012,735.4,476.6,207.8,683,439,244
060374307231,418.9,263.5,130.9,397,251,146
060374307242,509.8,315.6,166.0,622,352,270
060374307232,494.3,305.1,161.6,631,378,253
060374307011,381.0,183.2,176.1,498,208,290
060374307014,500.4,230.3,241.2,596,236,360
060374308032,491.0,286.1,178.0,606,303,303
060374308031,324.6,190.0,120.3,463,221,242
060374308024,346.5,194.8,135.1,404,189,215
060374317001,379.2,207.7,156.0,439,209,230
060374307211,454.0,245.4,183.9,355,177,178
060374307213,208.8,112.9,84.6,320,169,151
060374304004,568.8,325.1,205.1,500,272,228
060374304003,337.1,171.1,144.0,343,167,176
060374306004,772.7,409.1,314.9,1013,427,586
060374629002,531.8,370.4,131.6,541,326,215
060374629001,865.7,563.4,240.1,815,527,288
060374600001,671.9,355.0,276.6,745,386,359
060374600003,777.6,439.6,296.3,844,494,350
060374630001,407.8,246.6,134.2,475,258,217
060374630002,783.2,473.4,257.8,665,388,277
060374600002,596.2,330.8,232.9,638,355,283
060374600004,526.7,281.0,216.6,501,299,202
060374306003,293.4,164.3,112.2,384,150,234
060374305022,1023.7,598.7,355.4,907,493,414
060374305025,558.3,337.0,182.3,567,319,248
060374305026,785.1,499.7,235.9,812,470,342
060374305024,342.9,218.3,103.1,322,183,139
060374305011,701.7,427.3,226.4,693,375,318
060374305012,675.7,413.0,216.4,632,368,264
060374305023,735.7,444.4,242.0,855,507,348
060374306002,504.4,252.5,219.9,505,209,296
060374305021,425.6,231.5,166.9,443,232,211
060374305014,729.4,457.0,219.3,800,457,343
060374306001,318.6,166.7,134.4,351,156,195
060374304002,322.4,164.3,138.8,431,198,233
060374305013,444.9,281.0,131.3,481,340,141
060374324012,323.4,250.1,58.2,391,288,103
060374325002,717.8,510.8,170.4,630,420,210
060374325003,534.7,380.5,126.8,545,358,187
060374315024,403.5,226.6,160.9,448,233,215
060374326013,411.7,300.3,89.3,318,210,108
060374326014,489.8,356.8,106.3,427,286,141
060374325001,536.0,373.0,133.3,516,337,179
060374326021,468.1,350.9,90.4,455,338,117
060374308033,432.0,252.7,151.1,499,262,237
060374325004,508.5,345.2,131.7,476,290,186
060374314003,387.5,211.4,155.1,410,225,185
060374312004,675.5,461.3,178.8,591,373,218
060374313002,658.8,393.5,226.7,559,307,252
060374314002,393.5,254.4,113.1,371,244,127
060374314001,384.9,208.8,155.7,457,239,218
060374308023,345.8,198.1,129.3,414,222,192
060374308022,521.4,300.5,191.2,514,244,270
060374308034,379.1,223.4,135.7,419,205,214
060374308035,270.6,160.9,96.1,315,165,150
060374308014,488.7,318.0,147.1,447,274,173
060374308012,634.2,414.8,188.8,699,438,261
060374308011,218.3,136.5,69.6,237,139,98
060374308013,273.0,179.9,79.9,253,161,92
060374309021,858.0,547.9,251.7,871,520,351
060374309022,384.7,251.5,104.6,379,233,146
060374309013,508.4,357.6,117.3,500,355,145
060374309012,335.1,234.2,78.5,415,273,142
060374314004,333.5,215.6,95.9,399,247,152
060374308021,217.5,125.5,79.3,247,131,116
060374313001,468.3,261.1,178.7,552,291,261
060374311002,605.8,459.7,107.4,653,496,157
060374311005,273.6,185.6,73.4,267,193,74
060374309023,208.2,138.6,55.6,182,126,56
060374311001,644.1,495.0,108.7,504,408,96
060374312001,549.9,475.3,50.0,479,439,40
060374048014,537.0,417.0,96.8,499,383,116
060374048012,435.9,343.1,73.3,437,339,98
060374049021,547.6,425.8,89.9,438,333,105
060374049032,461.5,363.5,73.8,435,334,101
060374049022,576.5,432.5,111.2,573,444,129
060374049031,272.6,215.4,43.5,194,145,49
060374048011,403.9,325.0,59.7,277,210,67
060374051022,458.8,363.7,76.6,447,340,107
060374052021,288.5,243.7,32.1,238,182,56
060374049012,481.4,380.5,70.7,446,339,107
060374049011,283.5,223.1,42.3,320,260,60
060374049013,644.6,525.9,78.4,539,419,120
060374050013,385.0,306.2,58.4,413,320,93
060374051013,227.7,178.0,29.3,253,199,54
060374312002,420.8,346.2,52.9,362,309,53
060374312003,266.2,214.5,37.2,255,212,43
060374301023,630.9,515.5,83.4,485,394,91
060374301022,414.5,335.4,57.7,390,309,81
060374301021,548.1,402.0,113.2,497,385,112
060374301013,271.8,199.4,56.1,223,161,62
060374301014,383.3,256.3,103.0,344,214,130
060374301012,269.5,178.3,73.4,245,171,74
060374301011,743.0,487.2,207.2,884,554,330
060374304001,655.1,328.2,282.0,865,423,442
060374310014,1024.2,666.1,297.5,963,595,368
060374006042,977.4,580.8,330.3,456,246,210
060374008001,1425.6,818.0,515.5,1223,540,683
060374009001,465.2,198.5,240.8,512,176,336
060374005011,1190.3,381.3,742.4,1284,432,852
060374010011,688.1,255.8,396.4,758,285,473
060374004041,1063.1,323.6,678.6,1156,432,724
060374010013,584.5,227.3,327.2,667,256,411
060374013043,951.2,445.4,456.8,1041,498,543
060374013041,1476.3,684.2,718.2,1618,708,910
060374013044,410.7,179.0,210.8,470,195,275
060374013121,1132.8,513.7,557.9,1036,479,557
060374013122,1231.2,579.3,576.1,1316,622,694
060374012021,641.0,323.0,287.0,782,418,364
060374013031,1105.4,552.4,502.4,1087,556,531
060374013042,105.3,27.9,73.6,130,50,80
060374003042,488.4,266.2,185.1,361,216,145
060374013113,592.5,353.5,194.2,478,293,185
060374013114,730.1,332.3,344.0,684,314,370
060374013112,773.8,372.8,340.8,657,375,282
060374003043,589.0,296.0,262.0,611,302,309
060374012022,495.4,252.8,205.4,493,257,236
060374012023,859.2,448.2,365.6,804,398,406
060374012011,739.8,324.8,352.5,763,335,428
060374012012,861.7,340.7,455.7,765,318,447
060374013111,816.6,345.9,420.1,993,422,571
060374015002,866.6,433.8,374.5,796,457,339
060374015003,377.9,211.1,145.8,338,208,130
060374009003,540.0,229.1,270.5,394,192,202
060374010023,608.7,282.3,275.9,479,271,208
060374010022,734.7,329.3,352.5,756,363,393
060374036003,768.2,367.4,360.6,894,378,516
060374037223,809.6,496.8,267.4,641,396,245
060374036004,1082.8,604.4,422.1,1107,579,528
060374037022,913.4,470.2,391.0,1147,567,580
060374037021,785.8,413.9,326.4,764,389,375
060374037033,315.2,165.1,132.6,304,158,146
060374037032,1056.2,521.6,478.1,1058,484,574
060374037211,467.2,257.5,177.7,429,255,174
060374038011,818.3,482.7,275.6,726,451,275
060374038013,280.1,155.0,105.3,249,124,125
060374038012,556.6,316.6,200.8,690,382,308
060374012031,1134.1,541.2,517.4,1087,512,575
060374039022,279.5,136.9,123.5,315,153,162
060374038023,1032.7,570.6,391.0,921,500,421
060374038021,720.4,435.8,237.7,674,418,256
060374038022,405.8,242.4,139.4,394,228,166
060374012032,1199.8,577.0,545.1,1063,550,513
060374037031,840.5,457.5,336.3,886,469,417
060374011023,392.2,202.5,165.1,309,156,153
060374011012,511.1,266.7,205.2,381,200,181
060374039011,386.7,198.8,163.1,468,255,213
060374039012,381.4,222.7,136.5,343,202,141
060374011022,474.4,221.6,212.5,422,215,207
060374011021,456.6,213.3,204.5,313,155,158
060374011013,593.8,242.5,306.5,612,268,344
060374011014,488.1,255.5,194.0,558,291,267
060374011011,436.8,188.9,214.8,494,235,259
060374010021,569.6,247.4,286.6,597,252,345
060374010012,386.5,160.8,206.6,414,186,228
060374004022,992.6,418.7,501.5,952,421,531
060379107162,1174.8,791.0,319.0,814,492,322
060379106033,454.3,318.0,103.2,462,294,168
060379106032,423.6,271.4,114.4,398,240,158
060379106034,613.0,423.0,151.0,526,357,169
060379107152,494.7,337.8,127.7,358,256,102
060379107153,857.8,588.9,213.1,659,433,226
060379106031,484.0,296.6,140.4,418,237,181
060379107161,1009.6,659.2,287.0,839,473,366
060379106051,676.1,495.0,134.5,565,415,150
060379106061,548.5,379.3,133.5,471,322,149
060379107151,701.8,511.0,158.5,645,424,221
060379106052,627.6,433.3,155.2,514,324,190
060379106062,258.8,175.9,66.3,232,171,61
060379106021,1007.8,716.1,234.4,719,509,210
060379106012,378.6,273.3,81.6,295,196,99
060379106013,681.5,489.9,146.7,532,383,149
060379107121,896.8,641.8,206.0,772,550,222
060379107111,1369.5,987.2,299.8,1073,686,387
060379107112,762.3,552.3,165.9,714,470,244
060379107142,330.0,237.3,72.3,248,188,60
060379107141,685.9,505.2,138.2,468,331,137
060379107132,1131.4,850.2,218.2,907,637,270
060379107131,493.0,367.2,107.1,379,257,122
060374006031,1508.8,918.6,474.6,1469,882,587
060374006041,437.6,245.1,171.3,462,261,201
060374006021,432.4,262.0,141.5,432,276,156
060374061023,488.9,288.5,167.7,452,248,204
060374061022,334.2,193.4,120.2,408,221,187
060374061021,620.5,407.1,169.9,481,312,169
060374061024,497.9,319.8,143.0,461,267,194
060374061012,495.5,293.4,163.7,382,223,159
060374037213,419.5,245.8,148.6,443,237,206
060374061013,457.5,269.8,155.4,362,203,159
060374061011,384.6,228.6,128.2,358,216,142
060374060001,547.0,339.5,176.6,419,251,168
060374059002,795.8,509.3,238.1,777,503,274
060374045041,480.3,380.2,76.9,288,215,73
060374045042,518.5,411.4,83.6,332,240,92
060374041003,632.6,453.6,143.3,467,333,134
060374059001,784.2,495.9,239.8,602,358,244
060374037212,702.4,419.4,241.6,780,426,354
060374037221,594.8,382.0,180.3,664,417,247
060374037214,322.7,189.2,117.0,324,194,130
060374037222,201.7,119.9,70.4,279,156,123
060374038014,457.3,281.6,146.8,488,307,181
060374039023,666.4,356.2,265.7,746,408,338
060374040004,466.1,308.0,132.1,322,208,114
060374041004,325.6,247.5,59.1,290,207,83
060374040003,192.5,127.4,54.3,203,116,87
060374041002,416.0,313.6,78.2,328,246,82
060374041001,310.0,240.1,51.9,280,213,67
060374042012,415.1,278.3,110.2,512,328,184
060374042021,347.5,230.5,97.2,297,179,118
060374043011,417.2,300.3,91.5,441,327,114
060374042011,529.8,353.7,143.8,338,244,94
060374042022,516.7,352.0,142.9,414,255,159
060374040001,349.9,231.6,100.9,367,222,145
060374040002,359.7,238.0,103.6,363,228,135
060374039013,442.7,234.3,178.6,416,230,186
060374009002,842.3,396.4,378.0,937,481,456
060374039021,729.2,354.0,313.5,781,382,399
060710016002,70.3,55.4,11.6,33,24,9
060710016001,186.0,153.7,24.1,159,132,27
060710018131,291.2,241.2,37.4,243,184,59
060710018132,371.2,308.0,47.1,287,236,51
060710018122,373.2,284.1,67.9,296,239,57
060710014002,400.7,258.3,111.5,187,136,51
060710014001,388.1,250.2,108.0,317,204,113
060710011033,335.3,210.4,101.2,428,246,182
060710015012,298.1,203.0,73.9,188,130,58
060710011011,257.9,164.7,75.3,196,139,57
060710012002,430.8,264.9,134.2,383,225,158
060710013102,430.9,298.4,105.1,382,275,107
060710013103,422.5,292.5,103.1,365,252,113
060710019031,1780.7,942.7,746.4,1310,616,694
060710019053,110.3,62.1,41.7,174,74,100
060710018092,512.2,299.3,177.1,377,240,137
060710018091,372.7,217.8,128.8,496,269,227
060650406092,2569.5,1323.9,1124.8,451,278,173
060650406112,1124.4,612.8,458.7,455,299,156
060650406131,1001.9,530.1,421.5,1123,657,466
060650406111,1744.7,940.8,722.2,1332,733,599
060650406133,1604.2,898.5,639.1,1039,614,425
060650406071,1754.0,983.0,695.0,1087,615,472
060710018063,726.1,401.8,290.3,653,324,329
060710018062,510.6,317.0,167.2,494,280,214
060710018061,565.0,329.6,206.0,602,362,240
060710018083,481.0,269.1,190.5,428,255,173
060710018082,482.1,269.7,190.9,486,257,229
060710018031,916.8,597.0,270.8,808,448,360
060710018102,350.8,238.2,91.1,366,248,118
060710018101,424.2,271.6,131.2,213,158,55
060710018081,551.6,360.5,153.8,550,357,193
060710018103,345.0,243.2,78.4,368,261,107
060710018121,483.9,355.4,102.6,341,254,87
060710015032,302.0,237.4,48.7,206,149,57
060710015031,259.9,204.3,41.9,100,84,16
060710015011,366.3,287.9,59.0,301,237,64
060710013092,330.7,253.5,61.1,308,243,65
060710013093,314.7,241.3,58.2,293,218,75
060710015041,463.0,345.0,97.0,330,254,76
060710015042,642.0,487.0,117.0,581,434,147
060710013082,365.0,260.0,93.0,376,267,109
060710018093,343.3,210.3,111.9,339,187,152
060710022061,893.5,545.9,293.8,800,478,322
060710019062,1119.0,683.0,361.0,877,548,329
060710022064,640.6,383.5,228.1,643,395,248
060710022062,300.7,180.0,107.1,273,162,111
060710022063,534.1,344.6,165.3,520,344,176
060710004042,750.1,413.3,294.3,669,357,312
060710004041,905.0,496.2,377.2,870,466,404
060710006031,1076.8,543.3,481.8,1018,491,527
060710017023,641.0,312.0,289.0,581,250,331
060710003042,758.8,496.8,217.1,673,397,276
060710003041,577.2,375.4,177.2,471,288,183
060710002072,325.9,243.4,61.9,301,213,88
060710003013,435.8,325.5,82.7,196,139,57
060710002081,759.8,534.3,182.5,949,618,331
060710003012,361.8,254.8,88.3,281,198,83
060710002082,402.8,274.8,103.8,374,224,150
060710002053,334.2,228.0,86.2,274,181,93
060710003043,352.9,237.2,109.9,287,175,112
060710017022,483.1,280.3,173.6,606,299,307
060710017021,623.9,362.0,224.2,425,260,165
060710016003,228.4,179.3,38.2,159,125,34
060710010021,340.1,229.8,87.6,272,160,112
060710010022,481.1,351.0,100.4,262,180,82
060710010023,282.2,205.9,58.9,324,226,98
060710010012,418.6,269.3,120.1,439,272,167
060710017032,453.4,245.5,184.0,453,264,189
060710017033,645.6,349.5,262.0,613,328,285
060710019051,778.2,394.2,351.8,645,334,311
060710019011,945.2,479.4,418.5,950,499,451
060710017034,700.3,353.4,313.7,721,387,334
060710017031,639.7,358.6,249.3,591,325,266
060710017042,574.9,360.8,173.1,557,348,209
060710017041,845.1,533.2,279.9,883,544,339
060710017073,681.0,438.0,205.0,718,446,272
060710017072,414.5,274.1,117.9,413,271,142
060710017071,521.4,389.1,107.3,526,380,146
060710018041,585.6,389.3,164.2,519,350,169
060710017062,210.1,146.5,53.5,143,110,33
060710017061,433.2,337.6,75.5,321,253,68
060710017063,669.0,466.5,170.5,746,499,247
060710016005,232.0,190.4,31.0,150,114,36
060710016004,220.1,180.7,29.5,135,108,27
060710011012,324.7,206.2,97.7,311,204,107
060710011043,486.0,308.6,146.2,616,364,252
060710011013,293.8,186.6,88.4,137,108,29
060710011042,338.8,198.1,122.0,393,228,165
060590639031,850.0,413.8,360.3,712,359,353
060590639083,351.3,203.5,109.3,526,334,192
060590639042,553.2,282.1,229.5,626,327,299
060590631012,430.0,184.4,213.9,482,189,293
060590630091,973.5,375.8,534.0,1064,398,666
060590639082,713.0,339.0,317.0,697,360,337
060590630073,1002.0,468.8,474.2,949,520,429
060590626443,1037.0,485.2,490.8,1081,526,555
060590626455,865.0,366.7,453.9,1120,415,705
060590626261,491.0,385.0,81.0,513,385,128
060590626101,1.1,0.7,0.4,1,1,0
060590626113,631.7,413.9,180.4,752,427,325
060590626112,575.8,377.4,164.5,329,264,65
060590626111,230.7,151.2,65.9,126,96,30
060590525214,264.4,173.7,69.6,181,117,64
060590992323,693.0,289.0,364.0,680,267,413
060590992322,586.4,250.7,300.3,585,241,344
060590992321,956.5,409.0,489.8,971,385,586
060590992502,493.3,201.4,268.7,541,245,296
060590992324,545.0,233.0,279.1,582,253,329
060590992501,658.0,307.0,316.0,772,315,457
060590992511,575.2,330.2,206.4,572,322,250
060590992512,1008.7,507.9,436.1,505,300,205
060590992293,884.0,531.0,319.0,897,457,440
060590992301,922.0,398.0,460.9,957,404,553
060590992513,624.1,301.1,282.0,695,302,393
060590992292,864.6,420.9,389.5,1174,525,649
060590992302,1271.6,613.5,574.5,1352,602,750
060590638052,737.9,335.5,354.0,753,331,422
060590992291,958.8,487.4,412.5,856,382,474
060590992252,839.5,362.5,426.0,889,353,536
060590992233,603.9,331.2,247.1,649,258,391
060590992032,1055.1,585.4,422.6,1163,491,672
060590992251,706.3,330.3,338.4,757,331,426
060590992043,809.1,432.7,341.7,916,331,585
060590992232,521.6,276.9,218.1,451,186,265
060590992222,508.6,270.0,212.7,571,207,364
060590992223,467.2,248.0,195.4,520,239,281
060590992224,375.3,199.2,156.9,384,146,238
060590992231,591.3,368.4,200.1,488,184,304
060590992042,318.9,180.8,126.0,320,116,204
060590992041,428.0,242.6,169.1,372,157,215
060590992031,930.4,559.6,334.0,927,413,514
060590889043,400.7,240.1,143.0,439,193,246
060590889044,487.3,291.9,174.0,425,190,235
060590992262,852.0,425.8,390.9,943,361,582
060590992261,776.3,419.0,317.6,774,316,458
060590889033,872.0,593.0,247.0,734,354,380
060590639072,1103.6,546.8,505.8,1207,507,700
060590639073,985.4,475.2,462.2,880,443,437
060590992273,743.4,365.6,345.0,781,340,441
060590992272,284.4,201.5,60.2,332,195,137
060590741082,399.6,316.7,63.8,249,196,53
060590992271,338.6,189.5,137.3,376,165,211
060590748032,742.9,575.4,133.8,636,443,193
060590639021,717.4,344.2,320.2,1064,488,576
060590639032,770.0,392.4,321.2,864,397,467
060590741071,544.0,348.0,160.0,661,405,256
060590741073,629.3,343.4,242.7,594,289,305
060590741102,428.5,258.8,143.9,476,245,231
060590741062,696.2,420.4,233.7,588,316,272
060590741063,424.7,256.4,142.6,463,197,266
060590741061,593.6,412.4,132.9,476,306,170
060590741101,995.0,673.0,276.0,968,525,443
060590741092,378.6,311.8,48.7,272,202,70
060590992274,854.9,494.1,308.3,645,309,336
060590992023,615.8,410.6,178.4,527,314,213
060590992021,708.3,460.1,220.3,832,478,354
060590992022,877.3,611.8,231.1,811,463,348
060590890043,492.7,343.6,129.8,321,153,168
060590890041,434.2,302.8,114.4,312,160,152
060590890012,548.5,382.5,144.5,537,245,292
060590890013,371.2,258.9,97.8,272,137,135
060590992471,336.6,234.7,88.7,370,156,214
060590992472,446.7,311.5,117.7,391,227,164
060590992482,499.1,371.9,102.8,534,279,255
060590992481,364.5,271.6,75.1,279,154,125
060590992492,294.2,219.3,60.6,179,83,96
060590992491,361.2,269.2,74.4,288,189,99
060590891052,300.7,249.7,38.9,246,194,52
060590741081,669.3,532.5,104.8,575,432,143
060590748033,443.7,343.7,79.9,281,231,50
060590748031,909.2,680.2,179.7,846,552,294
060590891053,327.3,257.3,55.1,259,168,91
060590752011,765.9,612.1,110.3,561,438,123
060590748021,284.7,246.6,21.0,211,183,28
060590748022,264.0,228.7,19.5,272,214,58
060590748023,401.3,347.6,29.6,207,165,42
060590889012,434.0,290.0,121.0,434,226,208
060590889011,368.2,243.3,111.3,407,186,221
060590889013,557.8,368.7,168.7,595,226,369
060590889032,868.4,506.6,313.3,816,332,484
060590889021,423.2,282.3,120.3,440,209,231
060590889022,575.1,379.7,165.3,648,284,364
060590888012,190.8,126.2,53.5,97,52,45
060590887014,229.6,130.4,88.8,388,188,200
060590887012,476.4,270.6,184.2,385,171,214
060590887022,536.0,369.0,146.0,407,175,232
060590887013,550.0,344.6,176.0,614,295,319
060590887011,272.0,170.4,87.0,117,63,54
060590889031,596.6,360.4,215.7,622,284,338
060590889023,383.7,251.0,111.4,392,190,202
060590886013,617.1,410.3,172.5,623,332,291
060590886014,298.9,198.7,83.5,201,102,99
060590886011,347.7,208.4,120.3,320,161,159
060590886012,651.5,398.4,216.5,582,286,296
060590886021,651.6,403.7,215.4,589,313,276
060590883012,975.2,527.6,406.7,986,443,543
060590883023,656.7,387.6,237.0,714,321,393
060590886022,647.5,396.4,222.5,699,310,389
060590890032,503.4,343.8,134.4,474,271,203
060590890031,413.0,252.9,141.9,266,131,135
060590882032,621.0,362.0,225.0,554,277,277
060590882031,846.0,482.6,314.7,873,410,463
060590882022,671.5,350.8,277.6,585,242,343
060590882021,422.9,238.1,163.3,468,252,216
060590877031,491.2,330.0,131.5,371,243,128
060590877032,483.8,325.0,129.5,448,242,206
060590877043,456.4,296.5,140.3,335,173,162
060590877042,395.7,238.6,136.0,394,196,198
060590877044,475.0,278.8,170.0,588,295,293
060590876012,400.7,235.2,143.4,405,175,230
060590877041,373.2,219.0,133.6,199,113,86
060590883013,385.3,219.2,144.9,503,247,256
060590883011,563.8,320.8,212.1,330,158,172
060590883022,732.0,385.0,307.0,787,342,445
060590883021,847.4,495.3,301.0,809,394,415
060590876022,630.6,358.7,237.0,597,328,269
060590876025,344.5,198.1,125.9,381,206,175
060590876023,436.4,275.8,134.9,387,211,176
060590876021,401.7,251.0,122.7,337,161,176
060590876024,443.3,277.0,135.3,433,252,181
060590876013,460.0,291.6,138.8,558,313,245
060590871061,538.7,341.4,162.6,405,255,150
060590876011,265.5,168.3,80.1,185,112,73
060590871062,701.2,458.1,196.1,532,336,196
060590890042,737.8,516.6,185.4,577,322,255
060590890014,472.7,331.0,118.8,516,261,255
060590890011,378.6,265.2,95.1,381,208,173
060372172002,286.7,255.3,19.4,260,243,17
060372172003,466.1,416.4,29.2,459,426,33
060372182202,819.9,729.0,53.8,716,672,44
060372171001,590.2,517.4,44.5,652,613,39
060372182101,227.2,200.6,13.6,192,179,13
060372172001,413.1,357.0,34.5,387,350,37
060372183001,437.3,388.2,23.7,396,364,32
060372183002,359.5,316.1,20.3,302,286,16
060372172004,469.8,422.2,25.0,431,412,19
060372162005,695.8,606.7,55.8,642,578,64
060372162002,617.5,561.8,29.6,627,590,37
060372162001,335.2,293.5,29.2,349,311,38
060372162003,320.4,272.3,37.0,354,298,56
060372162004,607.2,516.2,70.1,300,257,43
060372145033,126.5,103.2,18.6,170,139,31
060372145034,131.5,107.3,19.4,152,115,37
060372145032,284.4,232.1,41.9,399,316,83
060372145031,326.6,268.2,45.5,325,272,53
060372151012,440.1,378.1,39.1,441,381,60
060372145022,399.4,329.5,50.6,390,315,75
060372145023,428.6,353.5,54.4,560,452,108
060372144001,651.2,571.9,55.1,622,555,67
060372145021,742.0,621.1,85.6,553,453,100
060372151021,652.3,564.1,51.3,612,526,86
060372151022,1026.0,875.0,102.0,928,808,120
060372140002,493.1,306.3,170.2,558,346,212
060372140004,395.5,234.1,147.3,417,236,181
060372140003,418.7,246.0,157.7,455,240,215
060372140001,341.7,182.7,145.7,376,204,172
060372128003,499.3,421.3,49.6,430,358,72
060372161003,410.3,354.4,37.2,410,366,44
060372161002,589.5,518.2,38.8,592,537,55
060372128002,422.9,352.9,43.4,350,291,59
060372128001,553.3,455.6,60.6,517,421,96
060372129002,631.7,516.5,65.2,427,362,65
060372127023,338.1,284.3,43.2,328,228,100
060372127021,646.2,535.2,82.7,591,440,151
060372161001,304.8,256.3,38.9,374,299,75
060372110006,474.8,368.5,83.9,339,240,99
060372110004,295.8,202.9,80.5,338,232,106
060372110005,415.5,315.9,80.7,425,306,119
060372141004,650.4,461.4,166.9,647,458,189
060372141003,309.8,217.3,81.8,283,185,98
060372141002,493.8,341.3,132.8,607,353,254
060372141001,510.2,387.9,106.4,483,341,142
060372110003,374.0,255.1,104.1,435,254,181
060372110002,303.0,196.2,94.7,294,201,93
060371923001,307.9,247.9,47.2,281,204,77
060371923002,502.6,355.0,124.1,386,291,95
060372340002,372.5,339.4,20.3,458,442,16
060372190203,414.4,370.5,24.4,310,290,20
060372340001,839.0,766.9,44.4,715,670,45
060372340003,495.0,458.3,21.5,539,524,15
060372190101,484.9,451.8,20.9,398,367,31
060372190102,535.2,497.4,21.8,425,391,34
060372190202,489.1,439.8,29.8,494,457,37
060372190201,623.0,557.5,36.2,542,513,29
060372314003,465.8,430.9,24.9,434,404,30
060372314001,512.0,462.0,26.0,411,382,29
060372220021,358.4,325.3,16.2,308,298,10
060372220024,435.8,395.6,19.7,382,350,32
060372220022,312.4,283.5,14.1,276,255,21
060372220023,333.5,302.7,15.0,284,268,16
060372220011,476.6,437.6,20.3,464,427,37
060372220012,597.4,541.5,33.5,489,451,38
060374029022,817.9,627.4,131.6,555,435,120
060374029021,633.8,498.1,95.0,546,412,134
060374029031,946.4,772.9,123.1,757,596,161
060374029041,443.4,342.0,70.7,402,307,95
060374028032,295.1,243.2,36.5,228,181,47
060374025022,996.3,812.7,125.4,798,646,152
060374025011,239.7,201.4,26.5,256,218,38
060374025012,487.6,407.7,56.0,342,295,47
060374024021,302.6,232.9,47.6,256,189,67
060374025021,317.8,262.1,40.7,257,204,53
060374023041,322.3,265.4,35.9,228,185,43
060374023042,239.8,184.3,34.5,169,139,30
060374023012,700.2,542.3,108.2,483,381,102
060374023034,201.5,149.8,34.3,187,146,41
060374023011,675.9,519.3,109.1,591,456,135
060374023033,157.3,112.6,29.3,168,126,42
060374023031,284.8,198.3,56.4,167,125,42
060374023032,170.3,118.6,33.7,135,107,28
060374022002,834.2,527.9,245.0,702,468,234
060374028031,202.1,168.8,24.1,172,129,43
060374028013,228.8,181.7,30.9,120,101,19
060374088003,189.9,150.8,25.6,149,109,40
060374026004,482.3,324.6,119.1,429,290,139
060374026002,545.4,385.0,131.8,330,230,100
060374026005,615.2,415.9,154.6,682,421,261
060374026001,330.6,235.8,80.2,323,232,91
060374029042,499.8,386.6,76.2,460,361,99
060710004013,550.9,253.9,272.5,417,189,228
060710004012,367.1,166.1,187.5,416,192,224
060710004011,725.3,411.6,278.0,533,304,229
060710004033,664.6,312.5,328.4,624,282,342
060710005032,527.9,266.8,232.9,618,300,318
060710005013,784.8,402.6,335.2,757,375,382
060374024024,452.2,308.7,112.7,385,250,135
060374032001,69.6,48.3,16.6,12,7,5
060374024022,342.0,231.6,88.1,334,250,84
060374024023,615.5,432.8,139.9,613,431,182
060374024051,252.8,216.7,24.4,209,191,18
060374024053,436.5,374.1,41.9,365,323,42
060374024041,765.0,584.2,72.7,24,13,11
060374024062,801.2,646.9,98.5,778,638,140
060374024052,144.1,123.5,13.7,146,127,19
060374024061,322.4,260.7,39.4,88,76,12
060710001173,405.1,208.4,174.6,384,198,186
060710001174,495.4,253.1,221.1,455,230,225
060710001171,757.2,389.6,326.4,1001,444,557
060710001172,1318.0,609.0,663.0,1370,638,732
060710001083,820.4,398.9,377.8,847,429,418
060710001111,1131.0,475.2,590.4,1103,435,668
060710001082,648.6,282.7,338.2,626,293,333
060710001081,632.0,272.8,332.7,764,330,434
060710001051,648.1,329.5,292.2,783,360,423
060710001052,1024.1,557.8,425.3,1097,533,564
060710001053,804.8,477.9,294.2,729,397,332
060710001042,629.8,342.9,247.6,653,358,295
060710001032,571.6,291.4,251.2,501,278,223
060710001033,750.5,420.2,292.3,530,298,232
060710001041,1049.8,566.1,431.6,982,506,476
060710001031,456.8,228.9,206.3,567,287,280
060710001043,694.0,392.1,269.2,850,433,417
060710001093,787.3,345.5,403.7,799,323,476
060710001095,662.4,274.5,351.6,687,282,405
060710001091,678.2,284.7,359.3,620,273,347
060710001094,635.2,284.9,310.0,619,278,341
060710001092,414.0,165.8,220.7,403,185,218
060710001134,672.0,353.1,279.8,700,342,358
060710001135,928.3,472.9,400.2,708,390,318
060710001132,655.3,359.4,260.8,554,310,244
060710001133,592.8,309.0,253.6,415,248,167
060710001071,1316.0,537.1,693.6,1374,593,781
060710004014,962.0,428.0,487.0,959,443,516
060710005043,1033.3,507.1,482.7,1031,554,477
060374033184,506.9,299.4,184.9,527,313,214
060374033181,577.1,406.6,150.1,601,397,204
060374030001,635.2,505.9,90.1,556,440,116
060374030002,360.6,297.3,42.1,414,358,56
060374030003,608.2,483.8,83.9,559,460,99
060710001181,1077.3,546.9,481.7,956,500,456
060374033243,1052.6,579.3,413.5,1161,599,562
060374033202,1414.1,802.5,560.5,1326,715,611
060374033201,754.0,444.3,270.3,937,553,384
060710001182,960.3,488.6,436.7,857,419,438
060374033122,578.0,355.0,193.0,612,361,251
060374033121,899.5,522.9,334.1,749,435,314
060374033123,412.5,240.1,150.9,547,310,237
060374033191,788.0,489.0,246.0,811,493,318
060374034032,622.0,398.0,208.0,696,376,320
060374034031,860.0,536.8,291.3,1019,594,425
060374034033,681.4,440.5,210.8,611,322,289
060374033163,818.0,477.0,303.0,877,488,389
060374033231,389.0,224.5,143.8,592,327,265
060374033211,1167.0,663.3,428.0,1203,660,543
060374033212,818.0,487.0,293.0,832,498,334
060374024032,726.3,542.7,136.8,985,729,256
060374033161,851.0,486.0,309.0,1028,585,443
060374035001,691.5,355.8,304.8,721,316,405
060374024031,336.9,275.3,41.9,304,262,42
060374033162,1043.0,628.0,360.0,1096,646,450
060374033171,1148.8,703.2,382.5,1068,643,425
060374033213,377.9,224.4,132.5,456,260,196
060374033183,917.8,580.9,287.1,935,551,384
060374033172,547.0,347.8,164.3,595,379,216
060374033182,690.8,437.1,222.8,761,470,291
060374033173,442.3,248.3,171.5,369,212,157
060372131002,293.4,238.5,39.0,338,261,77
060372131001,338.0,276.5,43.7,290,230,60
060372132012,346.7,287.6,43.8,196,138,58
060372132013,132.4,112.2,12.7,34,28,6
060372126202,425.6,349.1,52.4,266,205,61
060372126201,460.6,370.3,65.8,438,326,112
060372126102,444.7,369.1,51.8,410,316,94
060372117041,346.2,290.2,38.9,427,321,106
060372117042,512.9,428.8,60.7,408,298,110
060372126101,515.6,424.1,64.6,342,240,102
060372115003,604.6,474.2,102.9,629,467,162
060372117012,421.3,337.8,64.4,404,294,110
060372115001,434.0,346.6,67.1,462,342,120
060372110001,524.0,407.1,95.9,472,316,156
060372117013,239.7,197.2,31.7,240,186,54
060372117011,381.9,314.1,50.4,357,247,110
060372117032,606.0,507.0,67.7,439,340,99
060372117031,677.4,558.5,79.6,390,311,79
060372115002,723.7,586.9,102.1,619,471,148
060372132022,365.8,310.2,34.8,338,267,71
060372132021,286.2,242.8,27.2,273,220,53
060372125011,500.1,423.4,49.8,380,313,67
060372132011,338.2,290.4,27.8,160,120,40
060372125022,342.3,293.1,28.2,308,243,65
060372125021,328.2,275.9,36.2,217,157,60
060372118021,471.0,390.1,54.5,351,269,82
060372118022,345.2,286.8,39.6,310,245,65
060372124102,478.5,406.0,42.8,314,243,71
060372124101,232.8,190.5,30.2,153,122,31
060372123041,317.7,272.0,25.1,222,176,46
060372124201,324.5,268.3,38.4,229,168,61
060372124202,234.0,199.2,21.5,151,114,37
060372133102,374.6,320.1,34.8,245,196,49
060372133101,332.6,284.2,30.8,217,169,48
060372133201,262.3,224.4,24.1,243,190,53
060372133202,237.3,203.2,21.5,252,195,57
060372123031,524.4,448.2,42.8,282,227,55
060372123061,188.9,154.4,19.9,133,104,29
060372123062,224.8,183.7,23.7,184,143,41
060372123051,364.4,297.9,38.4,287,238,49
060372118041,215.6,172.1,31.6,156,111,45
060372114101,479.7,377.3,77.3,387,254,133
060372114102,180.8,141.1,30.2,168,120,48
060372118042,370.1,290.8,59.2,354,257,97
060372118031,283.7,225.3,42.9,234,175,59
060372118032,296.4,235.3,44.8,276,210,66
060372114202,310.9,251.3,43.7,291,194,97
060372114201,621.7,510.5,80.0,423,299,124
060372119103,263.6,231.5,20.6,229,194,35
060372119101,267.3,234.7,20.8,141,117,24
060372119221,258.3,217.6,26.7,166,139,27
060372119102,273.7,228.7,29.5,201,157,44
060372119222,369.5,310.9,38.5,279,239,40
060372121011,286.0,231.3,36.2,190,144,46
060372121022,366.9,296.8,46.4,232,175,57
060372119211,502.1,406.0,64.0,361,281,80
060372113202,393.6,335.1,35.9,283,239,44
060372113102,415.1,356.5,39.9,284,237,47
060372113101,258.3,221.8,24.8,166,139,27
060372112021,528.3,449.3,46.1,411,327,84
060372112012,378.0,327.1,32.8,277,226,51
060372112011,145.2,125.6,12.6,139,108,31
060371926201,416.0,352.4,34.9,231,182,49
060372404013,310.3,288.2,13.8,282,275,7
060372404012,422.6,392.0,18.2,322,295,27
060372404021,337.4,312.5,14.3,323,313,10
060372404011,404.1,373.3,19.6,311,294,17
060372403004,169.7,157.0,7.3,183,168,15
060372403003,333.5,310.3,13.6,278,266,12
060372403001,378.6,348.5,14.1,314,300,14
060372403002,238.4,219.5,8.9,156,143,13
060374034083,828.6,540.7,250.3,776,448,328
060374034081,342.4,223.9,104.1,434,256,178
060374034082,414.2,268.2,122.2,415,244,171
060374034084,404.8,262.1,119.4,486,290,196
060374034013,927.4,593.9,294.9,1122,648,474
060374081361,779.5,507.4,226.7,659,447,212
060374034011,583.7,353.4,200.4,628,351,277
060374034072,400.9,243.4,137.6,364,204,160
060374034085,645.3,391.3,219.7,605,365,240
060374034071,344.2,205.2,121.1,420,246,174
060374080051,673.8,377.1,264.6,775,391,384
060374080053,656.0,441.5,179.4,388,262,126
060374080052,494.2,285.4,183.9,709,412,297
060374064021,306.8,173.9,117.2,359,205,154
060374064122,642.2,380.8,229.3,699,390,309
060374064121,429.8,256.0,152.4,456,268,188
060374064111,370.0,241.2,108.6,340,206,134
060374062001,603.4,383.3,186.5,519,280,239
060374062003,786.3,535.6,204.9,714,463,251
060374060004,503.9,275.5,202.0,534,273,261
060374063002,1354.9,714.8,582.0,1270,628,642
060374063001,819.1,436.4,347.9,859,441,418
060374036001,758.5,468.9,244.9,637,364,273
060374036002,425.9,197.8,205.7,304,132,172
060374034042,551.5,341.1,187.0,605,325,280
060374034021,1007.5,622.1,339.6,905,528,377
060374034022,453.0,266.3,162.4,516,300,216
060374034041,280.5,157.5,105.3,470,248,222
060374034061,959.2,565.3,333.8,1015,585,430
060374033031,1038.6,633.0,354.0,1090,684,406
060374034051,774.4,469.3,261.4,680,415,265
060374079001,1523.0,1123.9,319.6,1510,1062,448
060374080041,724.8,518.7,173.7,597,406,191
060374080032,1038.7,726.8,265.7,1092,752,340
060374081392,569.7,489.8,52.0,488,410,78
060374081391,500.6,442.1,38.3,344,295,49
060374081382,809.7,645.4,120.4,794,607,187
060374081332,434.0,328.5,86.4,180,132,48
060374080061,862.0,605.0,212.0,814,535,279
060374081331,259.4,194.4,53.5,506,339,167
060374081352,405.2,282.9,104.2,396,250,146
060374081351,969.0,675.9,253.1,859,571,288
060374081333,623.4,432.4,161.2,557,362,195
060374066024,623.4,431.6,147.8,633,404,229
060374066023,351.1,230.7,98.7,342,206,136
060374066021,379.1,238.5,120.5,430,273,157
060374066022,267.8,168.5,85.1,229,147,82
060374080031,671.1,494.7,140.5,602,460,142
060374066012,690.9,476.4,176.8,706,476,230
060374066013,696.0,455.2,206.8,665,420,245
060374066011,680.2,449.3,195.8,705,450,255
060374067022,729.8,480.3,211.8,466,323,143
060374067024,326.1,209.5,94.9,322,217,105
060374067023,585.1,411.5,137.0,511,351,160
060374055001,249.7,163.1,73.5,287,192,95
060374055002,439.0,289.3,128.2,422,269,153
060374065003,598.2,419.3,146.3,647,437,210
060374065002,710.0,473.8,197.2,662,423,239
060374065004,259.3,180.7,62.1,302,198,104
060374065005,370.2,257.3,88.0,258,190,68
060374065001,370.6,251.9,96.4,356,250,106
060374056003,332.8,214.3,104.1,308,191,117
060374056001,534.5,344.0,162.2,545,346,199
060374056002,449.7,290.9,139.3,422,243,179
060374064022,346.6,224.6,104.8,338,195,143
060374064023,304.5,197.2,92.0,337,191,146
060374056004,354.5,233.6,105.2,329,210,119
060374056005,376.7,252.4,101.6,507,325,182
060374064112,401.9,287.2,94.5,357,242,115
060374062002,502.6,339.4,133.1,412,252,160
060374087222,694.7,408.3,246.2,756,402,354
060374087032,1283.7,732.5,482.2,1340,700,640
060374087052,663.0,410.4,209.8,742,428,314
060374087051,398.4,245.1,128.1,369,229,140
060374087053,572.2,326.0,221.0,569,318,251
060374076021,243.9,187.3,44.4,265,199,66
060374076022,213.2,159.1,43.7,256,184,72
060374076012,333.9,262.2,52.5,288,223,65
060374076013,266.0,207.7,44.9,175,137,38
060374076011,414.5,326.3,64.1,336,272,64
060374076023,345.6,277.8,50.0,321,234,87
060374076024,310.9,250.4,44.5,244,189,55
060374075011,563.0,453.8,83.6,538,428,110
060374075013,342.1,250.9,62.7,260,189,71
060374075022,443.6,331.8,85.9,349,260,89
060374075012,231.8,167.1,44.1,231,159,72
060374075021,310.9,234.9,53.0,223,172,51
060374078022,491.1,385.5,77.8,404,314,90
060374079002,351.0,264.2,69.0,342,240,102
060374073012,453.9,353.4,72.3,385,299,86
060374074001,660.0,472.0,141.0,650,442,208
060374068002,761.5,522.5,213.8,680,416,264
060374068003,575.0,392.7,151.7,533,332,201
060374069023,296.5,203.7,77.5,288,185,103
060374068001,389.1,264.9,102.7,277,192,85
060374067021,376.2,262.6,91.4,267,181,86
060374053023,251.0,179.3,59.9,284,176,108
060374053024,375.7,268.4,89.6,399,272,127
060374067011,529.0,372.5,124.0,451,299,152
060374067012,330.9,232.2,78.4,336,244,92
060374067013,249.4,170.8,66.3,290,200,90
060374075023,327.5,260.3,48.5,267,200,67
060374077011,419.9,333.0,57.9,274,195,79
060374077012,501.3,391.4,80.6,479,364,115
060374077013,231.2,183.3,31.9,254,194,60
060374082111,255.0,176.6,64.3,345,227,118
060374078013,443.6,335.8,84.5,492,368,124
060374078011,350.9,272.1,60.8,371,301,70
060374078012,580.2,437.9,111.5,530,414,116
060374086241,732.4,449.0,242.7,764,453,311
060374086311,1103.8,726.7,304.5,1064,702,362
060374086242,407.3,240.4,147.6,498,287,211
060374086312,366.7,245.2,103.2,425,271,154
060374086301,257.1,186.2,56.1,273,204,69
060374086302,411.2,297.9,89.7,440,324,116
060374086313,231.1,161.1,49.1,214,163,51
060374086281,654.8,405.0,214.7,836,472,364
060374086283,506.3,312.4,171.3,394,238,156
060374086282,511.8,316.3,171.4,616,345,271
060374086231,1087.0,705.5,338.9,1048,642,406
060374086271,653.2,392.9,226.0,791,422,369
060375001001,752.6,282.8,427.8,752,274,478
060374087031,711.6,360.7,317.9,664,332,332
060374086272,383.4,231.0,133.6,386,239,147
060374086263,466.8,290.4,148.6,583,333,250
060374087221,729.3,442.5,240.6,661,404,257
060374087231,647.0,401.1,201.1,765,479,286
060374087242,495.5,305.4,150.7,288,205,83
060374086262,277.4,174.8,86.7,410,238,172
060374087241,317.3,215.1,88.2,216,146,70
060374086261,258.3,175.1,71.8,312,179,133
060374082112,528.5,352.8,146.1,381,258,123
060374081401,565.4,467.5,62.4,461,386,75
060374077023,377.7,272.7,86.7,413,282,131
060374077021,1057.2,784.9,218.7,870,641,229
060374072003,487.8,388.5,75.8,423,323,100
060374072004,224.9,179.4,32.8,172,140,32
060374073021,356.1,287.0,48.7,347,281,66
060374073022,380.0,305.5,53.9,371,304,67
060374072005,381.8,304.9,52.6,402,322,80
060374073014,317.0,253.7,47.3,232,192,40
060374073023,287.6,230.2,43.4,303,229,74
060374073013,358.4,292.4,50.0,329,266,63
060374077022,599.2,483.2,91.3,526,391,135
060590015031,943.4,383.7,480.4,1102,462,640
060590015044,509.1,278.8,195.7,411,217,194
060590015041,397.3,200.9,171.7,345,178,167
060590015072,386.6,175.1,184.0,340,165,175
060590015043,391.7,198.1,169.3,389,180,209
060590015073,878.6,389.4,443.4,885,384,501
060590015061,907.7,374.3,471.0,867,352,515
060590015062,1233.4,544.6,632.6,1230,518,712
060590218142,763.3,386.6,312.1,684,336,348
060590218151,1791.7,921.8,787.8,1133,504,629
060590218144,841.3,375.8,388.6,884,383,501
060590218141,1250.2,566.3,620.0,1148,480,668
060590117111,614.4,260.2,310.2,499,232,267
060590117151,778.4,292.1,436.7,936,325,611
060590117152,1676.1,665.7,922.4,1719,660,1059
060590117153,999.4,420.2,517.5,907,344,563
060590117112,526.3,305.2,176.8,518,319,199
060590117102,1091.0,425.7,588.4,1145,417,728
060590117122,672.0,423.0,202.9,466,281,185
060590117101,772.6,331.9,390.9,843,342,501
060590117092,855.2,352.0,461.0,828,306,522
060590117093,1043.3,393.9,576.1,1125,447,678
060590117091,625.0,235.9,345.2,671,279,392
060590218153,2195.3,873.3,1216.5,2306,872,1434
060590218143,675.9,267.0,376.4,618,212,406
060590117181,824.5,313.0,453.4,798,279,519
060590117171,1052.8,378.7,608.2,993,371,622
060590117182,957.9,339.8,556.0,976,374,602
060590117172,436.9,165.0,241.3,457,184,273
060590218092,666.2,235.0,399.7,624,213,411
060590218101,580.5,204.5,339.1,588,226,362
060590218202,1498.9,664.3,748.9,1416,613,803
060590218102,768.6,323.9,400.3,847,356,491
060590218103,551.1,196.5,327.3,528,215,313
060590218222,1348.1,500.1,771.9,916,293,623
060590218091,914.2,316.5,549.2,947,341,606
060590218025,754.2,282.1,433.2,738,239,499
060590218023,672.7,240.2,394.7,660,247,413
060375001002,758.7,320.0,400.1,738,295,443
060374086292,573.7,347.2,204.4,601,326,275
060590524204,1214.4,717.7,451.9,1382,660,722
060590524213,597.7,332.8,233.0,625,311,314
060590524041,803.2,514.7,248.6,0,0,0
060590524184,1430.3,931.6,425.1,363,265,98
060590524191,732.2,391.0,290.6,669,322,347
060590524203,2640.0,1630.0,878.0,3332,1926,1406
060590756072,1046.6,547.3,432.5,921,487,434
060590524192,790.3,385.2,354.9,815,373,442
060590756064,1175.0,576.0,530.9,1097,439,658
060590756051,450.1,175.7,249.2,564,183,381
060590756053,713.6,255.9,402.6,782,303,479
060590219123,688.8,233.9,415.4,672,228,444
060590219172,595.0,242.6,314.9,619,222,397
060590756054,551.7,230.3,286.5,311,159,152
060590756052,858.3,358.4,445.7,983,408,575
060590756055,696.0,290.6,361.4,662,291,371
060590756044,789.6,345.0,394.6,866,323,543
060590756045,1171.7,533.4,572.0,1300,520,780
060590219122,1069.2,380.0,620.3,998,299,699
060590219234,605.3,235.0,326.2,572,233,339
060590219231,1337.2,605.4,678.7,1368,594,774
060590877014,200.2,130.9,60.4,210,109,101
060590877013,381.4,218.4,141.5,370,175,195
060590877011,451.6,258.6,167.5,450,198,252
060590871031,767.0,448.0,274.0,665,306,359
060590871032,770.0,464.0,269.0,773,431,342
060590871023,217.0,159.6,44.6,95,65,30
060590871022,494.3,344.5,112.5,757,456,301
060590871021,259.5,190.9,53.3,188,134,54
060590867023,559.3,398.4,124.1,467,308,159
060590867021,387.2,267.6,96.9,361,231,130
060590871034,519.3,324.4,171.9,509,261,248
060590871033,471.7,294.6,156.1,388,208,180
060590871052,1051.2,640.4,356.6,966,516,450
060590871051,512.7,326.0,159.0,457,249,208
060590867022,594.5,436.0,115.0,460,308,152
060590872001,807.2,464.6,292.2,775,432,343
060590866023,699.9,469.4,181.7,611,380,231
060590866022,381.2,255.8,96.9,191,120,71
060590866012,308.0,236.5,52.6,338,233,105
060590866011,306.8,235.6,52.4,158,128,30
060590866015,234.1,179.8,40.0,211,156,55
060590867013,843.5,489.1,305.7,780,425,355
060590867014,648.5,391.9,228.3,748,366,382
060590019031,537.4,278.7,221.6,578,285,293
060590019021,544.0,314.5,196.7,444,233,211
060590019022,561.2,325.9,199.9,536,291,245
060590110006,630.2,303.7,279.0,666,305,361
060590110001,313.7,151.4,138.8,139,71,68
060590110003,254.2,145.0,96.5,256,125,131
060590110004,739.7,338.5,347.3,674,315,359
060590111012,684.0,411.0,233.0,584,319,265
060590111011,795.0,473.0,278.0,744,428,316
060590111023,525.7,376.2,124.6,564,336,228
060590116014,349.7,249.6,80.4,232,147,85
060590116015,252.6,180.2,58.0,138,111,27
060590111021,486.6,284.8,170.6,412,230,182
060590112004,568.9,316.7,209.2,524,288,236
060590111022,477.8,279.6,167.5,371,200,171
060590112001,427.3,249.2,138.4,345,201,144
060590110005,423.9,187.2,208.2,379,158,221
060590110002,402.2,177.6,197.6,471,230,241
060590017042,430.4,214.6,198.1,356,144,212
060590017063,569.9,244.7,284.9,477,170,307
060590017041,1033.8,611.3,369.8,924,441,483
060590112003,416.4,211.5,175.5,369,168,201
060590017062,461.5,196.5,231.5,518,195,323
060590112002,438.3,224.1,180.4,452,232,220
060590113002,719.7,351.4,324.2,838,336,502
060590872002,739.0,476.2,207.6,704,426,278
060590874012,812.0,537.0,192.0,667,423,244
060590872003,342.7,253.5,70.4,140,103,37
060590872004,675.1,405.7,244.8,596,330,266
060590866021,433.9,290.8,115.4,350,221,129
060590873003,510.7,376.0,95.8,291,206,85
060590873005,352.5,258.2,67.9,289,196,93
060590865013,313.6,217.4,79.5,219,174,45
060590865011,465.3,347.2,91.5,339,234,105
060590865012,356.8,261.0,76.1,397,265,132
060590874052,216.2,165.7,38.9,140,81,59
060590874053,528.9,405.3,95.1,362,250,112
060590874042,196.1,150.3,35.3,249,160,89
060590874051,247.8,189.9,44.6,220,168,52
060590874041,413.1,316.6,74.3,197,159,38
060590863033,895.0,559.0,277.0,851,468,383
060590863013,802.1,547.5,209.5,624,380,244
060590873002,996.4,710.5,216.0,651,446,205
060590874011,605.3,442.9,116.8,339,249,90
060590865022,272.0,222.1,33.2,143,108,35
060590865023,388.2,317.0,47.4,316,261,55
060590873001,356.2,244.5,89.3,96,67,29
060590873004,330.9,227.1,82.9,274,184,90
060590866013,485.1,378.4,76.8,330,233,97
060590866014,351.6,274.3,55.7,265,193,72
060590116016,373.5,281.7,70.4,274,180,94
060590116012,412.7,311.3,77.8,225,152,73
060590116011,295.8,225.9,54.4,191,139,52
060590116023,391.9,295.1,68.6,352,248,104
060590116013,201.1,127.9,62.6,186,125,61
060590116022,713.5,499.2,164.7,682,469,213
060590113003,545.3,302.1,206.5,461,274,187
060590114011,281.4,164.4,93.8,245,149,96
060590113001,784.0,510.1,207.4,605,414,191
060590114012,752.2,381.3,322.2,830,394,436
060590116021,370.8,279.3,67.0,137,91,46
060590865021,366.0,248.8,93.6,140,100,40
060590864041,735.7,528.9,167.2,566,372,194
060590864042,402.1,299.1,78.8,321,212,109
060590114035,421.0,281.9,98.6,415,293,122
060590114034,231.6,160.8,48.8,172,117,55
060590114032,316.1,200.5,93.7,342,201,141
060590114033,435.0,256.0,155.0,416,241,175
060590114021,528.4,262.7,224.8,548,262,286
060590114031,404.9,201.3,172.2,370,170,200
060590114022,807.3,391.8,360.2,833,394,439
060590017074,620.0,343.0,251.0,713,366,347
060590017082,590.8,277.4,277.7,675,244,431
060590017081,556.2,270.6,251.3,505,226,279
060590016015,1105.4,520.1,514.4,1316,496,820
060590017061,563.8,251.7,279.9,611,220,391
060590017083,752.8,334.1,379.9,684,277,407
060590017064,454.4,207.1,218.2,545,191,354
060590017053,477.1,223.0,218.1,551,260,291
060590017052,349.1,173.3,150.6,400,159,241
060590017051,816.9,405.7,352.4,741,399,342
060590013033,607.0,381.1,186.5,467,282,185
060590013031,622.6,369.8,218.1,524,317,207
060590013032,633.0,400.4,186.1,537,311,226
060590013042,711.4,439.6,239.9,609,337,272
060590011033,451.3,268.5,156.6,386,213,173
060590011031,329.1,186.2,124.7,342,170,172
060590012011,367.8,231.1,115.7,363,231,132
060590012013,428.7,270.9,132.8,290,184,106
060590011011,619.4,310.6,273.6,614,289,325
060590012023,224.8,146.7,63.8,139,79,60
060590014013,424.8,223.6,176.7,406,170,236
060590012012,385.4,248.8,112.5,277,169,108
060590013041,261.6,172.8,72.1,230,154,76
060590012021,386.9,255.5,106.6,324,201,123
060590012022,257.9,170.3,71.1,298,171,127
060590014043,266.4,184.9,63.9,280,170,110
060590014012,377.8,165.1,189.2,404,195,209
060375420001,452.6,415.3,18.6,471,441,30
060375420003,657.3,596.0,31.3,514,488,26
060375405023,322.6,293.3,15.9,258,235,23
060375417003,296.8,264.9,18.5,337,306,31
060375417002,397.9,354.7,26.8,379,345,34
060375417001,286.0,255.6,16.2,254,223,31
060375417005,364.2,330.9,18.5,373,340,33
060375421032,208.8,192.7,8.2,182,169,13
060375421031,340.9,314.2,13.6,310,299,11
060375420002,284.4,255.1,14.9,252,240,12
060375421043,200.3,183.3,8.3,124,116,8
060375421041,346.6,310.8,16.1,287,258,29
060375418013,360.8,320.0,18.4,290,257,33
060375418012,535.7,487.4,27.9,412,381,31
060375418023,433.1,392.6,23.4,373,338,35
060375418011,360.2,324.7,20.9,315,294,21
060375418022,353.4,322.7,16.0,316,287,29
060375416031,231.1,209.9,10.9,90,79,11
060375405014,372.5,336.3,20.9,307,278,29
060375405021,535.9,487.1,27.9,331,308,23
060375405013,464.2,418.9,24.9,447,407,40
060375405022,220.8,202.6,10.0,171,153,18
060375405011,246.1,220.1,13.8,185,162,23
060375405012,243.6,217.4,14.4,202,174,28
060375403001,358.9,329.1,14.4,67,61,6
060375403003,199.0,180.0,10.0,76,67,9
060375403002,476.1,428.5,25.9,231,198,33
060375403004,365.9,317.2,29.7,286,246,40
060375356071,424.1,377.0,24.7,267,236,31
060375356072,447.8,395.9,28.2,347,295,52
060375356052,491.1,429.3,33.0,196,168,28
060375356042,492.6,421.9,40.2,110,95,15
060375356061,392.9,352.6,23.2,138,122,16
060375356074,211.8,183.1,17.5,279,240,39
060375356073,164.3,142.0,13.6,148,130,18
060375402011,160.8,146.7,6.4,86,68,18
060375402012,157.0,143.3,6.2,180,153,27
060375402021,311.2,284.0,12.4,243,215,28
060375417004,199.2,181.6,9.9,197,175,22
060375402032,295.7,267.0,16.2,213,186,27
060375402031,555.6,505.1,27.1,501,456,45
060375402023,275.8,237.3,31.6,337,287,50
060375402033,191.9,170.0,13.4,201,178,23
060375402022,466.9,407.3,43.7,261,231,30
060375402024,155.1,137.4,10.9,121,108,13
060375417006,235.1,209.5,16.4,187,173,14
060375401022,575.1,518.7,31.9,423,370,53
060375401024,503.7,454.3,27.8,450,419,31
060375358024,611.1,539.2,43.0,507,445,62
060375358021,525.8,465.4,36.2,447,369,78
060375358022,202.4,178.1,14.5,172,140,32
060375358023,461.0,399.6,38.7,473,407,66
060375358041,623.9,552.3,46.0,200,166,34
060375358042,723.7,625.7,66.1,152,123,29
060375359022,428.5,355.7,54.4,415,329,86
060375359023,465.9,382.7,60.9,394,312,82
060375359024,748.9,621.8,89.1,653,530,123
060375359014,347.9,314.4,20.0,116,100,16
060375359013,501.8,438.8,35.7,370,322,48
060375422001,621.8,571.6,18.6,572,550,22
060375437025,361.8,263.1,79.8,277,173,104
060375437022,848.3,640.0,167.6,581,411,170
060372941101,512.8,396.1,87.2,476,357,119
060372941102,437.7,332.7,76.8,367,274,93
060375437021,467.8,351.7,93.3,491,344,147
060375439052,455.8,389.2,38.8,420,347,73
060375439051,131.7,109.2,14.9,105,86,19
060372947012,187.7,153.4,26.4,142,115,27
060372947011,135.4,110.7,19.1,124,100,24
060372946203,241.4,202.2,24.2,200,166,34
060372946201,456.8,386.9,50.1,384,329,55
060372941201,147.9,124.8,13.9,105,92,13
060372941103,279.7,211.7,49.5,317,254,63
060372941203,140.1,120.8,10.7,105,90,15
060372941202,275.9,237.9,21.0,211,191,20
060372946202,436.8,371.5,49.5,385,337,48
060379800021,0.0,0.0,0.0,0,0,0
060375439053,420.5,329.6,69.3,422,322,100
060372781023,439.4,287.2,122.0,601,395,206
060372781021,309.8,199.2,88.7,367,244,123
060379800281,10.0,6.0,4.0,5,5,0
060372781022,677.4,489.2,147.7,835,597,238
060376212041,1358.3,787.0,493.3,1265,767,498
060376212042,203.6,115.7,77.6,358,218,140
060376211043,440.6,268.7,130.5,466,290,176
060376211045,457.3,279.8,134.4,486,301,185
060376211042,390.8,243.8,110.6,378,233,145
060376210021,572.3,342.8,177.2,637,389,248
060376210044,540.3,335.6,162.9,580,346,234
060376210042,825.8,504.7,256.1,826,518,308
060376211044,1156.8,757.1,298.2,1160,746,414
060376211041,955.3,643.5,233.8,781,500,281
060376210012,698.0,458.7,178.1,644,387,257
060376210045,413.8,256.2,124.2,418,252,166
060376210043,428.7,268.8,127.0,455,279,176
060376210041,402.7,247.4,121.9,413,244,169
060376209042,290.7,180.1,87.9,299,178,121
060376209043,320.0,199.7,95.0,389,211,178
060376209041,400.1,244.3,125.5,385,232,153
060376209044,593.2,358.8,190.5,661,394,267
060376209011,715.5,419.4,246.5,740,386,354
060376209012,407.7,242.8,132.9,423,221,202
060376209013,379.9,219.8,136.6,395,224,171
060376210011,1664.1,1078.1,455.7,1730,1081,649
060376208006,382.7,227.0,134.0,351,170,181
060376208005,636.1,387.3,205.0,642,351,291
060376208003,677.8,417.0,216.2,744,416,328
060376208007,420.2,256.1,139.8,433,242,191
060376213261,449.1,272.5,140.7,763,478,285
060376213263,707.5,428.6,225.2,716,437,279
060376513043,842.1,475.3,312.2,504,308,196
060376213262,481.1,291.0,155.7,471,280,191
060376213241,1309.1,802.3,428.0,1315,801,514
060376214002,800.1,476.3,271.6,717,412,305
060376214001,857.4,513.1,286.5,734,437,297
060376214003,341.1,194.7,122.7,334,198,136
060376513042,593.8,343.7,210.7,685,370,315
060376513041,414.5,248.1,135.7,337,164,173
060376513045,525.2,296.1,193.5,502,244,258
060376214004,545.2,293.3,209.7,528,300,228
060376213013,681.0,386.7,239.1,725,421,304
060376213012,598.5,369.6,184.5,554,330,224
060375548012,325.1,200.1,108.1,341,218,123
060375548021,757.0,485.6,234.3,723,369,354
060375548023,441.9,294.6,124.1,503,335,168
060375548022,636.0,423.6,178.6,491,307,184
060375545162,878.6,520.2,311.7,896,498,398
060375545152,1073.9,636.4,381.0,1117,631,486
060375545151,599.0,366.0,204.0,630,350,280
060375549004,684.3,426.8,223.8,634,358,276
060375549001,510.4,343.8,138.0,518,329,189
060375549003,211.9,140.0,60.1,166,103,63
060375549002,390.9,266.8,102.2,347,234,113
060375545161,927.0,582.7,300.4,899,513,386
060375545192,1015.3,632.6,337.0,1163,602,561
060375545171,1116.3,717.0,350.3,1293,758,535
060375545143,735.8,444.0,255.4,722,392,330
060375548011,529.0,437.0,57.0,405,342,63
060375545142,585.0,413.0,141.0,624,389,235
060375545141,654.8,436.5,187.6,436,296,140
060375545131,866.2,561.5,272.4,1060,606,454
060591101172,555.0,289.4,239.7,650,285,365
060591101182,539.7,290.8,216.1,595,297,298
060591101174,763.6,400.6,325.0,706,333,373
060591101171,771.9,430.3,292.6,868,450,418
060591101173,300.1,191.7,91.4,233,150,83
060591101062,429.8,215.4,186.5,582,275,307
060591101061,288.8,148.6,120.0,297,170,127
060591101181,657.4,382.4,241.6,666,293,373
060591101112,1001.6,507.9,445.4,1051,465,586
060375551041,848.4,542.9,256.0,751,476,275
060375551032,808.6,506.3,250.9,839,507,332
060591101111,715.8,342.5,339.7,626,311,315
060591101113,661.4,384.1,240.6,624,343,281
060591101022,1145.8,587.0,489.7,1235,593,642
060591101161,674.1,367.3,262.2,635,311,324
060591101042,896.8,385.8,445.8,1130,483,647
060591101091,461.9,209.0,232.7,405,204,201
060591101092,466.9,220.2,223.9,390,177,213
060591101041,1010.9,515.1,426.8,1128,556,572
060591101043,316.9,175.8,125.9,196,112,84
060591101023,575.5,315.9,228.2,537,284,253
060591101101,386.5,204.7,151.8,309,194,115
060591101103,654.3,333.0,274.7,735,361,374
060591100153,138.6,82.2,51.0,116,58,58
060591100124,1060.7,520.8,493.5,1116,492,624
060591100123,592.3,269.6,296.5,551,238,313
060591100051,940.2,338.0,524.0,938,340,598
060591100052,825.8,331.0,442.0,904,355,549
060591100141,402.1,216.2,155.4,308,179,129
060591100152,1050.3,458.8,513.6,1177,500,677
060591100144,419.5,207.9,182.0,342,200,142
060591100062,850.7,375.6,424.7,862,341,521
060591100142,400.5,209.4,165.5,394,225,169
060591101063,750.6,361.4,340.5,835,395,440
060590994154,781.2,298.4,425.3,797,317,480
060590994131,425.4,189.0,211.3,413,190,223
060591101142,698.0,325.3,324.1,695,312,383
060591100011,1380.4,623.6,668.3,1425,617,808
060591101141,679.2,316.5,316.7,759,372,387
060590994155,405.3,157.2,222.9,364,162,202
060590994152,644.7,292.2,308.5,626,304,322
060590994042,1268.7,538.9,654.0,1313,557,756
060590994041,1123.8,464.1,593.9,1187,499,688
060590994053,859.3,418.0,386.2,595,305,290
060590994135,578.3,209.6,348.6,574,196,378
060590994132,917.8,420.3,436.3,880,415,465
060590994123,956.0,393.4,498.6,1050,461,589
060590994023,268.8,126.8,128.2,356,166,190
060590994122,533.2,241.4,261.0,681,305,376
060590994121,783.1,382.3,357.2,582,355,227
060590994051,632.6,263.9,330.1,681,294,387
060375706024,313.9,250.5,43.5,249,160,89
060375706021,496.1,396.5,72.4,494,350,144
060375706023,319.8,244.8,53.6,264,208,56
060375705023,400.0,303.0,69.7,343,255,88
060375705011,606.7,476.0,92.7,553,438,115
060375706033,196.0,171.3,14.8,193,181,12
060375715031,916.5,645.2,218.9,874,602,272
060375706032,533.9,480.9,29.7,676,622,54
060375705013,667.6,522.1,111.3,569,438,131
060375705024,400.6,298.9,72.8,347,267,80
060375705022,528.8,413.0,81.8,365,271,94
060375705014,461.1,352.5,77.3,416,338,78
060375705021,430.6,332.8,67.1,430,350,80
060375702022,391.2,321.8,54.0,293,239,54
060375702032,274.7,225.0,33.3,207,187,20
060375702021,220.7,186.4,26.3,213,184,29
060375425021,257.1,237.3,11.5,280,270,10
060375425022,148.9,135.4,7.4,128,123,5
060375425023,184.8,169.8,8.5,128,125,3
060375424014,474.3,433.4,23.5,383,365,18
060375424011,309.3,284.2,16.7,385,376,9
060375424013,339.5,312.7,15.3,369,360,9
060375426011,167.6,155.6,6.5,107,101,6
060375426021,337.5,310.1,15.1,196,183,13
060375416062,224.3,207.5,8.8,170,159,11
060375416061,290.6,268.7,11.4,213,199,14
060375415002,172.2,156.9,9.1,126,121,5
060375415003,274.1,249.8,14.4,235,217,18
060375415001,372.7,340.4,18.4,292,273,19
060375416032,286.1,260.2,12.8,305,291,14
060375416043,294.8,266.0,12.3,207,189,18
060375416041,340.9,307.9,14.3,362,340,22
060375416053,402.4,367.5,16.8,419,397,22
060375416052,527.6,477.1,25.7,462,442,20
060375416042,401.1,355.9,20.7,283,264,19
060375422002,667.8,609.6,29.2,625,590,35
060375424012,509.9,472.7,24.5,435,413,22
060375416051,304.2,277.1,14.4,203,188,15
060375421051,338.8,309.3,13.0,308,286,22
060375422003,445.2,414.0,15.4,410,389,21
060375421053,510.8,464.1,23.6,425,400,25
060375421042,208.9,185.5,12.1,129,120,9
060375421033,264.1,234.5,16.1,274,254,20
060374825022,349.9,277.8,56.7,340,248,92
060374825021,309.6,245.8,50.2,274,208,66
060374817121,578.3,422.2,128.7,599,409,190
060374823041,269.1,216.1,40.1,272,187,85
060374823042,273.9,219.9,40.9,265,196,69
060374823033,401.2,306.0,75.2,478,339,139
060374823032,345.3,258.8,70.3,352,235,117
060374823014,216.4,161.7,45.2,215,148,67
060374823015,192.0,143.4,40.1,201,139,62
060374823031,266.5,209.2,42.5,232,175,57
060375738002,718.3,396.2,287.2,596,329,267
060375738001,660.2,362.9,253.9,611,342,269
060375739021,1217.0,636.0,520.0,1281,707,574
060375552112,130.6,104.2,19.2,98,77,21
060375550022,764.0,428.0,275.0,757,451,306
060375550011,471.0,288.0,150.0,472,273,199
060375551022,589.9,445.9,109.4,602,415,187
060375550021,392.5,274.1,89.8,372,236,136
060375550014,634.9,445.9,151.0,436,324,112
060375550013,336.1,236.9,81.9,420,279,141
060375550012,306.0,214.0,72.0,288,186,102
060375552022,943.0,511.2,373.6,991,488,503
060375552021,835.0,445.8,333.4,813,449,364
060375552111,552.9,458.6,72.2,386,311,75
060375552121,919.3,703.5,153.9,803,556,247
060375551042,384.8,294.3,67.1,329,232,97
060375552113,543.5,433.7,80.1,464,349,115
060375551021,972.4,726.0,190.4,879,606,273
060375551031,792.0,527.8,202.1,708,501,207
060375545222,883.2,542.4,309.1,844,456,388
060375545223,941.3,580.5,326.3,1027,563,464
060375549005,264.5,159.6,92.9,255,154,101
060375545213,862.0,548.0,275.0,867,472,395
060375545211,1102.9,687.3,366.8,1215,689,526
060375545212,752.2,457.6,262.8,620,361,259
060375546002,576.9,381.3,163.3,578,337,241
060375750022,702.7,510.1,133.6,606,460,146
060375750023,555.3,389.9,115.4,555,416,139
060375750021,651.0,444.0,146.0,624,456,168
060375734031,1412.9,955.2,364.3,1280,850,430
060375750012,881.0,642.2,165.0,757,557,200
060375750011,541.7,345.1,153.1,568,367,201
060375742022,565.3,354.2,169.2,482,303,179
060375749022,474.2,333.5,88.7,450,325,125
060375749021,348.9,228.7,86.6,363,237,126
060375749023,785.0,583.0,143.0,666,475,191
060375742021,355.3,210.4,121.2,355,217,138
060375748003,552.3,337.3,174.0,478,274,204
060375748002,699.5,394.3,249.2,619,374,245
060375749013,561.4,328.9,198.6,556,340,216
060375749014,596.9,349.7,211.1,597,350,247
060375748001,365.9,203.8,133.1,530,269,261
060375749012,441.7,282.5,132.2,417,263,154
060375742014,330.6,193.2,112.8,327,174,153
060375742013,343.4,200.8,117.2,311,180,131
060375742012,486.6,270.8,180.4,486,264,222
060375742011,514.4,286.2,190.6,542,300,242
060375775011,742.2,378.3,317.9,756,405,351
060375775013,666.2,336.7,287.8,633,324,309
060375775041,436.9,225.3,186.9,477,248,229
060375775012,708.1,348.0,319.3,832,383,449
060375774004,547.7,318.4,189.4,513,314,199
060375773005,508.4,300.2,173.3,560,343,217
060375776035,651.5,372.7,231.1,722,380,342
060375776041,832.8,430.2,351.4,785,426,359
060379800071,0.0,0.0,0.0,2,0,2
060375776032,1130.5,564.4,511.6,1208,534,674
060375776022,1046.4,561.3,411.1,1036,556,480
060375776031,1079.4,621.7,385.7,1111,642,469
060375776034,1071.6,691.4,310.6,965,609,356
060375776021,823.0,524.0,256.0,998,586,412
060375747001,30.1,24.3,3.1,3,2,1
060375746011,490.9,395.7,50.9,345,269,76
060375746021,798.4,403.5,348.7,773,353,420
060375749011,440.3,281.5,131.8,439,282,157
060375743005,441.9,247.9,167.5,465,272,193
060375743003,429.6,241.0,162.8,415,233,182
060375743007,578.0,322.1,227.2,588,337,251
060375743006,531.0,295.9,208.8,534,292,242
060375741003,496.3,247.2,208.3,503,259,244
060375350021,255.5,235.9,8.0,227,209,18
060375350023,225.2,210.1,8.1,137,122,15
060375350022,153.3,141.5,4.8,114,108,6
060372422001,361.7,335.3,13.2,294,279,15
060372422003,553.2,514.4,20.3,465,435,30
060375354001,341.4,313.9,11.4,284,266,18
060375353005,222.0,205.1,6.2,187,172,15
060375353004,281.7,254.4,14.6,183,167,16
060375353001,214.9,191.2,12.6,153,140,13
060375353002,133.2,118.4,8.0,80,69,11
060375353003,375.7,334.0,22.4,299,270,29
060375354002,147.4,132.5,8.3,123,118,5
060375354003,132.9,119.5,7.5,80,78,2
060375348041,482.6,427.6,32.4,179,156,23
060375348042,355.1,321.2,19.5,2,1,1
060375351011,334.4,300.4,16.5,294,268,26
060375349002,430.9,387.1,24.3,335,293,42
060375349004,350.1,327.4,17.5,267,235,32
060375349003,315.5,285.7,18.2,263,238,25
060375330022,253.2,228.2,14.3,202,182,20
060375330012,106.9,96.7,5.7,114,103,11
060375330013,232.0,209.9,12.3,219,195,24
060375330021,162.1,145.2,8.8,172,157,15
060375349001,202.7,182.4,12.0,176,155,21
060375348031,775.8,667.6,66.6,236,207,29
060375331031,253.7,218.5,15.6,143,131,12
060375331032,315.8,272.1,19.4,251,206,45
060375329004,222.0,206.8,7.6,154,146,8
060375329001,136.3,127.0,4.7,93,88,5
060375329002,268.7,246.8,10.1,266,252,14
060375329003,491.1,450.5,18.6,364,343,21
060375328001,296.2,270.1,19.8,297,272,25
060375328002,271.8,247.9,18.2,258,231,27
060372291002,304.2,279.7,12.5,261,237,24
060372291001,494.4,453.3,21.3,393,360,33
060375330011,383.0,349.9,20.1,286,253,33
060372289001,404.7,366.6,21.6,217,203,14
060372288003,313.6,281.9,16.9,236,223,13
060372288002,172.9,157.2,8.6,128,124,4
060372292002,432.2,392.6,19.7,382,359,23
060372292001,321.1,293.1,14.2,267,256,11
060372294201,429.8,383.7,23.9,340,307,33
060372287203,292.8,264.2,16.4,229,214,15
060372287102,241.9,218.3,13.6,205,183,22
060372287101,484.9,446.5,20.9,306,280,26
060372287201,209.7,194.7,7.8,156,147,9
060372287202,280.1,260.2,10.5,202,192,10
060372286002,336.5,302.6,20.8,288,268,20
060372286001,489.1,443.8,26.9,357,336,21
060372283102,268.4,241.2,14.1,167,157,10
060372283203,194.4,172.8,12.9,159,152,7
060372282203,304.2,275.7,16.2,225,211,14
060372282102,429.7,388.6,23.9,301,278,23
060372282101,354.1,324.9,17.6,180,169,11
060372288004,340.2,304.5,18.4,238,222,16
060372281002,396.6,360.9,16.5,281,261,20
060372282202,199.7,187.0,7.0,147,137,10
060372282201,182.3,170.8,6.4,143,132,11
060372281001,225.7,207.2,7.8,140,133,7
060372281003,238.3,218.7,8.3,233,215,18
060375327002,362.2,329.2,21.7,233,205,28
060375327001,272.9,248.1,16.3,167,153,14
060372289002,250.1,228.4,11.1,184,166,18
060372288001,107.9,98.5,4.8,73,66,7
060375326032,207.7,182.2,15.9,161,141,20
060375326031,228.3,200.3,17.4,187,163,24
060375326033,191.1,167.7,14.6,177,156,21
060372312202,301.9,270.6,22.2,300,276,24
060372312201,522.5,465.1,36.6,347,321,26
060372219001,550.0,460.0,53.0,539,428,111
060372227001,844.9,709.5,75.3,810,657,153
060376213011,1332.5,842.0,398.1,1465,862,603
060376213242,674.1,406.5,217.0,567,335,232
060376213014,853.0,553.1,240.3,846,512,334
060376212012,1095.8,638.0,377.2,1036,610,426
060376212013,1259.8,750.4,416.8,1118,671,447
060376512014,582.6,301.9,249.3,561,268,293
060376512013,320.4,147.7,147.4,328,149,179
060376512015,600.8,296.5,267.0,677,318,359
060376512012,723.2,351.6,332.4,683,322,361
060376507024,286.8,136.2,129.3,333,155,178
060376507025,412.2,195.8,185.7,376,194,182
060376507023,771.7,402.3,322.1,793,385,408
060376506032,746.9,417.8,284.2,837,400,437
060376506031,1171.2,610.9,483.7,1155,573,582
060376505023,1193.5,616.6,500.7,1384,661,723
060376507021,515.9,268.0,200.0,533,266,267
060376507022,344.2,179.9,135.0,375,175,200
060376507011,396.0,209.3,158.9,438,207,231
060376212011,1170.4,720.8,362.0,1063,658,405
060376211022,1050.0,723.2,261.1,1008,643,365
060376211021,621.6,408.5,158.3,625,375,250
060376207021,474.1,301.4,137.8,560,343,217
060376207025,785.0,503.4,224.5,749,484,265
060376207024,701.3,458.5,191.3,732,431,301
060376207023,536.3,346.4,151.2,498,291,207
060376207022,1025.1,667.1,290.3,1025,638,387
060376207014,913.8,591.1,258.4,895,514,381
060376207013,675.9,435.5,192.5,655,430,225
060376207011,1022.0,652.4,281.1,953,577,376
060376207012,894.4,577.1,248.8,885,536,349
060376205221,663.5,453.4,166.5,557,363,194
060376205223,749.8,482.2,213.9,762,470,292
060376208002,587.9,372.4,179.6,565,334,231
060376208008,580.1,367.8,177.5,577,315,262
060376205222,921.1,598.6,260.1,890,542,348
060376505022,408.7,193.1,189.9,356,158,198
060376505021,618.9,336.9,228.0,517,283,234
060375341023,281.1,239.8,28.2,236,199,37
060375341022,314.3,268.1,31.5,254,220,34
060375341013,95.4,83.2,8.2,73,64,9
060375341024,283.4,242.6,24.0,198,165,33
060375341012,252.6,224.3,18.9,178,148,30
060375341011,184.1,163.5,13.7,161,144,17
060375341021,262.6,233.2,19.6,213,182,31
060375335031,284.7,251.1,21.0,235,207,28
060375335022,143.5,126.6,10.6,178,147,31
060375335021,287.6,253.6,21.0,246,219,27
060375335032,99.8,88.1,7.4,104,90,14
060375334021,578.4,511.4,43.2,455,388,67
060375334032,236.4,195.6,26.9,156,136,20
060375334031,520.7,465.7,30.2,482,421,61
060375334022,380.7,324.0,37.4,347,301,46
060375334012,218.0,189.5,18.8,171,141,30
060375334011,594.9,520.9,48.2,523,445,78
060375337022,248.6,215.4,21.1,213,178,35
060375337021,451.7,391.4,38.4,397,339,58
060375337012,483.4,431.1,31.6,366,325,41
060375337011,262.2,235.6,15.8,296,265,31
060375337031,364.4,320.1,25.5,306,252,54
060375323021,463.3,405.5,32.2,424,368,56
060375323022,385.6,332.1,35.5,333,271,62
060375323023,332.5,286.0,31.1,328,273,55
060375324001,48.0,35.0,8.0,31,13,18
060375337032,542.7,475.5,38.6,428,373,55
060375323042,295.2,250.0,29.6,171,139,32
060375338053,147.4,127.7,13.0,153,136,17
060375338062,193.0,167.4,18.2,241,203,38
060375338052,128.2,111.2,12.1,153,132,21
060375338061,616.6,533.8,52.3,444,377,67
060375323031,425.3,337.2,65.6,332,276,56
060375323024,319.4,256.2,46.6,316,255,61
060372051202,257.7,235.3,10.1,44,39,5
060372049202,215.7,191.7,9.8,148,121,27
060372060501,574.2,498.9,44.8,400,340,60
060372051201,547.6,502.1,21.2,6,6,0
060372051101,574.8,516.9,23.3,110,97,13
060372047003,278.1,246.9,15.6,5,5,0
060372047002,239.0,207.8,20.8,52,45,7
060372046001,548.7,479.5,33.5,182,167,15
060372047001,702.0,611.2,56.9,74,66,8
060372046002,361.0,317.2,21.2,16,16,0
060372044101,189.4,158.0,18.0,154,137,17
060372043003,195.2,171.6,11.4,18,15,3
060372043004,270.1,237.5,15.8,76,69,7
060372044202,168.8,150.6,7.6,57,49,8
060372044102,277.8,244.8,15.6,5,5,0
060372044201,371.0,332.3,15.3,147,130,17
060372048201,238.5,209.6,16.2,99,89,10
060372048202,295.6,259.7,20.0,1,1,0
060372048103,449.2,405.0,25.9,17,17,0
060372049201,535.0,468.0,35.0,127,116,11
060372048102,399.8,369.3,17.7,145,124,21
060372049101,781.2,680.1,66.2,593,518,75
060372043002,498.2,435.1,36.4,8,5,3
060372043001,172.8,150.9,12.6,75,68,7
060372042002,340.4,297.1,20.3,3,1,2
060372042001,296.6,258.9,17.7,86,77,9
060375345023,379.9,323.7,36.8,152,127,25
060375345021,552.1,473.2,53.0,7,6,1
060375344031,728.0,628.0,58.0,58,48,10
060375336031,538.3,471.0,40.4,59,50,9
060375336032,651.5,558.1,63.3,390,320,70
060375336022,538.3,447.9,51.4,235,184,51
060375336021,432.4,359.5,38.9,122,104,18
060375326063,283.6,247.5,21.8,63,56,7
060375326053,396.6,346.2,29.7,4,3,1
060375326042,343.0,299.6,25.3,82,73,9
060375326062,349.4,304.9,26.7,64,57,7
060375326052,184.6,161.3,13.6,109,91,18
060375326051,105.0,91.8,7.7,105,93,12
060375326061,226.7,197.9,17.2,215,181,34
060375326041,143.0,125.0,10.5,110,90,20
060375325002,309.0,270.9,22.6,161,133,28
060375325001,178.7,156.9,13.1,90,78,12
060375325003,392.7,344.8,28.7,5,5,0
060375331062,153.8,134.2,12.0,96,78,18
060375331051,416.0,378.1,24.9,103,92,11
060375332011,162.1,147.3,9.7,55,41,14
060375332012,338.2,300.3,24.1,160,137,23
060375333001,268.9,238.7,19.1,132,115,17
060375335012,307.3,270.0,20.8,3,3,0
060375335011,416.0,365.6,28.2,138,112,26
060375336011,352.8,313.5,26.9,96,82,14
060375336012,514.8,452.2,41.6,82,68,14
060375334013,301.6,268.1,21.3,273,240,33
060375333002,424.5,375.2,30.9,381,332,49
060375360001,275.6,239.9,19.7,179,152,27
060375357021,346.7,308.3,24.2,1,1,0
060375360002,675.5,581.1,60.9,541,453,88
060375357022,319.1,282.7,22.8,69,61,8
060375343011,394.0,337.2,34.8,259,214,45
060375343012,455.9,391.4,39.6,448,387,61
060375344042,326.8,279.0,29.3,274,229,45
060375344041,327.3,279.4,29.3,329,276,53
060375336033,270.2,228.9,29.3,197,154,43
060375336013,139.5,116.1,14.1,84,71,13
060375336023,199.1,165.7,20.1,155,129,26
060375344051,574.4,511.5,28.4,432,376,56
060375344052,174.6,155.5,8.6,171,151,20
060375338032,356.9,306.3,37.7,307,244,63
060375338034,544.7,471.0,52.5,320,266,54
060375338033,323.3,280.7,31.1,219,175,44
060375338031,293.0,247.5,34.9,306,243,63
060375338041,282.7,238.8,33.6,257,212,45
060375338042,537.3,457.6,56.2,653,532,121
060375361031,253.7,214.1,28.1,203,170,33
060375343021,411.5,362.8,30.6,252,210,42
060375343022,314.5,277.2,23.4,238,197,41
060375344062,358.0,313.8,23.8,222,189,33
060375344061,378.0,331.2,25.2,320,264,56
060375342012,298.0,260.3,27.0,280,229,51
060375342011,375.9,328.2,34.0,290,257,33
060375342022,339.4,292.4,33.1,224,187,37
060375338051,480.2,414.8,36.4,404,352,52
060372972022,514.4,329.6,152.2,531,370,161
060372972021,553.6,365.4,155.7,592,412,180
060372970005,540.8,306.1,197.0,518,334,184
060372970004,581.3,359.4,182.0,612,418,194
060372969013,195.8,128.3,57.2,191,135,56
060372969022,646.1,417.7,186.2,619,443,176
060372969023,211.9,138.9,62.0,220,150,70
060372970002,347.6,204.2,119.2,341,209,132
060372970003,590.7,366.8,180.6,495,336,159
060372964023,513.4,344.8,141.3,505,362,143
060372964021,571.3,383.9,156.8,614,418,196
060376099002,365.7,218.1,113.9,300,212,88
060376099001,350.3,208.9,109.1,351,243,108
060372964022,307.3,206.3,84.8,284,213,71
060372966004,438.6,335.3,79.7,457,349,108
060376705001,1127.0,397.0,663.0,1363,490,873
060376707021,1165.2,521.8,575.1,1109,462,647
060376707022,601.1,278.3,294.6,648,272,376
060376514022,838.0,459.8,323.0,733,431,302
060376514021,496.7,276.3,189.7,435,241,194
060376514023,868.7,491.2,325.4,995,497,498
060376514024,438.1,243.2,167.6,393,226,167
060376513022,744.5,398.7,302.5,1050,544,506
060376703241,625.4,326.4,259.6,642,281,361
060376513021,508.8,278.8,196.2,452,271,181
060376512221,1139.1,623.2,444.2,1086,562,524
060376512222,1336.6,771.6,489.4,1139,648,491
060376514012,606.0,303.0,266.0,558,262,296
060376514011,666.5,335.7,290.8,401,186,215
060376700033,625.2,306.1,272.9,555,309,246
060376700034,888.2,442.4,380.1,881,471,410
060376707013,726.0,369.0,313.0,665,352,313
060376707011,1441.6,818.0,556.7,1218,662,556
060376707012,886.1,431.5,405.7,1051,544,507
060375758022,527.2,419.4,59.8,416,334,82
060375758012,177.0,140.8,20.1,99,77,22
060375758021,390.0,321.7,46.0,298,242,56
060375728001,334.0,250.0,59.0,188,150,38
060375729001,373.7,314.3,42.2,281,219,62
060375729002,354.5,306.4,36.4,249,202,47
060375727004,574.6,445.7,100.4,471,290,181
060375727001,327.2,260.6,51.1,296,228,68
060375727002,330.0,262.8,51.9,408,306,102
060375725001,494.0,396.0,75.0,521,414,107
060375727003,456.2,349.9,86.6,405,281,124
060375726004,232.1,175.5,40.4,222,169,53
060375726002,552.0,423.4,93.0,498,358,140
060375726001,502.0,398.6,74.0,478,390,88
060375755001,15.1,12.5,1.9,60,33,27
060375754012,50.3,42.1,5.1,39,31,8
060375754011,102.4,85.4,11.5,49,37,12
060375754013,150.8,128.7,15.0,97,83,14
060375729003,416.7,340.3,51.4,337,259,78
060375730031,651.9,505.0,106.7,617,486,131
060375731003,511.3,420.4,62.3,465,375,90
060375730044,325.7,256.3,42.8,272,226,46
060375730043,257.1,202.3,33.7,248,213,35
060375730041,273.4,227.1,30.6,216,185,31
060375730042,208.4,173.8,22.8,148,117,31
060375754014,312.7,265.7,30.9,209,184,25
060375723022,242.4,210.7,21.1,248,210,38
060375722014,747.4,538.2,167.4,734,509,225
060375731004,280.6,233.6,31.3,228,180,48
060375731002,1045.9,872.8,114.0,893,774,119
060375722022,223.9,167.5,42.7,255,193,62
060375722023,325.1,243.6,61.6,292,232,60
060375722024,606.3,444.9,127.8,573,437,136
060375760013,350.5,261.7,65.0,292,224,68
060375762005,441.0,338.4,63.9,335,276,59
060375762003,384.7,296.4,54.7,323,283,40
060375503006,250.2,201.3,37.5,221,163,58
060375519006,324.0,231.7,78.1,291,192,99
060375519001,331.4,257.0,59.6,283,210,73
060375503007,367.5,295.7,55.2,355,261,94
060375519003,331.8,239.4,72.3,369,247,122
060375503005,183.6,134.9,34.3,128,96,32
060375503002,497.7,343.6,126.7,530,343,187
060375503004,509.2,353.9,128.0,346,244,102
060375510003,435.6,284.0,126.8,469,264,205
060375510002,431.9,278.6,132.2,349,214,135
060375510001,574.6,375.6,166.8,515,305,210
060375510006,483.0,304.8,150.8,492,279,213
060375505005,517.8,317.3,175.0,513,254,259
060375506024,357.9,218.3,125.7,307,176,131
060375505006,368.1,228.8,123.1,327,171,156
060375504001,528.0,376.0,126.0,457,316,141
060375028011,511.9,343.4,137.4,367,239,128
060375505004,442.9,266.1,154.6,426,202,224
060375505001,906.5,669.9,187.0,834,563,271
060375503001,408.2,280.7,104.6,439,297,142
060375505003,530.2,330.8,178.3,554,283,271
060375356041,378.8,347.2,21.5,103,90,13
060375356032,480.0,427.2,29.7,92,81,11
060375355012,421.1,373.2,28.6,118,95,23
060375356031,268.6,237.5,18.3,90,75,15
060375355022,582.1,523.9,34.9,217,183,34
060375355011,404.7,356.1,31.6,76,68,8
060375355031,616.1,541.4,45.5,142,122,20
060375356051,420.8,377.3,28.5,128,115,13
060375358032,339.2,297.5,27.9,132,110,22
060375358033,252.8,220.9,21.4,0,0,0
060375355021,437.4,396.8,23.3,129,113,16
060375348021,419.8,361.8,37.2,77,66,11
060375348022,297.6,256.5,26.4,187,155,32
060375348032,496.1,427.2,44.9,248,210,38
060375331041,192.0,166.3,15.7,154,134,20
060375331042,309.0,267.6,25.3,115,95,20
060375331061,184.5,160.9,17.1,128,107,21
060375331072,483.0,421.4,44.7,94,80,14
060375331071,240.2,208.0,20.6,176,146,30
060375347001,1347.0,1154.0,117.0,196,158,38
060375358031,347.6,297.3,34.2,83,72,11
060375357024,476.9,416.8,37.3,3,2,1
060375357023,253.9,221.9,19.9,77,66,11
060375357013,535.8,463.5,47.8,223,184,39
060375357012,611.7,529.9,52.1,4,4,0
060375359012,457.7,383.2,53.7,443,342,101
060375357011,529.7,461.1,37.7,59,45,14
060375345013,553.7,487.2,36.5,77,61,16
060375345012,330.5,286.5,25.4,38,36,2
060375345011,431.4,362.8,42.5,169,142,27
060375345022,200.4,168.6,19.8,65,48,17
060375332032,212.1,183.4,17.9,11,7,4
060375332031,199.2,172.3,16.8,128,100,28
060375332022,406.7,350.1,35.0,0,0,0
060375332021,293.0,252.2,25.2,90,74,16
060376500043,590.6,383.0,158.9,476,276,200
060376500044,230.7,145.1,66.7,283,159,124
060376500042,320.7,194.5,99.9,294,162,132
060376500041,369.7,219.2,120.4,325,187,138
060376510022,593.6,300.7,259.3,668,322,346
060376510023,482.4,258.4,190.4,498,250,248
060376510021,586.2,299.8,251.2,505,237,268
060376509022,855.3,518.2,282.6,704,424,280
060376509023,976.9,597.5,330.6,775,451,324
060376510011,513.1,271.5,204.6,593,305,288
060376510012,496.4,272.8,191.7,605,319,286
060376509021,694.7,398.8,249.5,703,408,295
060376509014,669.2,389.5,234.8,738,439,299
060372932021,316.3,223.2,74.7,336,225,111
060372932022,395.9,323.7,49.9,176,135,41
060372932023,493.0,403.2,62.1,330,260,70
060372932012,628.9,428.9,163.2,521,327,194
060372932011,534.1,363.8,142.2,456,275,181
060372932013,651.6,442.3,170.6,497,323,174
060375435032,955.3,645.2,256.9,989,629,360
060372920004,265.1,177.9,65.6,303,167,136
060372920001,262.5,176.2,64.9,271,175,96
060372920003,714.5,538.0,129.3,464,377,87
060372920002,298.3,236.8,44.4,217,175,42
060375435031,892.7,582.8,264.0,736,412,324
060375435023,742.0,466.0,234.0,705,407,298
060376501013,739.7,433.6,259.1,795,441,354
060376501012,426.4,257.9,138.8,451,243,208
060376501014,532.0,301.4,200.2,473,253,220
060376500015,346.9,219.1,105.2,392,209,183
060376500013,823.8,516.1,255.0,827,463,364
060376500014,372.7,227.7,122.4,413,221,192
060376033011,300.2,215.7,68.6,273,189,84
060376036003,689.6,482.7,163.8,681,413,268
060376500012,303.4,181.0,104.8,323,180,143
060376033023,275.2,194.4,64.5,197,134,63
060376500011,519.3,309.9,179.4,446,244,202
060376034002,539.4,371.7,135.9,476,302,174
060376501011,702.0,470.0,209.0,612,349,263
060376033013,388.1,278.7,88.4,292,192,100
060376033022,570.3,408.5,129.0,551,347,204
060372913001,371.5,232.7,119.0,403,237,166
060372913003,392.9,253.5,121.1,379,232,147
060372913002,307.6,188.8,100.9,311,196,115
060376032002,365.0,267.3,78.8,390,246,144
060376032001,251.0,183.7,54.2,198,135,63
060376032003,449.7,348.2,81.9,464,311,153
060376033012,406.8,294.8,90.6,383,254,129
060376033021,329.0,238.5,72.4,263,196,67
060376031023,379.3,293.8,69.1,360,244,116
060376031021,445.7,346.2,76.0,346,257,89
060376031012,423.7,322.3,78.8,416,286,130
060376031022,331.4,257.4,56.5,366,235,131
060376039004,490.6,366.5,86.2,494,345,149
060372409005,237.2,219.9,9.9,222,208,14
060372409004,200.0,185.3,8.5,159,148,11
060372409003,251.5,230.7,11.6,179,168,11
060372409001,168.7,156.5,6.1,155,149,6
060372408001,295.7,276.0,8.7,300,285,15
060372408002,307.0,282.5,12.8,289,282,7
060372408003,315.9,289.5,14.1,242,230,12
060372407005,309.0,290.3,8.6,289,274,15
060372407002,279.1,262.3,7.2,294,281,13
060375431006,440.0,410.0,14.9,436,421,15
060375430002,264.1,247.9,8.8,357,347,10
060375430003,328.0,301.5,13.8,242,236,6
060375430004,426.0,389.5,19.6,479,468,11
060375431002,306.7,284.6,11.2,318,310,8
060375431007,432.5,400.0,14.7,405,381,24
060375431005,279.6,260.5,10.7,286,278,8
060375411002,394.0,354.1,20.7,441,415,26
060375411003,257.5,229.8,14.6,208,205,3
060375430001,399.3,368.1,13.0,373,360,13
060375431004,444.7,407.7,20.1,407,385,22
060375431003,449.5,413.0,20.4,373,364,9
060375431001,218.7,199.6,9.7,227,220,7
060375429001,453.9,418.9,22.7,428,393,35
060375429002,339.4,311.4,17.0,407,393,14
060375412005,510.0,473.0,23.0,496,473,23
060375412004,349.7,321.3,15.4,259,249,10
060375411001,484.4,439.8,24.0,427,406,21
060375412001,514.2,486.9,15.6,526,522,4
060375428001,482.0,453.3,12.8,599,587,12
060375412003,885.4,825.9,33.4,953,931,22
060375413005,308.6,291.6,8.0,482,461,21
060375412002,442.5,422.2,13.0,456,451,5
060375428003,363.0,336.7,15.2,279,268,11
060375413004,541.2,507.2,15.7,462,449,13
060375413001,272.9,256.3,8.3,266,258,8
060375408002,310.0,284.6,14.5,290,273,17
060375432011,438.7,391.6,32.6,503,482,21
060375432012,584.9,536.2,23.4,530,502,28
060375428002,315.1,289.5,13.9,373,365,8
060375427003,463.6,429.3,20.0,421,400,21
060375427004,245.1,223.8,11.2,242,226,16
060375425012,501.3,453.1,27.5,478,460,18
060375425011,781.5,706.3,44.5,758,721,37
060375432023,341.2,311.2,11.9,294,284,10
060375426023,363.1,333.6,17.6,358,344,14
060375426022,545.4,498.6,27.2,408,390,18
060375427002,242.7,223.6,11.3,283,273,10
060375425024,335.2,304.5,16.6,308,296,12
060375413003,435.9,404.6,13.9,405,397,8
060375413002,210.3,197.4,6.0,226,215,11
060375426013,172.3,152.4,9.3,191,178,13
060375427005,173.2,157.8,8.1,120,112,8
060375427001,285.3,260.0,13.3,208,202,6
060375426012,218.5,193.3,11.9,205,189,16
060375414004,244.2,221.5,9.8,235,224,11
060375414003,196.4,179.5,8.2,157,150,7
060375414005,453.6,415.7,19.1,383,353,30
060375415004,336.0,307.8,15.1,304,279,25
060375414001,407.6,374.9,16.7,325,308,17
060375414002,161.6,149.9,7.2,106,102,4
060375408004,289.3,262.6,13.2,455,447,8
060375408003,341.5,311.3,14.4,371,363,8
060372410022,363.8,330.0,17.2,302,293,9
060372410023,329.0,298.9,15.8,329,309,20
060372410013,411.5,378.7,16.8,455,439,16
060375407002,380.1,349.2,20.6,380,376,4
060375408001,276.4,255.7,12.7,354,346,8
060375407003,222.7,207.4,6.8,171,167,4
060375407001,257.0,239.3,7.9,203,197,6
060372409002,466.5,425.8,21.7,321,306,15
060372426003,227.4,216.8,3.7,181,175,6
060372426001,224.4,205.7,10.6,140,127,13
060372426002,325.2,307.3,7.4,300,277,23
060372407001,296.9,276.8,9.9,194,186,8
060372420002,429.6,391.0,20.1,287,270,17
060372420001,293.3,269.2,8.1,317,310,7
060375352003,496.0,449.0,27.0,404,379,25
060372423003,250.3,225.3,15.7,258,246,12
060372420003,161.2,145.1,10.1,131,130,1
060372423002,185.5,168.4,10.4,132,123,9
060372422004,284.5,265.4,10.5,266,247,19
060375406002,325.8,296.7,17.2,197,187,10
060375406001,689.8,629.7,36.3,599,573,26
060372431002,374.8,353.5,9.1,272,264,8
060372431003,225.6,212.7,5.6,168,159,9
060372427003,321.2,299.3,9.8,236,227,9
060372427004,333.8,311.4,10.9,223,210,13
060372431001,570.1,534.4,19.5,362,331,31
060372427002,180.0,164.4,7.3,137,132,5
060372427001,265.6,244.9,10.7,226,214,12
060372427005,171.8,160.7,6.4,97,91,6
060372422002,183.9,172.0,6.4,133,129,4
060372430001,328.8,301.8,14.0,286,268,18
060372430002,271.0,249.1,12.8,231,220,11
060372430004,430.9,395.5,22.0,312,290,22
060375404002,281.5,256.5,14.6,217,194,23
060375404001,237.5,216.5,12.4,166,153,13
060590995101,1175.3,547.6,586.5,1252,584,668
060590995103,849.8,399.1,421.2,813,366,447
060590995102,783.9,393.3,366.3,633,301,332
060590995092,494.1,231.9,241.4,833,357,476
060590995093,383.9,180.1,187.6,399,183,216
060590995091,838.0,378.5,423.3,504,225,279
060590995094,368.1,158.8,195.3,305,121,184
060591100072,524.6,221.6,278.2,524,211,313
060591100073,1086.0,499.8,532.7,1075,465,610
060591100081,1170.4,553.9,555.0,1146,532,614
060591100082,660.7,279.2,352.9,677,269,408
060590995095,416.9,194.7,212.4,363,161,202
060591100083,631.0,305.8,296.6,601,289,312
060591100121,758.0,375.7,352.0,832,372,460
060591100074,744.5,329.1,376.4,734,298,436
060591100071,573.0,248.0,291.1,540,214,326
060375740002,471.7,296.2,148.3,474,304,170
060375740001,602.3,378.2,189.4,633,364,269
060591100061,838.5,400.5,399.6,859,396,463
060591101083,299.2,141.4,134.0,321,154,167
060591101082,653.8,274.6,340.5,722,300,422
060591101081,219.0,107.2,92.8,243,137,106
060591100143,533.1,313.7,181.7,444,263,181
060591100122,655.0,294.0,337.0,707,305,402
060590996033,806.0,328.0,433.5,810,332,478
060590996032,508.0,206.7,273.2,442,173,269
060590999063,823.0,340.9,438.1,845,323,522
060376513026,504.6,252.0,218.0,853,441,412
060376513024,433.3,216.0,186.1,415,220,195
060376513025,537.0,267.6,230.4,492,239,253
060376513044,368.5,199.8,144.7,241,137,104
060376703242,631.5,323.8,264.7,678,322,356
060376513023,349.8,184.2,149.5,475,230,245
060372974002,1194.4,615.8,503.6,1493,780,713
060372974003,453.2,237.0,194.7,421,222,199
060376707024,1210.4,568.9,570.6,875,366,509
060372975005,503.7,261.7,204.1,481,275,206
060372973002,176.3,90.4,72.5,119,64,55
060372975003,377.0,253.4,97.8,360,265,95
060372974001,541.6,285.0,225.9,440,250,190
060376707023,689.0,322.8,330.3,666,307,359
060372964011,1213.3,696.7,437.4,1082,667,415
060372970001,620.2,333.1,250.5,585,340,245
060372964012,277.0,149.5,113.2,443,267,176
060376707014,510.9,288.6,187.5,589,326,263
060372973001,406.7,254.5,124.0,394,247,147
060372973003,280.6,172.3,88.8,402,248,154
060372972023,213.7,145.4,53.5,213,159,54
060375435011,284.4,201.3,71.5,228,140,88
060372912202,471.6,369.0,75.7,526,399,127
060372912103,360.6,281.7,57.6,213,163,50
060372912203,205.9,172.8,20.9,101,82,19
060372912201,151.2,118.3,24.3,78,67,11
060375410021,1700.0,1419.0,200.0,1465,1273,192
060375434003,327.5,275.2,42.7,314,246,68
060375434002,844.0,696.1,113.8,694,537,157
060375438011,1216.8,853.8,299.7,1025,649,376
060375433211,1872.9,1628.2,168.8,1652,1509,143
060375434001,467.5,373.6,66.5,448,355,93
060375433225,724.5,643.5,55.9,775,734,41
060375433222,602.6,550.2,36.2,639,614,25
060375433212,993.1,864.8,105.2,1092,962,130
060375439031,544.0,399.6,118.2,407,258,149
060375439032,920.0,678.0,194.4,863,581,282
060375433064,1094.0,827.0,214.0,1147,860,287
060375433061,879.8,646.2,198.3,868,606,262
060375433063,281.2,255.2,19.3,190,174,16
060375433223,1201.7,1098.6,77.9,1338,1265,73
060375433042,1454.2,1316.6,97.4,1525,1469,56
060375433221,837.0,759.9,56.9,874,810,64
060375433224,493.9,455.6,24.7,462,440,22
060375433044,771.0,714.0,39.0,797,777,20
060375433041,592.5,551.1,23.4,599,585,14
060375433043,914.4,849.2,40.1,949,926,23
060376028012,344.6,313.9,17.6,207,202,5
060376028021,437.2,401.6,17.0,522,497,25
060376028011,757.5,691.1,30.7,629,607,22
060376003022,352.1,322.8,15.3,402,391,11
060376003023,438.9,407.9,17.2,455,443,12
060376004004,666.5,625.4,22.2,758,736,22
060376002022,744.9,692.3,25.3,677,661,16
060376003021,710.5,664.6,25.3,666,636,30
060372380001,355.2,331.2,12.5,371,363,8
060372380002,493.4,460.3,19.7,467,456,11
060372380003,499.0,465.5,19.4,495,485,10
060376002023,356.0,329.9,11.7,398,388,10
060376003033,458.0,417.6,21.5,347,324,23
060376003042,188.1,170.0,12.8,158,150,8
060376003031,141.3,127.9,7.0,105,105,0
060376003041,372.4,336.2,27.5,283,269,14
060376003043,140.4,132.0,4.7,163,152,11
060376003032,194.9,183.2,6.5,233,224,9
060376002013,268.0,234.7,10.3,221,211,10
060376002012,408.0,357.3,15.7,350,336,14
060376002021,424.0,383.0,23.0,419,400,19
060375435013,580.9,427.4,123.8,539,374,165
060375436011,1476.2,1071.3,358.0,1115,702,413
060375435014,699.0,492.0,183.0,846,509,337
060375435012,607.7,417.2,170.7,563,347,216
060375435021,426.8,319.4,89.3,344,255,89
060375435022,304.2,227.6,63.7,277,201,76
060375438012,418.2,307.7,91.9,446,297,149
060375437012,558.1,397.7,123.7,448,306,142
060375438023,601.1,414.4,155.7,576,362,214
060375438022,409.4,298.8,93.6,321,205,116
060375438013,275.4,194.9,69.8,285,197,88
060375438024,844.7,615.2,189.5,737,502,235
060375438021,669.4,500.5,138.2,573,346,227
060375437011,451.9,337.7,92.2,398,264,134
060375732022,526.3,443.8,54.6,406,357,49
060375730021,325.0,286.0,21.0,260,230,30
060375732023,532.0,445.7,57.5,447,373,74
060375753001,266.5,226.8,23.8,308,267,41
060375753002,250.6,222.3,17.8,242,189,53
060375752013,438.4,366.7,47.1,359,307,52
060375752012,324.3,265.9,44.3,249,215,34
060375752011,248.8,213.1,26.2,231,197,34
060375732021,356.3,297.2,39.9,304,258,46
060375733001,535.0,432.9,69.1,485,407,78
060375732011,476.3,394.6,62.1,524,430,94
060375731001,405.8,328.8,52.8,395,334,61
060375722021,204.8,158.6,34.5,151,119,32
060375732012,528.0,436.0,64.0,453,366,87
060375722011,418.0,305.4,87.6,361,264,97
060375734011,551.0,406.0,122.0,489,350,139
060375752022,263.0,218.6,33.1,144,122,22
060375752023,168.8,140.2,21.0,135,113,22
060375752021,367.9,311.1,40.6,318,242,76
060375733002,232.5,187.5,30.6,188,158,30
060375751022,352.4,273.0,52.7,284,230,54
060375751021,371.3,288.0,57.4,328,260,68
060375751011,397.9,317.2,52.5,357,293,64
060375734024,717.9,498.1,165.2,598,434,164
060375734022,324.4,242.5,59.9,410,302,108
060375734025,803.9,565.8,178.9,674,476,198
060375734023,519.0,389.2,94.6,431,341,90
060375720011,834.2,579.7,198.0,810,539,271
060375773001,406.6,265.5,116.5,401,282,119
060375773003,409.6,279.2,101.0,368,268,100
060375773002,566.7,383.0,146.6,570,400,170
060375775042,449.1,231.7,192.1,355,186,169
060590995112,492.3,259.3,211.2,468,262,206
060590995113,468.3,221.3,220.3,431,245,186
060590995122,467.4,248.1,198.3,301,180,121
060590995114,425.6,218.4,179.9,415,238,177
060376701003,1016.7,599.3,354.3,1027,586,441
060372963002,1182.0,766.4,345.1,1372,863,509
060372963001,630.9,393.6,199.0,556,363,193
060372933061,296.7,171.1,107.3,207,148,59
060376701002,307.5,192.4,97.3,443,252,191
060376701001,907.8,560.3,299.6,790,460,330
060376700032,614.7,322.2,239.3,574,342,232
060376701004,432.0,258.4,155.5,307,181,126
060376700022,915.7,529.1,326.6,1001,567,434
060376700021,606.3,351.9,208.4,402,233,169
060376700031,236.9,123.4,94.7,285,153,132
060376700012,608.1,322.7,230.7,703,377,326
060376700011,773.9,404.3,321.3,664,327,337
060376510024,487.1,263.6,188.4,458,237,221
060376510013,924.8,497.5,363.1,884,457,427
060376510014,442.4,231.6,177.4,487,241,246
060372933072,227.4,172.4,42.3,130,94,36
060372933071,339.3,257.2,63.1,384,281,103
060372933042,444.0,332.7,86.8,359,265,94
060372933041,740.2,542.8,157.8,566,391,175
060372933022,722.9,468.1,207.1,525,341,184
060372933021,873.0,534.6,287.6,896,534,362
060372944211,293.6,226.0,53.6,194,118,76
060372933011,1193.2,697.3,446.3,1253,662,591
060375436031,934.0,606.0,282.0,954,598,356
060375436032,1014.0,771.0,188.0,1055,826,229
060375436022,861.3,566.1,247.7,849,528,321
060377031004,657.8,597.2,34.6,713,677,36
060377031006,414.7,379.9,16.6,348,334,14
060377031005,457.1,411.5,28.3,524,497,27
060377031002,811.4,744.8,38.1,809,795,14
060377031003,709.6,651.5,36.2,704,682,22
060372351002,627.5,580.1,26.3,665,640,25
060372351004,585.4,544.8,26.5,617,597,20
060372351003,642.7,589.9,34.3,638,612,26
060377032005,804.1,745.8,32.4,759,740,19
060377031001,504.9,474.5,14.3,512,490,22
060372364003,757.8,696.6,35.3,724,697,27
060372364002,952.9,889.8,35.2,909,892,17
060372364001,656.3,607.6,23.5,786,773,13
060372361003,836.5,767.4,28.7,827,821,6
060372362041,626.6,581.7,24.3,452,442,10
060372351001,602.8,558.8,18.6,611,594,17
060377032006,574.6,523.8,23.8,583,553,30
060372349022,480.3,446.7,20.6,454,437,17
060372347004,287.7,265.0,12.5,375,366,9
060372349023,401.1,374.0,16.7,318,306,12
060377032004,624.9,572.7,28.3,630,617,13
060372346004,836.0,779.5,31.1,851,822,29
060372349012,452.9,423.9,17.8,433,408,25
060372347003,547.4,502.9,23.3,521,499,22
060372346003,448.9,408.7,22.5,495,474,21
060372346002,383.9,350.7,17.5,362,338,24
060377032002,567.3,526.5,23.3,546,535,11
060377032003,425.5,387.8,16.5,395,380,15
060377032001,705.1,664.1,24.6,714,699,15
060372361002,409.9,371.4,14.3,337,330,7
060372361004,386.1,355.8,16.5,434,421,13
060372345012,634.9,572.5,40.3,783,764,19
060372343003,432.6,401.6,18.2,469,456,13
060372345023,504.6,456.3,25.9,437,414,23
060372343002,365.2,342.7,8.3,414,410,4
060372343004,546.3,508.7,19.2,554,547,7
060376007022,612.0,586.0,12.0,603,585,18
060376007021,551.5,515.2,21.8,593,585,8
060376007042,898.5,818.8,53.2,883,858,25
060376007041,825.0,769.0,28.0,838,805,33
060372380004,475.8,450.4,11.5,410,404,6
060372380005,581.0,552.5,11.0,640,622,18
060372384004,586.5,542.1,26.8,600,588,12
060372384003,501.0,458.4,20.1,506,498,8
060372381002,521.9,486.7,19.8,478,462,16
060372381003,426.5,387.3,26.3,487,480,7
060372381004,524.3,485.0,22.3,516,503,13
060372381001,597.4,548.5,27.5,513,494,19
060376008014,512.2,476.2,20.6,509,495,14
060376008011,490.2,458.1,18.7,437,435,2
060376008012,476.2,448.6,16.6,506,493,13
060376021031,596.3,522.3,44.5,423,344,79
060376021061,786.3,654.1,96.6,625,506,119
060376021033,650.6,568.7,54.5,531,453,78
060376021052,480.1,409.1,48.0,438,371,67
060376024031,298.8,258.7,26.8,278,237,41
060376024021,449.2,353.1,72.8,397,297,100
060376021062,672.0,543.0,92.0,504,393,111
060376021051,240.4,199.2,28.3,303,256,47
060376021053,142.9,118.4,16.8,186,151,35
060376021042,714.6,618.0,64.7,637,542,95
060376021041,744.8,647.7,64.2,730,631,99
060376017001,132.7,118.8,9.7,115,100,15
060376017003,195.3,174.6,12.8,169,147,22
060376017002,293.8,264.3,18.5,208,185,23
060376017004,350.9,319.1,21.8,294,252,42
060376018022,279.6,259.6,14.2,294,246,48
060376018021,525.2,467.0,38.0,461,391,70
060376018011,497.0,445.3,28.2,406,367,39
060376018012,254.7,231.4,13.4,223,192,31
060376011002,512.1,457.6,34.2,452,413,39
060376011001,532.6,488.2,12.2,445,429,16
060376025093,234.5,206.8,18.7,186,163,23
060376025094,227.0,200.4,18.1,197,178,19
060376025091,425.2,356.6,48.3,343,262,81
060376025084,414.4,363.2,32.8,355,306,49
060376025083,446.1,389.1,41.6,377,322,55
060376020021,347.4,313.4,22.3,226,196,30
060376020022,475.7,426.9,31.6,451,396,55
060376005022,586.2,546.6,23.6,589,558,31
060376005021,514.9,471.0,28.7,523,490,33
060376005012,657.5,604.3,34.5,719,695,24
060376020042,557.3,511.9,26.2,449,422,27
060376020041,718.8,670.5,24.4,623,580,43
060376020031,554.0,475.0,42.0,521,490,31
060376020032,704.0,639.0,33.0,557,503,54
060376019001,570.4,529.8,17.9,473,447,26
060376019002,467.9,435.6,14.5,407,369,38
060376006021,461.0,425.9,17.0,427,416,11
060376036002,305.1,207.1,79.0,307,195,112
060376036001,578.8,390.5,151.2,524,333,191
060376034003,515.3,347.1,135.6,534,347,187
060376035003,401.5,264.7,106.4,357,235,122
060376035002,487.6,346.8,111.2,432,283,149
060372430003,309.0,284.6,14.0,250,237,13
060372421001,501.0,470.0,12.0,445,411,34
060376012021,489.9,437.9,33.5,370,313,57
060376012122,851.3,764.9,51.4,688,610,78
060376012121,827.2,744.1,49.1,721,646,75
060376012112,479.6,439.0,24.3,461,434,27
060376012111,478.9,439.1,24.6,407,388,19
060376010021,345.7,313.3,18.9,367,351,16
060376010022,610.8,550.9,35.9,539,493,46
060376011003,418.6,380.0,22.1,365,337,28
060376010012,631.4,570.5,36.4,701,656,45
060376010023,753.5,694.8,31.6,676,636,40
060376009023,288.8,265.5,13.9,296,264,32
060376009022,417.2,383.5,20.1,388,361,27
060376009024,773.0,707.0,37.0,808,777,31
060376009112,769.0,672.5,49.4,753,671,82
060376010011,404.1,363.7,21.0,409,392,17
060376009122,742.7,670.4,42.7,570,526,44
060376009021,459.1,417.6,26.8,443,423,20
060376009111,487.0,430.5,32.6,410,371,39
060376009123,318.3,292.6,13.5,363,336,27
060376009121,741.9,662.5,46.1,635,578,57
060376007023,941.0,886.0,31.0,942,911,31
060376007031,1239.9,1160.7,51.1,1189,1156,33
060376008023,500.1,467.1,16.5,433,417,16
060376008022,408.4,382.7,13.2,440,428,12
060376008021,492.4,460.9,16.4,555,535,20
060376008013,387.5,365.6,11.9,433,429,4
060372352023,414.7,388.8,15.6,433,426,7
060372352022,661.6,618.5,27.5,573,561,12
060372352021,546.6,490.7,27.5,557,536,21
060372349021,295.9,269.6,13.9,243,233,10
060372348003,314.9,286.7,17.3,285,277,8
060372349011,327.5,299.9,15.6,276,261,15
060372348002,303.3,278.1,14.5,378,367,11
060372761003,518.5,466.2,31.1,439,405,34
060372201002,345.0,316.4,20.8,378,353,25
060372195002,481.4,435.2,29.5,527,487,40
060372197003,686.8,613.6,40.1,522,487,35
060372362031,873.7,793.7,47.7,697,675,22
060372362042,412.7,387.1,13.8,342,335,7
060372362032,271.4,250.2,11.7,263,251,12
060372200004,329.6,305.2,13.8,308,284,24
060372200005,465.5,426.4,20.2,354,334,20
060372200003,295.7,273.7,12.4,235,225,10
060372198003,311.8,288.7,12.9,241,219,22
060372198002,342.0,316.3,14.1,301,278,23
060372185002,550.5,484.5,38.3,509,481,28
060372185001,487.6,433.9,33.3,442,409,33
060372184003,279.7,252.8,18.6,280,265,15
060372197001,488.2,445.8,25.9,518,485,33
060372197002,340.8,311.2,18.1,261,244,17
060372186003,461.3,410.8,26.6,317,297,20
060372186001,366.6,326.5,21.2,379,353,26
060372186002,317.4,293.5,11.8,246,238,8
060372182102,515.1,457.3,28.7,354,330,24
060372182103,249.9,221.7,14.0,245,231,14
060372195001,350.2,318.5,22.2,377,348,29
060372361005,327.6,298.0,20.8,360,325,35
060372361001,285.2,259.4,18.1,284,261,23
060372200001,536.0,486.6,24.7,565,541,24
060372200002,493.7,447.8,24.0,454,433,21
060372342002,362.9,324.1,22.8,363,346,17
060372342003,562.1,501.9,35.2,498,465,33
060372342001,542.9,506.0,21.2,533,504,29
060372193003,468.6,433.1,22.8,379,353,26
060372193002,294.9,267.0,15.3,294,276,18
060372193001,323.8,296.1,14.8,286,268,18
060372187021,359.9,326.7,17.3,342,325,17
060372187012,545.6,504.5,20.2,580,547,33
060372182201,397.3,354.1,27.3,506,469,37
060372182203,253.3,227.3,16.4,179,167,12
060372187022,337.8,307.4,13.7,272,260,12
060372189003,530.3,483.2,17.4,516,496,20
060372189001,632.3,566.8,37.6,702,678,24
060372187011,340.4,299.5,24.2,366,339,27
060372188002,355.4,312.7,22.1,312,284,28
060372181101,759.4,668.6,58.1,612,531,81
060372181203,170.3,148.0,13.8,167,151,16
060372181102,330.5,289.8,26.1,312,280,32
060372171002,476.8,439.9,20.8,435,401,34
060376039003,315.8,236.7,59.1,231,150,81
060376039005,213.4,158.4,37.3,140,103,37
060376039002,269.0,203.2,52.6,241,166,75
060376039006,810.7,637.9,126.4,765,561,204
060376039001,258.2,197.2,47.7,213,146,67
060376038022,530.3,409.3,90.3,412,285,127
060376038021,609.2,459.0,105.4,663,459,204
060376038012,231.0,174.7,39.9,222,162,60
060376041002,349.7,267.8,62.7,306,232,74
060376041001,549.0,420.3,95.1,336,251,85
060376038013,191.0,143.5,31.7,270,182,88
060376037024,628.1,376.3,215.2,623,337,286
060376024026,292.3,204.1,68.6,250,158,92
060376024024,519.6,369.9,116.6,483,330,153
060376024025,271.3,190.1,63.4,240,171,69
060376024043,591.1,493.5,67.3,563,448,115
060376024042,440.4,353.0,62.7,432,334,98
060376038011,591.9,503.0,65.3,578,494,84
060376024023,479.9,351.3,100.1,429,289,140
060376024022,530.7,406.9,94.8,497,360,137
060376025052,334.2,291.6,27.3,274,245,29
060376024041,495.1,393.2,72.3,448,349,99
060376024033,484.4,393.8,64.1,393,305,88
060376024032,492.9,414.6,54.3,470,381,89
060376025081,322.1,280.9,25.4,372,319,53
060376025082,419.9,365.5,39.1,379,321,58
060376037023,613.6,376.2,198.5,636,346,290
060376037032,445.1,280.4,137.1,473,278,195
060376037033,305.8,212.4,72.9,312,182,130
060376037043,424.5,335.3,68.4,290,247,43
060376037042,859.5,715.9,101.8,754,649,105
060376037041,301.0,245.5,41.2,150,126,24
060376037021,305.9,241.6,49.3,431,269,162
060376037031,283.2,200.8,63.2,301,194,107
060376025071,628.7,549.9,54.8,545,488,57
060376025042,363.1,316.3,31.0,431,386,45
060376025051,727.8,631.7,65.1,449,402,47
060376025041,503.8,447.9,33.2,599,536,63
060376025092,293.3,245.7,33.6,220,164,56
060376025061,362.4,324.4,22.7,416,381,35
060376025072,527.0,462.1,45.7,403,347,56
060376025062,497.3,435.8,41.5,544,503,41
060372756032,264.8,213.0,38.4,288,224,64
060372755004,620.7,536.3,42.6,541,453,88
060372723012,614.7,488.4,84.1,513,402,111
060372723013,388.4,316.3,50.0,393,302,91
060372751022,403.3,339.4,38.9,380,315,65
060372752003,494.9,416.4,47.8,395,340,55
060377028021,467.9,369.4,72.3,387,304,83
060377028022,568.9,449.1,87.9,627,485,142
060372723011,423.2,332.7,59.3,391,305,86
060372751021,843.0,705.0,85.0,646,518,128
060377028011,1048.2,845.9,142.3,888,700,188
060377028012,690.5,549.5,95.7,587,445,142
060377027002,512.0,408.0,78.6,493,362,131
060377027003,408.8,325.8,62.8,410,319,91
060377026004,924.5,696.8,191.9,797,573,224
060377026005,455.6,347.3,88.2,435,300,135
060372751011,549.0,404.0,119.0,546,411,135
060377027001,480.9,383.1,75.4,476,354,122
060377026006,770.0,617.5,111.4,648,477,171
060377027004,517.4,410.1,79.1,601,474,127
060377026003,408.9,326.4,59.3,394,307,87
060377025014,1070.7,847.4,161.0,1093,825,268
060372772002,58.3,46.8,8.2,82,71,11
060372772001,835.8,661.2,128.3,749,644,105
060372771003,483.3,375.3,81.3,618,442,176
060372771001,527.3,374.3,121.2,503,325,178
060372760001,643.4,452.8,150.2,571,339,232
060377030011,1156.6,973.7,112.0,1097,926,171
060372761002,1051.5,884.8,100.9,949,854,95
060372771002,445.3,326.4,92.9,475,345,130
060377030023,1528.5,1386.5,100.8,1635,1486,149
060372761001,1110.6,925.3,125.4,1043,906,137
060372774002,184.7,166.1,10.4,266,251,15
060372774001,242.3,217.9,13.6,322,296,26
060376014021,490.4,429.2,41.6,438,360,78
060376014024,307.6,268.1,28.8,239,200,39
060376014013,532.9,461.7,49.1,574,497,77
060376014012,424.1,362.1,41.7,310,262,48
060376014011,665.3,600.2,44.7,580,539,41
060372383201,288.4,257.8,16.6,235,228,7
060372382002,576.4,538.9,25.9,472,455,17
060372383203,158.1,140.5,9.7,152,147,5
060372383202,142.3,126.5,8.8,198,191,7
060372397021,194.0,182.1,5.7,187,179,8
060372397024,193.7,181.9,5.7,164,153,11
060372397022,160.3,146.7,7.4,166,154,12
060372383101,284.0,262.8,6.2,261,250,11
060372377201,184.7,171.6,7.0,152,147,5
060372377101,368.1,340.8,15.1,280,272,8
060372378003,320.3,294.0,16.4,313,300,13
060372378002,430.9,398.0,23.0,420,396,24
060372375002,150.9,138.1,8.0,215,204,11
060372375001,435.3,398.5,23.0,324,308,16
060372383102,419.7,376.3,23.4,384,360,24
060372377202,407.8,368.8,20.5,281,264,17
060372397012,355.5,330.2,16.9,272,253,19
060372397011,398.1,371.8,17.5,348,313,35
060372377102,380.4,353.8,13.0,305,291,14
060372376002,202.1,187.4,7.0,203,194,9
060372376003,157.2,145.1,5.5,129,117,12
060372376004,162.1,149.8,5.7,165,153,12
060372376001,277.2,254.9,9.8,254,239,15
060372393101,242.4,226.3,7.7,188,175,13
060372393102,235.5,218.1,9.0,212,197,15
060372393103,208.9,195.0,6.6,176,153,23
060372392013,147.8,135.9,6.5,155,143,12
060372405004,274.6,247.7,11.8,295,280,15
060372405001,332.9,295.8,15.7,295,287,8
060372405002,296.6,275.0,10.8,272,264,8
060372402002,524.8,487.2,22.0,433,413,20
060372402001,217.8,202.1,9.0,164,161,3
060372406001,249.1,230.5,8.9,219,208,11
060372406004,324.2,300.2,13.0,257,244,13
060372406003,300.6,278.4,12.1,289,276,13
060372406002,241.7,223.9,9.6,194,185,9
060372400201,455.1,413.9,19.8,430,412,18
060372400101,198.6,182.2,8.3,112,105,7
060372402003,472.7,437.6,18.9,408,386,22
060372407004,323.8,302.1,11.3,305,287,18
060372407003,393.3,366.6,14.2,421,403,18
060372398024,222.0,202.5,10.4,194,185,9
060372398022,238.6,211.6,15.7,178,165,13
060372398023,288.0,263.9,12.6,249,240,9
060372400102,270.9,250.9,9.8,242,233,9
060372400202,340.4,315.3,12.3,313,295,18
060372400103,264.7,243.8,13.2,235,223,12
060372398021,246.4,230.3,7.3,255,247,8
060372396021,310.0,280.9,13.2,273,262,11
060372396022,350.0,317.1,14.8,279,260,19
060372397023,141.4,133.0,5.6,118,107,11
060372396011,279.2,261.7,9.0,236,225,11
060372396012,373.8,350.3,12.0,295,281,14
060372393201,284.6,265.4,10.1,265,246,19
060372393202,306.4,285.6,10.9,264,241,23
060372395023,245.0,223.7,12.3,210,200,10
060372398013,190.4,173.5,10.1,197,192,5
060372395022,174.4,159.8,7.8,144,139,5
060372398012,223.3,203.5,11.9,144,140,4
060372395013,265.5,245.6,8.3,212,204,8
060372395012,222.2,205.5,7.0,209,201,8
060372395011,244.9,221.7,13.1,263,257,6
060372393302,325.2,302.5,13.6,268,247,21
060372371013,70.8,64.3,3.7,64,59,5
060372371014,217.0,197.1,11.5,161,151,10
060372371015,223.1,202.6,11.8,189,176,13
060372327002,494.8,459.4,14.7,445,415,30
060372321102,400.3,372.3,13.4,303,285,18
060372371021,302.5,279.2,11.4,277,260,17
060372371022,360.5,332.8,13.6,336,306,30
060372392012,217.9,199.8,10.0,187,173,14
060372392011,223.5,204.9,10.3,207,199,8
060372327001,608.8,555.2,29.2,564,536,28
060372327003,212.5,193.8,10.1,215,198,17
060376206024,716.4,416.9,250.1,652,364,288
060376206023,481.4,262.6,185.3,468,262,206
060376206022,454.2,247.2,175.4,441,242,199
060376206025,565.1,357.9,165.7,619,384,235
060376206013,573.6,362.2,159.6,558,348,210
060376505011,626.4,318.8,263.7,619,289,330
060376206021,566.0,318.0,206.0,567,295,272
060376206014,843.3,565.8,194.3,709,447,262
060376206011,489.8,321.2,137.3,356,224,132
060376206012,624.4,404.6,174.1,549,367,182
060376205213,321.2,216.1,79.4,298,193,105
060376205214,428.0,280.8,116.1,450,299,151
060376205011,589.2,390.7,153.6,556,340,216
060376205015,350.0,215.8,110.8,347,194,153
060376205014,404.7,255.3,121.2,365,216,149
060376205013,565.7,343.1,179.5,544,322,222
060376205212,514.5,340.8,135.4,457,323,134
060376205211,554.1,367.0,144.2,571,380,191
060376203051,374.2,245.9,101.7,346,213,133
060376203057,677.1,431.0,201.2,709,437,272
060376203055,381.1,239.6,116.6,372,224,148
060376203053,348.6,224.2,99.8,330,205,125
060376203052,889.8,581.2,248.1,946,560,386
060376203056,335.7,203.8,103.7,352,212,140
060376203054,397.5,241.3,122.8,417,247,170
060376202012,355.9,237.9,102.7,393,257,136
060376202011,368.1,246.1,106.3,391,245,146
060376203013,648.7,405.7,183.6,667,374,293
060376203014,586.3,367.4,172.9,582,342,240
060376200021,565.4,331.8,184.2,530,316,214
060379800301,0.0,0.0,0.0,1,1,0
060376200022,643.6,368.2,221.6,650,306,344
060376200023,515.8,291.7,180.1,491,283,208
060376203032,684.5,447.9,189.1,740,427,313
060376203034,502.2,314.2,157.2,569,329,240
060376203031,716.2,486.9,192.8,724,435,289
060376203033,679.0,414.6,223.3,695,401,294
060376203012,643.7,406.8,195.0,675,375,300
060376208004,500.3,311.2,153.8,519,310,209
060376203011,733.4,476.4,221.0,739,434,305
060376201023,1069.0,619.1,359.2,1060,581,479
060376201021,490.7,307.5,145.9,547,301,246
060376201012,1160.3,638.9,435.0,1077,512,565
060376201013,982.7,588.1,329.0,978,531,447
060376201022,387.2,247.5,111.2,351,229,122
060376201011,821.0,505.0,245.0,750,412,338
060376200013,815.0,443.3,305.8,863,466,397
060376200012,741.2,402.9,281.4,621,323,298
060376200011,680.2,371.0,263.6,578,279,299
060376208001,435.7,276.0,132.1,450,257,193
060376204003,708.0,460.5,207.6,647,371,276
060376204004,819.2,504.1,272.7,714,427,287
060376204001,1089.5,648.3,388.2,1191,631,560
060376204002,387.2,252.1,113.5,454,272,182
060376023023,396.3,243.0,128.7,382,228,154
060376022004,866.0,517.2,273.0,755,450,305
060376205016,617.9,424.8,142.9,546,358,188
060376205012,396.6,239.2,125.9,428,235,193
060376023022,339.4,209.4,108.5,359,200,159
060376023024,796.8,492.2,253.6,723,409,314
060376023014,348.5,219.9,105.4,279,170,109
060376023021,382.4,234.4,124.2,402,232,170
060376023015,618.6,442.1,132.7,571,364,207
060376023013,521.8,341.3,140.5,429,257,172
060376023012,558.4,407.9,112.3,519,335,184
060376023011,610.8,445.4,126.8,496,324,172
060379800131,2.0,1.0,0.0,5,3,2
060376022003,335.0,247.8,67.0,270,172,98
060376022002,254.1,180.2,60.1,294,179,115
060376022001,668.2,484.1,150.2,431,296,135
060376021063,260.5,209.2,40.6,325,233,92
060376022005,664.4,538.0,86.3,578,478,100
060376021032,471.3,375.7,64.5,390,322,68
060376013024,1194.5,1096.3,56.7,806,778,28
060376013022,707.6,644.2,33.9,799,748,51
060376013023,414.2,381.2,23.9,596,568,28
060376013033,730.0,672.5,28.5,728,697,31
060376013012,612.1,531.8,53.5,608,547,61
060376013021,230.5,213.7,9.3,233,223,10
060376013032,367.7,341.2,14.4,367,353,14
060376013011,442.6,383.8,39.8,469,418,51
060376013031,530.8,494.3,20.1,501,476,25
060377030012,936.4,788.7,90.7,982,868,114
060377026002,650.9,498.6,120.2,594,442,152
060377030013,1316.9,1096.3,159.0,951,803,148
060377030022,805.2,716.2,68.9,808,730,78
060377026001,435.5,330.4,79.8,446,319,127
060377030024,1101.4,982.8,92.1,1158,1050,108
060377030021,838.0,772.0,40.0,825,773,52
060372719011,436.9,353.2,53.2,331,268,63
060372718012,736.8,606.4,86.8,643,539,104
060372718013,216.4,177.8,25.6,241,202,39
060372718011,352.9,294.0,40.5,384,312,72
060372718021,510.3,416.8,57.0,460,381,79
060372718023,624.7,530.3,62.4,490,423,67
060372717021,589.3,485.3,67.8,691,555,136
060372717012,451.3,365.6,60.8,530,423,107
060372717014,704.6,584.0,82.2,685,569,116
060372717023,646.8,528.7,74.6,466,352,114
060372717013,1057.2,867.9,127.3,899,742,157
060372718022,1317.2,1152.4,96.8,1031,901,130
060377028013,737.8,600.1,100.7,693,537,156
060372345011,603.6,562.6,21.6,429,415,14
060372324004,686.0,630.3,33.8,688,661,27
060372340004,438.9,406.9,17.6,449,439,10
060372343001,818.2,758.7,32.5,805,785,20
060372340005,502.2,459.5,23.1,441,420,21
060372345021,339.6,311.6,15.3,299,289,10
060372324005,364.3,338.6,16.6,255,243,12
060372324003,414.1,374.4,23.3,396,373,23
060372315003,539.7,488.3,28.2,487,455,32
060372315002,593.8,548.9,27.4,616,591,25
060372314002,413.6,386.9,13.7,449,409,40
060372372023,351.3,319.3,16.7,265,251,14
060372372021,342.1,309.8,17.6,286,261,25
060372372024,428.4,389.8,18.7,333,318,15
060372372022,270.4,249.8,11.4,290,282,8
060372374021,398.1,365.6,15.2,393,375,18
060372374022,365.1,339.5,12.4,293,272,21
060372372013,237.6,217.0,10.7,191,179,12
060372372012,378.1,343.4,20.3,316,288,28
060372372011,325.9,296.5,16.9,282,266,16
060372324002,405.0,369.4,17.8,309,292,17
060372325001,463.4,433.2,16.5,459,442,17
060372326003,552.2,514.8,20.0,521,496,25
060372323002,339.0,312.4,13.5,332,323,9
060372323003,290.0,266.2,10.6,344,325,19
060372374012,404.0,374.6,16.0,346,327,19
060372374013,390.5,364.4,14.2,374,356,18
060372371012,289.4,264.2,14.5,202,189,13
060372371011,207.9,188.6,11.4,168,160,8
060372326002,525.0,479.0,28.0,430,395,35
060372326001,562.5,509.9,30.3,493,466,27
060372323001,527.3,482.8,20.0,448,423,25
060372324001,264.6,244.9,8.9,265,247,18
060372322003,298.4,276.1,10.1,350,337,13
060372316004,509.5,461.3,30.2,444,416,28
060372315001,580.4,522.7,36.8,597,571,26
060372316003,416.5,380.8,20.6,371,350,21
060372322002,297.3,273.8,12.9,227,211,16
060372322001,347.7,320.2,15.1,271,254,17
060372316002,385.0,350.0,19.3,359,332,27
060372316001,275.8,251.6,14.0,181,168,13
060372316005,350.7,320.6,18.0,262,238,24
060372312102,504.1,457.4,32.4,380,348,32
060372362021,490.1,448.5,21.3,375,364,11
060372362022,565.8,519.9,24.8,578,555,23
060372362023,209.6,191.2,9.4,269,265,4
060372198001,277.2,255.0,11.1,211,202,9
060372912102,580.7,453.0,92.4,595,426,169
060372912101,318.1,266.9,32.3,381,310,71
060372911301,372.1,309.8,44.3,318,255,63
060372911303,348.9,290.5,41.5,324,259,65
060372911201,533.0,484.0,27.0,516,479,37
060372911302,574.0,508.0,41.0,512,447,65
060375409024,0.8,0.7,0.0,7,7,0
060375409023,563.9,522.2,24.8,551,522,29
060375409022,865.1,808.2,33.8,819,800,19
060375410011,493.0,430.0,46.0,498,455,43
060375430005,308.8,281.2,15.1,314,308,6
060375409021,450.2,415.9,18.3,460,453,7
060375408005,488.3,448.7,21.6,593,575,18
060372911101,612.1,571.8,24.8,624,602,22
060372911102,400.9,368.2,19.2,390,374,16
060372413001,285.4,267.7,11.7,298,290,8
060372413002,374.6,351.3,15.3,408,392,16
060372414002,547.0,505.5,24.3,456,439,17
060375409014,181.3,167.6,7.9,140,128,12
060375409013,425.8,393.7,18.5,433,405,28
060375409012,443.7,404.0,21.2,369,342,27
060372412025,216.7,199.0,8.9,232,220,12
060372412024,245.1,225.1,10.1,198,190,8
060372412021,371.3,339.0,17.2,407,383,24
060372412022,302.2,279.5,10.5,352,338,14
060372404023,356.8,328.8,18.3,339,319,20
060372412011,373.3,343.5,19.0,431,414,17
060372412012,309.8,284.3,15.6,297,286,11
060372412013,239.1,219.4,12.1,168,162,6
060372412023,249.7,231.4,8.3,157,142,15
060372404022,405.4,376.8,15.2,385,362,23
060372405003,307.4,287.5,11.0,293,282,11
060372414001,322.8,296.6,15.2,255,248,7
060375409011,432.4,389.8,21.9,254,237,17
060372410021,350.3,320.1,17.4,334,323,11
060372410011,291.9,269.0,11.7,212,204,8
060372410012,265.9,244.1,10.3,242,234,8
060372411203,164.0,148.3,7.6,151,144,7
060372411201,262.0,240.2,10.0,174,162,12
060372411101,425.8,384.5,20.2,432,410,22
060372411204,253.5,228.8,12.0,182,171,11
060372411202,331.8,310.2,12.8,246,234,12
060372411102,238.2,222.8,9.2,220,212,8
060372732001,378.8,335.2,23.0,371,339,32
060372732002,447.6,397.8,26.3,394,364,30
060372732003,313.6,280.2,17.7,387,365,22
060377022025,454.9,371.3,57.7,370,310,60
060377022022,390.3,314.8,55.0,426,347,79
060377022024,546.0,431.9,87.2,484,372,112
060377022023,472.0,369.9,79.8,435,357,78
060372731003,768.5,654.7,73.4,459,377,82
060372731002,433.6,359.6,53.5,436,355,81
060372731001,502.5,422.8,53.8,369,306,63
060372766032,1781.6,1345.3,338.6,1673,1215,458
060372766014,644.6,436.4,166.1,664,434,230
060377029011,1588.0,1216.0,284.0,955,716,239
060377029012,1010.0,727.0,245.0,821,594,227
060372766011,536.0,357.6,147.7,552,322,230
060377029014,783.3,551.9,187.1,924,629,295
060372766031,1145.3,861.9,207.8,1062,793,269
060372766042,572.6,415.3,120.0,851,625,226
060372766013,1138.1,847.1,221.3,459,268,191
060372766041,637.0,457.7,138.1,705,442,263
060372766012,647.3,458.0,141.8,487,311,176
060372741001,1513.5,1128.5,291.1,1066,785,281
060372738001,866.1,743.1,83.6,786,664,122
060372737003,582.3,509.6,51.4,576,509,67
060372737001,470.3,392.4,49.6,478,395,83
060372737002,474.7,398.9,45.3,535,459,76
060372714002,601.0,463.7,111.3,622,444,178
060372699031,1502.5,1263.1,144.4,1278,1095,183
060372699043,609.9,509.9,56.6,492,420,72
060372699042,783.7,668.7,62.6,638,547,91
060372717011,474.0,377.3,71.3,433,337,96
060372699041,290.6,247.9,23.3,279,223,56
060372699071,1333.0,1151.6,105.5,1078,949,129
060372693003,514.5,418.4,76.0,501,375,126
060372711001,378.5,294.5,65.0,379,284,95
060372711002,434.4,337.7,73.1,421,314,107
060372693005,350.3,282.9,53.9,332,266,66
060372693004,532.6,430.1,81.9,532,412,120
060372693002,505.5,416.6,70.5,527,401,126
060372693001,444.4,358.1,74.1,467,348,119
060372690002,488.2,394.2,80.2,516,394,122
060372699052,764.9,654.6,69.3,655,567,88
060377025011,568.9,464.4,79.1,412,347,65
060377025015,450.7,362.2,70.8,435,317,118
060372701001,820.8,710.1,65.0,647,553,94
060372699051,250.7,214.3,23.2,148,122,26
060372699061,1371.3,1192.0,105.0,1097,940,157
060372701003,949.0,829.0,69.0,807,696,111
060377025012,413.4,352.9,35.6,349,284,65
060377025013,453.0,386.7,39.0,382,311,71
060377024002,426.1,341.7,56.6,353,274,79
060372701002,409.3,354.2,31.1,374,329,45
060372690003,363.9,303.8,43.3,399,328,71
060372690001,381.8,316.3,50.3,501,382,119
060372690005,606.6,502.5,80.0,409,313,96
060372698002,986.0,855.5,75.8,750,637,113
060372698001,653.9,551.8,67.2,571,472,99
060372679021,537.6,438.9,73.8,583,464,119
060372679022,801.9,649.4,120.4,672,510,162
060372679023,575.5,462.7,92.8,465,377,88
060372679011,528.0,374.4,133.9,729,490,239
060372671002,525.8,403.9,103.8,524,404,120
060377023002,679.9,555.5,88.4,640,501,139
060372713003,772.3,595.5,118.8,710,547,163
060372712002,400.2,329.0,46.9,379,306,73
060372713004,313.6,239.4,51.6,303,229,74
060372713005,437.1,327.4,81.1,400,296,104
060372715001,588.4,462.9,92.3,533,399,134
060372676002,329.5,253.3,57.4,269,206,63
060372675011,789.9,647.4,100.8,716,584,132
060372673002,1105.5,913.5,119.3,941,772,169
060372677001,656.0,544.3,70.8,666,546,120
060372712001,590.2,485.2,69.3,514,437,77
060372673001,500.5,417.2,54.0,280,231,49
060372677002,803.0,664.0,93.0,569,467,102
060372716003,309.4,252.9,39.9,427,347,80
060372716004,626.0,519.7,71.5,359,269,90
060372716002,570.0,464.7,75.0,527,404,123
060372713002,454.5,368.6,62.7,497,389,108
060372713001,444.5,360.4,61.3,404,309,95
060372716001,455.4,378.7,51.2,500,397,103
060372717022,388.8,315.1,45.0,338,270,68
060372711003,483.8,375.8,79.9,380,303,77
060372678003,747.9,596.1,113.2,669,511,158
060372678002,483.7,385.4,74.2,467,367,100
060372678001,414.3,333.4,56.1,383,303,80
060372653051,1691.9,1464.3,118.8,1613,1403,210
060372655101,1136.4,880.2,189.3,1183,940,243
060372655102,382.3,297.7,61.3,473,376,97
060372655203,1147.5,914.6,173.1,1138,876,262
060372652023,222.3,183.5,26.6,103,83,20
060372652021,201.5,166.3,24.1,303,251,52
060372653032,804.8,695.1,57.0,895,764,131
060372653042,288.7,246.6,19.9,351,293,58
060372653041,786.2,668.4,59.5,797,684,113
060372653031,540.3,459.9,42.7,528,443,85
060376034001,508.0,419.0,72.0,429,340,89
060376029003,363.8,314.4,36.3,304,250,54
060376026007,719.7,661.6,43.5,713,680,33
060376026001,758.3,696.4,44.5,833,797,36
060376035001,393.6,289.5,83.0,370,241,129
060376026005,367.5,334.8,23.5,403,394,9
060376026006,677.7,621.2,40.5,724,693,31
060376026004,425.1,391.6,26.1,459,438,21
060376026002,612.1,564.3,29.8,660,642,18
060376026003,397.5,366.4,19.4,495,490,5
060376030061,415.4,307.1,88.3,391,270,121
060376030041,474.8,367.6,86.0,375,279,96
060376030062,207.6,159.8,38.7,184,105,79
060376030051,607.6,491.5,82.6,522,450,72
060376030052,565.3,447.1,85.0,539,424,115
060376030013,436.7,346.7,68.0,536,402,134
060376030014,513.2,431.0,59.4,554,454,100
060376031011,488.6,362.8,99.6,469,331,138
060376031013,451.5,335.3,92.1,403,313,90
060376030011,270.0,214.6,42.4,176,147,29
060376030053,415.6,338.7,54.5,448,377,71
060376029002,482.8,431.0,35.0,368,311,57
060376029001,479.3,427.8,34.8,421,362,59
060376030012,540.3,466.2,55.4,379,330,49
060376027004,331.7,308.3,15.1,370,361,9
060376027002,645.6,583.3,35.3,557,542,15
060376027001,606.1,555.4,28.4,483,468,15
060376027003,441.0,411.5,19.5,424,413,11
060376005011,777.6,735.8,23.6,922,903,19
060376006012,595.4,548.8,28.2,535,528,7
060376006013,431.4,393.8,24.7,420,411,9
060376006011,381.2,355.6,13.4,358,348,10
060376004003,526.1,491.1,21.8,565,557,8
060376004001,441.3,420.4,10.4,425,416,9
060376004002,278.7,265.6,6.6,326,319,7
060372380006,570.0,534.0,19.0,591,581,10
060376028023,585.9,532.9,32.0,397,387,10
060376028024,627.5,576.7,33.5,572,553,19
060376028022,393.4,366.8,11.0,423,405,18
060372214011,340.4,304.5,21.0,402,365,37
060372189002,454.2,418.1,21.2,320,297,23
060372188001,412.1,362.8,16.7,377,344,33
060372181202,229.0,197.2,19.1,272,239,33
060372181201,538.3,463.6,45.0,431,361,70
060372214012,687.6,623.4,34.0,613,523,90
060372213022,450.3,384.9,32.2,385,336,49
060372213021,480.2,407.5,45.3,465,405,60
060372214021,497.8,433.1,39.6,421,349,72
060372214022,332.2,288.9,26.4,332,289,43
060372213031,262.7,229.3,18.9,208,174,34
060372213042,216.8,189.2,15.6,184,168,16
060372213032,172.5,150.5,12.4,123,109,14
060372313003,327.1,298.5,15.5,293,276,17
060372313004,283.4,257.9,15.2,231,214,17
060372313002,256.8,234.1,12.8,214,206,8
060372225003,484.5,437.7,24.1,364,345,19
060372225002,515.9,461.5,27.3,441,400,41
060372313001,628.3,575.4,27.5,515,477,38
060372225001,349.8,309.7,20.3,270,250,20
060372221002,376.0,341.9,14.6,337,317,20
060372221003,243.0,220.9,9.5,229,214,15
060372221001,479.2,429.1,26.1,362,329,33
060372312101,276.0,253.1,13.8,219,204,15
060372226002,735.4,659.6,41.4,580,530,50
060372226003,373.3,334.4,20.1,368,333,35
060372222001,679.5,599.1,39.5,534,488,46
060372226001,333.9,299.1,17.9,326,291,35
060372219002,257.1,226.8,16.5,199,174,25
060372218101,379.9,335.2,24.5,338,301,37
060372215002,351.4,309.0,26.9,305,267,38
060372215001,530.6,472.0,35.1,497,442,55
060372222002,419.3,365.0,22.3,441,398,43
060372212102,539.0,465.5,32.8,431,373,58
060372212101,301.5,267.1,21.7,209,165,44
060372216011,451.1,394.1,25.5,406,355,51
060372216012,379.9,331.9,21.5,343,309,34
060372212202,366.3,315.1,32.5,386,322,64
060372212201,271.2,234.4,23.3,190,157,33
060372216021,254.3,219.8,21.9,262,210,52
060372129001,277.1,225.4,28.0,330,270,60
060372127011,674.7,525.7,108.9,630,435,195
060372127022,480.7,389.2,64.0,386,292,94
060372213041,450.4,371.1,47.6,378,326,52
060372321202,284.2,257.2,15.2,265,243,22
060372321201,277.4,250.7,14.9,148,142,6
060372328002,413.6,383.3,20.2,402,388,14
060372328001,300.3,275.0,16.6,239,220,19
060372321101,298.9,278.4,10.9,284,269,15
060372317102,316.9,282.6,18.4,203,188,15
060372317103,302.7,269.9,17.5,220,202,18
060372317101,174.4,155.5,10.1,140,127,13
060372321203,470.1,418.1,25.7,382,352,30
060372319001,535.9,478.8,35.5,436,398,38
060372319002,547.9,489.4,34.6,429,394,35
060372318003,167.4,149.5,10.2,135,124,11
060372317203,367.7,333.9,14.0,284,256,28
060372317202,156.6,141.5,7.2,111,102,9
060372318001,199.4,179.7,11.3,207,195,12
060372317201,587.9,528.4,31.5,498,450,48
060372318002,494.4,445.6,28.0,352,327,25
060372392022,193.5,178.7,9.0,168,158,10
060372392023,246.6,227.8,11.5,166,151,15
060372392021,462.6,428.8,20.8,351,326,25
060372294101,314.6,282.9,12.5,221,205,16
060372294102,240.4,216.1,9.5,211,197,14
060372393301,238.1,221.6,10.2,222,204,18
060372294202,445.0,389.6,29.0,350,317,33
060372293003,212.5,191.0,10.3,176,166,10
060372293002,257.1,231.1,12.5,194,180,14
060372293001,357.4,323.9,16.5,191,177,14
060372285002,311.8,283.3,14.2,266,247,19
060372284201,120.2,109.3,4.1,107,104,3
060372285003,151.4,138.4,5.4,95,85,10
060372284202,340.4,309.5,11.5,253,226,27
060372285001,316.0,290.6,15.2,228,217,11
060372283201,114.2,106.0,4.7,76,69,7
060372283202,259.2,240.7,10.6,169,156,13
060372283101,176.3,158.8,8.8,191,177,14
060372283103,259.4,233.6,12.9,160,146,14
060372283104,64.9,58.4,3.2,59,56,3
060375352002,474.3,439.8,16.6,363,340,23
060375352001,364.7,338.7,13.3,331,311,20
060372400203,288.0,265.1,14.8,319,304,15
060375351015,340.2,312.0,17.0,259,244,15
060375351014,472.4,427.7,27.8,456,436,20
060372423001,427.1,394.8,17.5,375,349,26
060375351023,225.4,208.9,9.8,252,233,19
060375351021,217.2,201.3,9.4,188,186,2
060375351022,410.7,383.5,13.1,316,291,25
060375351012,198.1,183.7,7.8,170,162,8
060372395021,225.0,203.4,12.4,226,212,14
060372398011,202.3,182.8,11.1,196,191,5
060375350013,298.4,277.7,11.4,206,185,21
060375351013,189.7,176.2,7.7,161,155,6
060375350011,421.4,381.6,15.7,301,279,22
060375350012,143.7,128.2,5.3,80,72,8
060372247001,324.9,271.0,36.4,283,217,66
060372311001,109.8,93.1,10.9,89,69,20
060372311002,230.2,202.0,16.4,114,101,13
060372247002,331.0,269.6,38.5,406,310,96
060372247003,178.1,148.6,20.0,120,94,26
060372244202,109.5,96.3,10.0,101,86,15
060372218102,196.0,165.8,21.7,254,205,49
060372218202,312.7,264.5,34.7,321,253,68
060372218201,140.3,118.7,15.6,177,149,28
060372217101,434.1,389.9,21.4,398,348,50
060372217102,233.9,210.1,11.6,229,197,32
060372211101,138.6,116.5,14.1,173,141,32
060372211102,385.6,324.2,39.2,293,232,61
060372216022,207.5,189.9,7.9,153,134,19
060372216023,158.5,145.1,6.1,99,90,9
060372211202,360.7,327.5,21.1,340,279,61
060372211201,324.3,294.5,18.9,204,176,28
060372244102,303.4,252.1,23.1,341,283,58
060372244101,389.1,330.5,31.8,337,276,61
060372244201,373.0,302.9,26.3,294,247,47
060372242002,124.9,105.8,9.6,120,99,21
060372243101,214.3,181.0,16.7,176,147,29
060372243202,217.7,183.9,16.9,214,188,26
060372243102,167.3,141.3,13.0,113,93,20
060372243201,379.9,329.4,32.9,303,263,40
060372242001,320.9,278.7,28.0,268,234,34
060372311003,173.1,155.7,6.8,152,133,19
060372284103,264.8,238.1,10.4,240,220,20
060372284102,166.1,149.4,6.5,116,104,12
060372284101,115.0,103.4,4.5,105,95,10
060372246002,262.3,233.3,18.9,150,133,17
060372246001,332.2,291.1,20.2,277,242,35
060372240202,326.5,277.0,31.0,191,168,23
060372267002,335.3,298.9,19.9,237,213,24
060372267001,318.7,283.1,17.5,166,156,10
060372267003,278.3,246.4,14.1,217,198,19
060372267004,190.2,168.0,9.2,147,133,14
060372264102,265.8,237.6,10.9,222,203,19
060372264101,346.2,309.4,14.1,225,211,14
060372098202,247.2,210.5,22.4,172,142,30
060372100103,276.3,235.3,25.1,298,244,54
060372240102,308.8,251.0,36.2,187,152,35
060372240101,269.4,220.2,28.8,127,101,26
060372079002,1462.8,1181.2,198.5,667,482,185
060372134023,346.4,293.8,36.4,275,210,65
060372134021,377.6,320.2,39.6,266,205,61
060372134011,343.6,293.9,31.8,219,169,50
060372134012,464.4,393.9,44.3,248,204,44
060372134022,177.8,152.1,16.5,148,114,34
060372122031,122.6,104.1,11.0,0,0,0
060372122022,139.9,117.3,13.8,115,90,25
060372122021,330.8,277.3,32.7,274,213,61
060372122042,252.0,214.9,22.7,150,105,45
060372122032,300.0,255.9,27.0,236,173,63
060372352012,405.1,375.1,21.9,476,466,10
060372352013,429.8,394.9,21.2,417,403,14
060372352011,346.2,316.9,16.3,343,338,5
060372348004,389.1,354.2,21.9,357,349,8
060372379003,473.0,437.8,19.8,505,488,17
060372379004,382.8,360.3,13.1,388,373,15
060372379002,535.7,493.7,24.4,490,474,16
060372373001,404.6,370.9,17.0,372,361,11
060372373004,493.2,452.1,20.0,564,541,23
060372373003,524.5,487.8,20.7,477,463,14
060372379001,389.1,366.2,13.3,333,330,3
060372373002,357.4,328.1,16.1,399,382,17
060372384002,690.6,643.4,28.4,806,789,17
060372384001,458.9,424.0,22.2,486,478,8
060372382003,484.1,454.7,15.6,499,482,17
060372382004,581.1,539.1,22.5,519,505,14
060376001003,493.8,458.9,23.3,502,478,24
060376002011,413.4,381.1,19.6,396,382,14
060376001002,323.1,301.1,14.8,306,286,20
060376001001,479.8,444.8,19.3,538,516,22
060372382001,580.0,541.4,26.3,706,677,29
060372378004,496.5,452.5,22.0,465,450,15
060372373005,341.9,311.5,15.9,301,276,25
060372374023,344.2,323.1,10.6,300,279,21
060372378001,414.1,382.2,18.9,336,324,12
060372374011,334.8,313.9,11.3,290,283,7
060372348001,251.3,231.6,11.0,287,280,7
060372347002,316.8,294.5,11.1,381,364,17
060372347001,314.4,291.3,12.3,300,297,3
060372346001,490.5,451.9,17.1,500,473,27
060372325004,301.2,276.3,11.3,248,239,9
060372325003,376.4,345.7,15.7,310,296,14
060372325002,394.3,362.3,16.9,296,281,15
060372345022,268.1,243.2,11.9,230,215,15
060375767003,1063.5,823.4,162.8,933,737,196
060375772004,1000.3,732.9,185.3,1083,820,263
060375768022,961.1,752.8,129.9,882,726,156
060375768021,885.0,699.0,115.0,756,629,127
060375771005,809.4,621.4,126.3,670,548,122
060375771004,876.8,660.5,146.5,867,690,177
060375769041,576.8,468.3,68.0,535,451,84
060375769013,352.5,291.9,32.7,308,260,48
060375769032,424.2,351.0,36.1,339,287,52
060375769042,538.2,436.7,58.0,467,389,78
060375769031,476.1,383.9,51.6,473,402,71
060375771002,686.7,494.6,151.4,626,446,180
060375771003,523.7,374.5,106.1,568,388,180
060375770001,681.6,530.3,97.3,663,535,128
060375770002,835.4,644.3,123.1,682,566,116
060375770004,417.2,302.0,72.5,361,279,82
060375770003,614.3,452.9,96.5,562,452,110
060375773004,580.6,373.7,164.9,605,394,211
060375772001,632.8,442.6,147.8,618,437,181
060375776033,854.5,563.2,233.6,846,532,314
060375774001,455.9,296.4,129.3,407,258,149
060375774002,350.4,225.9,98.7,336,220,116
060375773006,356.5,221.6,109.5,324,200,124
060375774003,596.4,368.3,179.8,569,375,194
060375771001,692.0,529.0,110.0,623,476,147
060375770005,275.5,188.6,61.6,344,218,126
060375751012,663.0,502.6,104.5,565,455,110
060375751031,494.0,391.4,59.3,415,366,49
060375751032,618.4,489.7,76.3,534,460,74
060375751033,409.3,322.9,52.3,326,273,53
060375762002,410.6,324.9,52.9,370,311,59
060375762004,264.3,204.6,35.8,209,168,41
060375758032,365.3,290.2,54.9,322,245,77
060375763012,290.3,229.8,42.3,313,255,58
060375763011,240.6,185.9,39.0,151,119,32
060375763022,191.3,148.5,22.5,115,93,22
060375763013,273.3,212.1,32.2,338,294,44
060375758031,375.8,288.0,63.6,244,190,54
060375763014,209.3,160.4,35.4,157,97,60
060375762001,389.3,311.7,47.3,229,192,37
060375765011,414.0,345.0,42.0,348,303,45
060375766012,388.5,309.2,48.9,356,295,61
060375766013,469.3,366.9,65.4,409,338,71
060375765012,656.0,503.0,86.0,520,444,76
060375763023,410.0,327.0,51.0,350,270,80
060375763021,199.5,158.3,21.2,219,179,40
060375764012,481.5,399.7,42.8,309,259,50
060375764011,270.2,229.0,24.1,198,164,34
060375766024,526.8,407.4,82.2,397,320,77
060375766023,377.2,300.4,47.4,353,292,61
060375766022,372.9,288.5,56.8,402,311,91
060375765022,391.5,322.7,33.6,330,289,41
060375765023,342.5,282.3,29.4,346,300,46
060375765021,860.0,716.0,81.0,634,560,74
060375765032,677.0,563.0,65.0,658,564,94
060375765031,617.0,506.0,61.0,561,470,91
060375764022,577.5,481.4,59.8,442,379,63
060375764021,349.9,296.6,32.3,220,189,31
060375764031,366.3,308.4,35.3,299,249,50
060375764032,491.0,397.0,55.0,385,324,61
060375768013,929.2,728.9,125.1,822,701,121
060375768012,503.6,396.7,72.7,503,410,93
060375768011,434.9,355.0,42.7,400,366,34
060375769011,375.3,307.8,43.1,234,185,49
060375769012,542.0,425.0,69.0,493,419,74
060375754022,137.4,111.8,16.4,119,101,18
060375754021,323.6,263.2,38.6,226,184,42
060375730022,280.0,234.0,25.0,190,170,20
060375753003,328.0,293.0,22.4,236,198,38
060375702025,607.1,500.5,76.2,471,389,82
060375421061,209.7,190.8,8.1,183,171,12
060375421062,248.9,227.1,10.2,172,161,11
060375421052,129.3,118.2,5.3,90,86,4
060375421063,122.8,112.3,5.0,77,67,10
060375702023,245.2,196.8,37.3,187,155,32
060375537021,555.1,503.4,38.1,565,486,79
060375538023,625.1,555.9,50.7,490,418,72
060375537022,380.6,343.2,22.8,276,237,39
060375537013,199.6,178.3,15.4,164,138,26
060375537012,288.2,259.9,15.3,267,231,36
060375418021,399.1,361.9,21.5,362,326,36
060375418024,161.1,144.2,9.8,130,117,13
060375537011,200.0,180.1,10.2,205,165,40
060375538022,808.6,665.7,107.9,670,506,164
060375538012,165.1,142.0,17.7,191,175,16
060375538013,518.2,451.4,50.8,390,352,38
060375536011,701.8,618.6,57.0,502,446,56
060375539014,279.8,233.0,36.5,266,204,62
060375538011,157.5,131.1,20.6,125,101,24
060375536012,568.7,452.2,88.3,491,374,117
060375538021,314.5,248.8,50.8,244,196,48
060375535022,541.8,462.3,49.6,429,376,53
060375536022,501.4,414.2,68.7,329,269,60
060375536021,733.0,645.0,47.0,584,526,58
060375401023,732.9,660.9,37.0,578,517,61
060375400001,381.2,338.2,25.2,330,293,37
060375401012,493.4,445.9,29.0,397,355,42
060375401021,509.3,460.1,27.7,429,393,36
060375401014,664.0,595.4,43.3,650,569,81
060375401013,524.6,445.0,48.1,499,424,75
060375400003,163.2,144.8,10.8,150,129,21
060375400002,310.4,275.8,20.2,335,292,43
060375359021,559.5,471.6,68.0,473,398,75
060375401011,302.2,253.7,29.2,214,176,38
060375359011,441.7,365.7,58.0,409,311,98
060375513001,527.7,380.4,112.2,493,310,183
060375513002,502.3,348.6,119.8,431,268,163
060375509011,777.0,553.0,168.0,430,268,162
060375513003,576.0,406.0,133.0,447,302,145
060375509012,268.4,183.7,69.7,272,151,121
060375542042,450.2,338.0,81.7,406,296,110
060375542032,582.7,373.3,180.0,513,316,197
060375542041,169.1,124.0,35.8,156,116,40
060375542033,322.8,241.2,65.1,253,171,82
060375542043,638.4,461.3,134.5,468,346,122
060375541012,499.0,380.0,84.8,348,255,93
060375540021,618.3,428.6,151.2,585,395,190
060375531003,354.8,204.0,130.3,388,203,185
060375531004,663.4,395.9,228.4,429,248,181
060375541052,402.1,317.7,65.3,322,253,69
060375541051,523.3,412.9,84.4,415,331,84
060375541011,306.1,198.1,88.7,239,146,93
060375540012,319.2,216.5,83.9,293,185,108
060375541041,232.4,171.1,46.7,226,157,69
060375541042,459.6,338.5,92.4,328,224,104
060375531001,856.5,630.8,177.4,861,629,232
060375531002,321.4,207.5,94.2,319,194,125
060375541031,542.1,338.7,168.2,495,307,188
060375532005,509.9,341.3,143.2,463,306,157
060375532003,232.2,158.6,62.1,186,129,57
060375532004,325.0,217.6,91.3,324,198,126
060375532001,399.6,279.7,99.9,403,273,130
060375532002,358.3,250.8,89.6,327,210,117
060375518005,363.7,264.8,80.0,393,269,124
060375518004,291.8,213.6,62.7,339,231,108
060375518001,653.5,477.3,138.6,536,372,164
060375530003,756.0,524.0,189.0,628,410,218
060375530004,422.9,288.3,108.4,419,291,128
060375529005,484.3,356.5,102.1,572,371,201
060375530001,262.4,196.5,54.2,278,218,60
060375530002,250.0,187.2,51.7,215,149,66
060375529004,742.0,536.5,166.2,571,400,171
060375519005,227.9,163.2,54.2,217,158,59
060375519004,323.8,231.5,75.6,274,199,75
060375528003,383.7,273.8,92.7,351,222,129
060375528002,770.3,560.0,175.3,645,439,206
060375528004,612.3,442.6,141.4,459,288,171
060375519002,208.6,149.1,48.7,246,169,77
060375511012,209.7,155.5,42.2,244,177,67
060375511013,371.7,275.6,74.9,206,154,52
060375511023,452.0,355.0,71.0,343,256,87
060375511022,493.3,363.5,104.8,407,281,126
060375511011,412.2,290.1,92.8,364,249,115
060375511021,200.6,139.1,48.6,135,97,38
060375509013,468.6,320.7,121.7,344,210,134
060375509023,265.5,176.6,74.7,300,168,132
060375509021,553.6,352.0,173.9,554,311,243
060375510004,443.6,276.1,140.7,432,249,183
060375510005,476.1,300.2,148.7,374,207,167
060375505002,408.5,312.1,73.0,361,273,88
060375026023,502.4,377.3,90.9,404,273,131
060375026022,546.7,414.3,98.2,599,430,169
060375025001,590.7,461.2,94.3,493,367,126
060375026021,467.1,356.0,83.6,347,278,69
060375322003,623.3,522.3,68.5,762,614,148
060375322002,348.3,291.5,39.0,194,166,28
060375322001,565.3,474.0,61.1,453,373,80
060375320022,601.4,483.5,87.7,542,425,117
060375320012,502.2,404.0,72.5,455,360,95
060375320021,213.7,179.6,24.6,141,122,19
060375320011,554.2,457.8,70.6,473,397,76
060375321021,631.7,490.6,103.6,564,420,144
060375321022,659.1,513.8,103.9,604,452,152
060375321012,824.8,673.1,96.2,608,521,87
060375321013,331.9,278.7,36.3,265,217,48
060375007006,234.0,185.0,32.0,210,155,55
060375006005,484.8,402.6,52.7,423,355,68
060375007003,441.1,343.8,77.3,410,313,97
060375007005,393.3,313.6,57.3,346,278,68
060375321011,544.2,451.4,60.0,473,395,78
060375301012,400.5,293.1,81.7,323,247,76
060375301014,198.6,145.3,40.5,229,162,67
060375301013,287.8,229.7,42.6,343,281,62
060375317022,188.8,162.3,16.9,146,129,17
060375317012,606.4,518.6,48.1,496,439,57
060375317011,746.6,638.4,58.9,654,575,79
060375303012,395.0,338.5,33.3,366,323,43
060375303011,328.5,281.5,27.7,228,196,32
060375303023,371.9,312.7,37.3,368,318,50
060375303024,367.3,307.4,38.2,352,306,46
060375303022,660.7,573.1,44.9,534,477,57
060375316032,633.6,552.2,45.5,552,492,60
060375305003,406.2,354.2,33.4,266,237,29
060375304001,432.7,375.5,30.2,0,0,0
060375023015,225.0,177.0,36.3,240,188,52
060375008001,436.8,345.4,66.3,421,335,86
060375022001,913.8,649.0,220.4,796,562,234
060375008003,441.3,354.4,67.1,413,316,97
060375023021,907.9,714.6,139.5,534,421,113
060375022005,408.9,298.8,83.8,325,236,89
060375029021,561.4,397.3,134.8,485,342,143
060375029022,227.3,163.8,49.7,161,123,38
060375023014,502.7,392.4,84.9,509,392,117
060375020042,705.7,556.9,112.1,533,389,144
060375023012,258.5,209.6,36.1,191,148,43
060375023013,351.3,282.8,49.1,387,297,90
060375022003,281.6,210.0,54.8,257,184,73
060375022004,362.7,257.8,84.6,370,284,86
060375022002,374.0,269.4,79.4,436,309,127
060375009003,610.5,482.7,97.4,543,431,112
060375009002,501.9,386.7,85.2,419,331,88
060375007001,354.7,271.6,67.2,396,315,81
060375007002,469.3,368.6,91.5,465,354,111
060375006001,310.5,264.7,30.8,309,262,47
060375006002,314.9,273.5,25.7,256,233,23
060375009004,321.3,242.6,59.9,212,173,39
060375004022,324.7,275.7,35.8,245,205,40
060375009001,530.5,405.6,92.7,535,402,133
060375006004,328.4,263.8,42.0,320,260,60
060375006003,247.3,196.8,40.2,276,218,58
060375004023,560.0,456.4,77.7,517,409,108
060375004021,349.2,301.0,34.7,350,285,65
060375010011,410.0,291.0,88.0,384,277,107
060375012002,902.1,670.3,171.9,837,619,218
060375010013,216.8,175.0,32.2,137,103,34
060375010021,513.6,380.1,107.1,490,360,130
060375010012,345.4,278.9,51.2,330,263,67
060375013006,267.6,189.2,62.5,259,165,94
060375013005,396.1,280.0,92.6,348,244,104
060375012001,1147.1,745.3,336.2,1033,660,373
060375020041,424.2,295.9,106.3,405,277,128
060375021001,438.0,313.8,94.3,424,307,117
060375021002,756.4,543.1,162.2,650,485,165
060375010025,452.3,340.5,94.9,374,256,118
060375010024,390.1,293.7,81.9,369,256,113
060375021003,646.7,458.1,147.6,624,442,182
060375501005,312.4,220.2,79.6,465,321,144
060375500001,331.6,233.8,84.4,156,104,52
060375501006,611.1,467.8,116.5,546,357,189
060375501004,438.1,334.1,81.5,511,364,147
060375501003,382.7,291.9,71.9,304,222,82
060375501002,485.3,366.8,93.2,391,287,104
060375027004,521.3,391.5,97.9,529,382,147
060375028022,56.9,40.3,13.2,13,6,7
060375028021,734.1,520.5,170.2,473,340,133
060375502011,605.2,439.4,134.4,515,355,160
060375526021,638.0,436.0,172.0,575,351,224
060375041021,14.0,7.0,6.0,66,35,31
060375523023,624.2,434.5,150.6,578,359,219
060375523021,401.5,278.7,96.6,249,166,83
060375522001,454.6,329.1,97.9,411,284,127
060375523022,301.3,208.8,73.0,310,208,102
060375523012,772.3,573.0,154.8,701,510,191
060375524002,252.6,192.0,50.7,236,174,62
060375524001,140.7,106.9,28.2,138,107,31
060375524003,212.2,161.3,42.6,249,171,78
060375545111,1148.5,745.7,350.6,1194,650,544
060375041012,596.5,398.6,160.7,515,339,176
060375030003,550.8,438.2,83.8,408,318,90
060375030002,517.7,412.7,80.1,423,334,89
060375031041,143.9,114.3,21.7,104,79,25
060375031033,344.8,260.6,65.0,247,182,65
060375030001,202.2,155.8,34.9,171,124,47
060375029012,954.3,672.4,230.2,917,645,272
060375029023,301.8,228.6,55.3,272,196,76
060375031042,491.7,365.1,97.8,461,328,133
060375031031,417.1,315.7,77.9,411,299,112
060375031034,225.9,167.7,45.1,131,94,37
060375031032,403.4,299.3,81.7,340,243,97
060375032022,337.4,215.8,100.1,315,202,113
060375029013,539.6,371.8,142.7,500,312,188
060375029011,544.3,370.0,145.8,470,299,171
060375032023,459.1,317.8,114.4,382,259,123
060375020051,566.7,365.9,163.2,481,317,164
060591101093,628.0,341.0,245.0,626,320,306
060591101094,589.0,295.0,261.0,607,274,333
060591102023,633.3,376.8,214.8,498,294,204
060591102022,420.3,241.0,153.0,348,178,170
060591102021,1002.0,578.0,365.0,973,468,505
060591102013,842.0,490.0,308.0,709,378,331
060375508006,549.0,376.7,148.1,498,314,184
060375514011,612.6,471.3,110.6,500,349,151
060375508007,311.0,213.3,83.9,290,207,83
060375340022,327.5,284.9,28.8,300,252,48
060375340013,293.0,260.5,21.1,232,193,39
060375339021,532.7,469.2,36.4,462,397,65
060375339022,400.2,342.8,32.5,272,231,41
060375339014,235.3,204.7,16.2,161,142,19
060375339013,385.2,335.1,26.5,278,242,36
060375339012,422.7,371.6,31.3,325,285,40
060375339011,306.3,269.4,22.7,307,261,46
060375340012,548.6,485.7,39.5,440,377,63
060375508005,483.4,298.2,166.0,470,282,188
060375508004,356.5,220.0,122.5,363,202,161
060375508002,450.1,266.1,157.4,356,195,161
060375508001,432.8,266.3,147.0,372,205,167
060375509022,327.0,250.7,57.9,347,248,99
060375509024,260.0,199.3,46.1,355,256,99
060375507004,336.7,230.6,88.6,297,204,93
060375507005,592.6,409.8,153.1,438,297,141
060375507006,396.6,271.0,104.7,358,216,142
060375506023,667.7,443.7,191.0,654,371,283
060375507003,506.2,343.7,137.4,451,235,216
060375506022,556.3,375.6,154.0,504,307,197
060375340011,369.9,324.2,29.1,299,261,38
060375507001,431.7,303.6,112.5,402,245,157
060375340021,616.3,532.3,49.5,689,577,112
060375323041,817.1,684.8,87.0,658,551,107
060375323033,225.2,189.2,26.4,202,161,41
060375323032,1089.0,879.0,156.0,926,729,197
060375319014,360.7,309.7,32.1,333,283,50
060375319022,599.9,511.9,56.3,495,415,80
060375319023,328.8,275.7,34.4,312,259,53
060375506013,342.7,231.9,93.0,343,196,147
060375506014,420.1,287.7,105.1,313,199,114
060375506021,324.5,198.0,114.0,292,160,132
060375506011,718.9,526.0,141.4,531,363,168
060375506012,294.6,214.2,59.4,349,230,119
060375507002,605.5,413.9,161.3,545,317,228
060375710003,485.6,247.0,209.1,639,344,295
060375710004,403.6,199.3,179.3,397,195,202
060375710002,445.1,223.7,194.2,373,208,165
060375710001,536.1,259.7,243.2,510,264,246
060375710005,362.6,173.7,165.9,360,168,192
060375710006,687.0,334.6,310.3,617,308,309
060375708002,598.0,330.3,227.1,575,326,249
060375708003,535.6,306.6,190.0,486,287,199
060375709022,670.1,353.8,285.1,672,360,312
060375709021,502.8,260.1,218.1,453,247,206
060375709023,537.1,278.1,232.8,549,266,283
060375700014,439.7,229.3,179.3,363,183,180
060375700013,607.0,315.4,247.9,567,285,282
060375700012,337.1,169.4,144.7,353,177,176
060375700011,529.3,268.4,225.2,609,269,340
060375544052,710.1,519.2,147.7,652,447,205
060375544051,223.6,130.6,81.4,220,130,90
060375544063,859.3,476.0,335.3,740,384,356
060375544062,378.8,207.2,150.2,458,194,264
060375542031,251.3,137.5,101.3,214,128,86
060375544061,695.3,422.9,238.8,720,417,303
060375709014,377.3,192.0,165.3,393,209,184
060375709015,583.7,297.0,255.7,524,276,248
060375709012,627.7,316.3,270.1,606,324,282
060375709011,697.0,350.8,303.4,689,343,346
060375709013,599.2,269.4,293.4,607,301,306
060375545221,380.6,236.1,127.4,482,247,235
060375539022,439.8,360.1,58.8,425,319,106
060375539021,489.3,379.9,84.3,479,357,122
060375539013,687.8,549.1,107.6,568,417,151
060375539023,445.8,366.8,57.9,345,276,69
060375539012,467.4,380.3,67.5,446,342,104
060375539011,471.7,386.6,65.9,397,321,76
060375535021,502.2,431.4,49.8,482,392,90
060375535042,417.5,374.7,28.3,296,262,34
060375535043,387.7,326.4,45.2,328,269,59
060375535041,522.1,454.2,50.6,487,422,65
060375535031,680.4,563.4,85.9,576,483,93
060375534003,329.5,253.8,51.7,253,197,56
060375534002,529.3,407.3,83.2,406,309,97
060375534001,435.2,336.9,68.1,388,291,97
060375543011,322.8,246.6,55.3,339,257,82
060375543013,216.2,162.4,38.7,261,200,61
060375702031,578.3,484.0,65.8,525,439,86
060375543021,628.0,528.0,79.0,605,483,122
060375543012,277.7,209.0,59.5,323,246,77
060375543022,352.3,265.0,75.5,225,161,64
060375707011,372.3,235.4,103.8,330,194,136
060375708005,422.8,254.7,137.9,500,287,213
060375700034,279.4,181.6,72.4,267,170,97
060375700035,380.6,247.4,98.6,355,215,140
060375708004,494.7,288.0,170.0,444,258,186
060375700032,521.0,306.6,183.3,551,298,253
060375700033,313.0,187.9,105.9,322,179,143
060375700031,446.1,256.5,163.7,446,254,192
060375708001,572.5,318.5,206.8,568,341,227
060375700023,507.5,271.0,199.2,463,245,218
060375700022,337.2,177.5,134.5,314,168,146
060375544032,561.3,423.6,104.1,595,453,142
060375544031,580.4,436.0,109.3,528,415,113
060375542013,633.3,448.2,157.7,598,398,200
060375700021,457.3,249.5,175.3,403,211,192
060375544042,776.0,565.0,168.0,653,463,190
060375544041,393.5,300.2,73.0,334,238,96
060375736017,401.6,206.5,170.2,408,221,187
060375736018,418.4,218.5,176.1,422,229,193
060375736019,373.9,201.7,152.1,392,206,186
060375737004,499.4,305.3,161.0,452,286,166
060375737003,550.4,339.7,173.4,550,344,206
060375736016,431.2,230.3,168.2,422,237,185
060375737006,440.9,222.2,188.5,486,263,223
060375711023,444.9,252.2,160.7,458,246,212
060375711024,333.1,188.8,120.3,301,170,131
060375711014,636.5,328.9,267.6,597,307,290
060375711013,600.2,306.5,256.3,492,265,227
060375711022,423.5,218.5,181.4,401,202,199
060375711025,355.7,178.1,148.1,338,167,171
060375711021,397.8,201.4,167.4,406,214,192
060375711015,340.0,159.2,157.9,383,182,201
060375737005,303.1,152.8,129.5,327,167,160
060375737002,336.0,184.8,133.4,360,195,165
060375737001,384.0,211.2,152.6,334,161,173
060375738003,549.3,278.6,230.2,525,282,243
060375738004,507.2,275.3,195.8,530,293,237
060375711011,334.2,155.3,155.7,350,165,185
060375711012,392.0,182.2,182.6,432,213,219
060591101021,700.3,352.7,298.9,773,324,449
060591101162,656.7,326.1,290.3,665,321,344
060591103041,933.7,486.3,401.1,851,422,429
060591101102,821.6,431.8,328.6,816,480,336
060591101163,583.0,358.0,210.0,529,300,229
060591103042,1052.0,543.0,446.0,998,511,487
060375545191,643.9,421.5,188.8,640,370,270
060375545172,699.8,442.3,226.3,593,352,241
060375545122,1041.4,681.4,321.4,1176,701,475
060375545183,624.8,406.3,197.8,737,414,323
060375545121,1714.0,1111.0,529.0,1725,1005,720
060375545182,1061.2,697.6,328.3,1057,608,449
060591101153,691.0,335.0,328.0,714,338,376
060591101151,427.0,245.0,159.9,413,228,185
060591101152,422.0,241.0,159.1,486,245,241
060591103011,1139.0,599.0,479.0,1098,577,521
060375545181,605.1,390.9,191.5,573,356,217
060375545112,540.5,339.3,176.4,556,357,199
060375546001,667.1,429.7,198.7,644,404,240
060375529001,208.2,145.4,54.8,206,137,69
060375529002,327.2,253.6,58.1,250,167,83
060375529003,225.1,156.6,59.8,262,162,100
060375521004,322.3,244.3,60.2,281,188,93
060375521005,430.4,330.7,76.2,388,266,122
060375528001,247.4,188.5,45.8,203,147,56
060375542012,441.9,306.6,106.9,433,276,157
060375542011,276.8,189.2,70.9,284,184,100
060375540022,650.3,454.8,158.8,551,356,195
060375540023,291.4,211.4,64.4,291,206,85
060375533002,395.6,268.2,108.6,443,289,154
060375540013,355.9,241.3,97.7,293,190,103
060375540014,298.9,196.5,85.5,269,144,125
060375533001,310.5,220.6,77.0,340,230,110
060375533003,435.5,309.4,108.0,349,238,111
060375540011,419.1,270.6,122.7,403,230,173
060375532006,405.4,274.8,111.8,387,259,128
060375532007,484.2,329.4,133.0,401,256,145
060375518002,725.8,509.9,179.9,678,421,257
060375518003,446.2,316.1,106.1,348,239,109
060375517001,825.0,641.0,153.0,629,461,168
060375362004,406.9,335.1,56.4,348,278,70
060375516001,19.4,12.4,6.0,1,1,0
060375515023,513.9,334.0,154.1,514,280,234
060375515022,597.2,408.2,154.6,409,262,147
060375517005,270.9,206.1,47.9,225,162,63
060375517004,278.4,218.3,39.7,218,171,47
060375517002,480.7,352.7,104.4,476,328,148
060375517003,337.0,247.9,72.1,313,205,108
060375515021,554.9,382.0,140.5,482,312,170
060375512012,822.0,605.5,170.5,713,485,228
060375515011,1165.0,788.2,307.3,1034,663,371
060375514012,694.3,496.1,162.2,679,422,257
060375515012,598.4,381.3,184.1,499,296,203
060375514022,680.9,475.0,165.3,669,418,251
060375514021,493.4,335.2,131.0,456,287,169
060375514023,492.0,333.2,129.3,460,265,195
060375512022,275.0,197.7,62.8,253,167,86
060375512023,855.0,617.1,194.7,647,445,202
060375512024,802.5,581.6,181.8,705,458,247
060375512011,559.0,384.5,146.5,495,325,170
060375512021,539.0,376.0,129.0,467,298,169
060375508003,326.1,187.4,116.2,302,153,149
060375520013,322.7,243.6,60.2,304,207,97
060375520012,465.3,351.4,86.8,389,285,104
060375521001,448.8,323.4,100.2,441,304,137
060375521003,420.1,298.1,97.2,355,238,117
060375520021,474.5,357.8,88.5,396,294,102
060375521002,443.5,334.6,88.2,464,300,164
060375520022,276.6,211.9,50.1,203,161,42
060375520023,286.6,219.5,52.0,211,171,40
060375547001,466.7,376.1,64.8,408,327,81
060375547002,603.2,492.2,76.8,562,447,115
060375547003,296.0,241.6,37.4,253,191,62
060375526013,365.2,312.3,34.4,284,238,46
060375526012,354.0,302.8,33.3,283,231,52
060375526011,378.2,315.4,40.0,249,213,36
060375526014,440.7,362.5,49.3,385,277,108
060375526023,364.5,267.2,74.5,251,185,66
060375526022,212.5,155.8,43.5,334,241,93
060375527002,275.7,204.6,58.9,255,179,76
060375527001,698.5,520.8,141.5,611,429,182
060375527003,447.9,329.4,95.0,394,281,113
060375527005,449.3,314.1,103.5,340,242,98
060375527004,317.5,222.0,73.1,256,173,83
060375522003,261.8,187.9,53.3,218,160,58
060375522002,508.2,384.6,91.6,559,391,168
060375523011,353.0,257.5,76.9,346,244,102
060375523013,233.2,176.3,44.6,270,200,70
060375502021,506.7,370.7,107.1,402,266,136
060375520011,445.5,330.6,88.0,518,374,144
060375502025,224.3,155.5,56.1,264,184,80
060375503003,294.4,202.4,75.5,339,223,116
060375502023,341.0,253.6,68.9,279,189,90
060375502024,332.4,240.4,73.6,282,185,97
060375502022,526.8,369.3,127.9,523,364,159
060375502012,403.1,310.7,77.7,363,239,124
060375028012,815.4,532.7,232.1,769,502,267
060375028014,504.7,347.4,129.0,497,345,152
060375028013,565.5,400.0,142.9,556,363,193
060375028015,446.0,313.5,108.5,462,319,143
060375501001,282.3,215.6,55.5,257,180,77
060375020032,362.3,274.7,68.4,292,202,90
060375020031,462.7,313.8,123.6,425,299,126
060375020053,636.3,394.1,206.8,583,348,235
060375019004,271.9,182.9,74.0,272,171,101
060375018041,391.8,284.1,75.8,389,269,120
060375014002,319.5,234.5,61.9,235,180,55
060375015043,298.7,219.3,57.9,233,175,58
060375015041,480.9,323.2,124.9,417,261,156
060375014003,439.1,316.1,93.5,348,244,104
060375018032,445.3,334.4,81.7,380,287,93
060375018031,502.6,375.3,88.7,331,239,92
060375018042,124.6,93.6,22.9,141,99,42
060375010022,300.6,213.6,71.7,274,186,88
060375010023,437.5,310.9,104.3,391,301,90
060375013004,464.5,324.3,110.2,557,368,189
060375013001,644.0,406.9,200.6,684,405,279
060375013003,363.1,247.0,88.6,341,226,115
060375013002,738.5,502.1,174.5,661,453,208
060375015031,409.4,286.8,89.3,365,241,124
060375015032,297.2,183.7,91.0,391,223,168
060375717041,402.1,326.7,49.3,315,260,55
060375717042,187.2,148.8,25.8,189,145,44
060375719001,840.1,607.7,181.3,713,457,256
060375715022,381.4,272.8,90.3,402,289,113
060375719002,597.9,417.3,141.7,609,421,188
060375715021,484.9,343.5,120.5,527,394,133
060375720013,629.9,411.6,168.4,583,373,210
060375715043,478.0,329.9,117.5,475,304,171
060375715044,560.5,392.6,132.6,476,354,122
060375715041,452.5,309.7,113.5,444,300,144
060375715032,662.8,474.5,144.4,553,382,171
060375714005,464.1,269.7,166.6,509,268,241
060375717031,164.3,136.9,18.7,167,126,41
060375717034,220.0,183.2,25.0,120,106,14
060375717033,170.7,141.2,19.9,178,136,42
060375703041,357.0,304.6,33.8,316,262,54
060375703032,589.0,468.9,87.2,508,421,87
060375703031,403.4,322.3,58.0,292,237,55
060375703013,390.8,311.9,59.4,450,351,99
060375703014,302.3,242.4,43.5,314,256,58
060375703011,697.1,559.5,105.4,363,300,63
060375716001,485.3,422.3,38.7,437,372,65
060375706011,628.4,478.7,106.5,476,390,86
060375706012,628.8,487.0,102.1,506,405,101
060375705012,486.6,383.2,75.1,468,365,103
060375702024,354.7,281.5,58.0,323,263,60
060375706013,248.4,199.1,39.7,215,162,53
060375706022,620.5,472.9,112.5,553,416,137
060591103013,481.9,236.5,215.7,533,279,254
060591103012,374.5,187.9,164.5,310,147,163
060591102012,916.0,471.0,384.0,822,411,411
060591103032,1034.7,510.3,474.0,975,482,493
060590869013,530.8,312.9,183.8,640,284,356
060590869012,422.6,236.3,161.3,268,144,124
060590869015,721.2,530.4,160.8,383,243,140
060590869014,157.8,99.0,47.1,124,65,59
060590869011,260.2,163.2,77.8,241,142,99
060591103031,738.8,376.7,313.8,785,430,355
060591103022,880.8,522.8,308.7,665,353,312
060591103014,556.7,289.8,233.2,537,287,250
060591105001,539.4,378.7,130.4,303,215,88
060591105004,230.3,159.1,62.5,312,195,117
060371836102,706.2,606.2,46.1,487,422,65
060371836202,267.3,233.1,16.5,223,194,29
060371831011,358.0,296.0,41.6,277,224,53
060371832202,478.7,413.4,38.3,393,316,77
060371832203,515.0,439.3,49.5,361,295,66
060371832201,275.2,221.8,34.6,293,243,50
060371832212,809.3,657.7,99.2,794,663,131
060371831032,724.3,572.5,99.8,552,428,124
060371831031,806.9,656.4,105.8,628,504,124
060371831013,731.2,610.2,78.3,630,525,105
060371831012,631.8,529.3,65.1,599,498,101
060371815003,583.2,480.0,72.8,598,485,113
060374638002,622.5,474.1,123.6,625,421,204
060374638004,729.3,555.0,143.4,666,491,175
060374638003,679.3,454.6,186.9,693,434,259
060371831041,893.3,710.0,126.9,910,667,243
060374807031,529.8,416.6,80.2,478,372,106
060374638001,527.2,335.7,160.4,504,245,259
060374639003,882.8,564.3,274.2,973,550,423
060371810003,392.1,267.7,105.5,350,228,122
060373009012,523.9,304.9,190.6,624,342,282
060373008001,795.8,465.4,277.3,822,531,291
060373008004,453.8,260.4,168.3,542,326,216
060373007021,1572.7,829.5,673.6,1545,861,684
060373009021,434.0,271.6,143.7,436,252,184
060373009022,662.0,414.4,219.3,685,427,258
060373006004,1062.6,608.1,381.5,752,428,324
060373007015,595.0,339.1,229.2,1045,583,462
060373008003,742.6,416.0,274.5,778,457,321
060373006002,445.5,248.8,162.1,394,208,186
060373006001,509.3,294.7,179.1,582,347,235
060373005021,780.5,463.6,260.8,655,411,244
060371031025,420.5,221.7,169.8,420,243,177
060371031023,414.5,226.3,162.9,430,242,188
060371032003,956.2,505.2,385.4,743,425,318
060371031012,385.8,191.5,171.9,419,227,192
060371032001,867.1,438.1,382.8,844,467,377
060371031011,661.2,347.5,273.9,763,412,351
060379800261,9.9,5.0,4.3,11,4,7
060371014002,668.4,379.3,243.0,677,404,273
060371014003,583.1,343.7,196.7,535,316,219
060371034001,432.1,251.1,154.0,373,220,153
060371014001,286.4,176.5,91.0,285,182,103
060371034002,403.0,231.9,146.4,378,225,153
060371011102,472.9,288.7,155.4,474,313,161
060371012102,786.5,506.1,227.3,605,418,187
060371012101,567.2,375.9,149.6,404,297,107
060371031022,250.9,152.5,86.3,240,137,103
060371031024,305.1,185.4,105.0,277,171,106
060371011221,896.8,466.6,377.0,994,577,417
060371031021,376.0,200.9,151.7,329,208,121
060371011101,623.6,373.2,205.1,641,431,210
060371011103,361.4,217.1,115.8,336,218,118
060371032002,639.1,382.3,225.8,809,435,374
060371012202,646.7,386.1,210.6,551,361,190
060371013002,485.4,253.6,204.6,578,298,280
060371013003,345.8,177.8,143.5,406,223,183
060371013001,542.4,284.0,217.3,542,329,213
060373004003,429.8,248.9,150.8,470,254,216
060373004005,318.9,181.1,119.1,326,167,159
060373004006,453.3,264.6,167.3,450,247,203
060373004004,347.4,204.6,123.1,336,226,110
060371012201,464.6,258.3,168.7,352,208,144
060371011222,687.8,365.7,276.5,660,383,277
060371013004,329.3,166.7,134.7,349,198,151
060373003015,353.1,209.7,125.1,320,179,141
060373003012,547.1,324.9,193.8,613,345,268
060373003013,378.7,213.5,146.5,419,214,205
060373007014,448.8,232.6,190.8,783,431,352
060373006005,591.9,347.8,200.6,480,300,180
060373004002,455.6,248.1,173.2,406,223,183
060373005013,549.5,338.1,172.4,518,328,190
060373006003,842.4,513.8,274.6,878,547,331
060373004001,497.0,296.7,164.5,433,247,186
060373003016,523.3,284.0,214.3,477,250,227
060373002005,704.1,434.8,232.0,663,406,257
060373002004,304.4,183.1,105.7,350,190,160
060373005012,248.2,149.4,82.5,243,165,78
060373002003,331.9,196.7,118.8,251,151,100
060373011005,447.8,287.7,139.0,503,363,140
060373011004,221.2,137.9,72.7,299,201,98
060373011006,659.0,406.9,219.3,553,403,150
060373011003,430.8,266.7,143.0,588,378,210
060373007022,1272.9,654.1,564.0,1340,733,607
060373022012,382.5,248.7,112.2,284,217,67
060373022011,258.9,170.0,75.9,210,172,38
060373020041,1130.8,798.3,276.0,1087,799,288
060373021031,351.2,230.1,102.6,322,240,82
060373019002,578.9,388.1,163.0,547,394,153
060373020031,836.7,543.0,235.0,802,613,189
060373010004,463.5,280.2,161.4,495,321,174
060373019001,837.9,543.1,249.1,682,451,231
060373019003,390.6,254.4,115.4,481,323,158
060373010002,603.4,372.9,196.9,601,349,252
060373010001,463.7,306.5,129.6,458,272,186
060373021042,372.0,260.3,95.1,291,215,76
060373021041,198.4,144.6,44.0,212,165,47
060373021043,517.0,376.6,114.7,417,297,120
060373010003,508.4,326.4,151.2,340,209,131
060373011002,422.3,273.1,130.7,409,258,151
060373011001,358.0,231.4,110.8,434,275,159
060373007013,593.9,337.8,230.9,545,316,229
060373007012,518.5,315.6,176.0,432,272,160
060373007011,386.2,235.2,132.4,384,244,140
060371222002,586.2,462.6,90.2,451,367,84
060371021042,526.2,282.2,219.3,453,256,197
060371021051,305.3,218.5,66.6,315,238,77
060371021052,274.2,196.2,59.8,252,176,76
060371021031,695.7,365.1,287.1,695,401,294
060371021041,948.8,595.8,296.7,1068,684,384
060373101002,645.4,330.6,283.8,725,372,353
060373101003,676.9,365.4,277.4,699,373,326
060371033002,1023.6,471.5,488.7,974,454,520
060371021071,977.6,455.0,463.9,1039,532,507
060379800211,9.7,6.5,2.3,11,6,5
060371021072,452.7,195.5,232.4,528,226,302
060379800201,0.0,0.0,0.0,15,10,5
060371034005,923.7,512.0,355.1,973,552,421
060371034003,362.7,202.7,138.4,359,198,161
060371034004,425.6,241.8,157.8,406,233,173
060379302001,121.8,62.6,43.8,105,63,42
060371041243,245.1,128.3,86.8,226,133,93
060371041242,700.2,510.6,153.1,735,532,203
060371920011,426.9,356.1,49.4,384,321,63
060377001021,618.2,496.6,86.2,516,381,135
060377001022,559.3,456.6,71.2,503,383,120
060377001015,449.3,359.4,71.9,384,311,73
060377001014,841.2,641.1,164.7,602,444,158
060377001013,488.7,384.6,78.6,528,426,102
060371919021,752.3,568.2,138.0,772,610,162
060371920012,807.9,624.0,135.6,665,496,169
060371919022,674.2,556.1,82.9,752,592,160
060377001011,431.9,349.5,57.7,381,315,66
060371899052,582.2,443.5,97.0,616,486,130
060371899021,895.4,711.8,135.2,685,480,205
060371899023,574.6,481.9,65.0,550,495,55
060371899031,961.2,748.5,151.8,875,707,168
060371899051,610.1,472.0,91.5,399,328,71
060371899022,864.6,694.9,118.9,861,708,153
060371899041,973.0,765.0,154.0,857,689,168
060371901001,554.5,459.6,60.4,566,491,75
060371901002,664.6,528.5,89.0,630,530,100
060371918201,449.6,375.9,50.3,313,263,50
060371919011,689.9,572.8,72.4,580,499,81
060371919012,738.0,604.0,77.0,576,492,84
060371908021,510.6,421.4,56.9,407,322,85
060371908022,257.4,213.3,26.6,227,193,34
060371907003,490.7,408.5,47.9,492,427,65
060371923003,805.2,683.5,90.1,680,549,131
060371918202,399.6,339.3,35.6,266,234,32
060371918203,274.2,232.8,24.4,238,213,25
060371908023,233.8,193.6,27.3,207,174,33
060371918103,327.9,292.0,16.3,272,234,38
060371901003,399.4,320.5,61.0,481,405,76
060371907002,206.7,179.0,15.5,242,206,36
060371907001,632.9,513.2,84.5,411,357,54
060371902022,795.8,653.5,83.8,851,729,122
060371902021,338.9,280.5,36.8,334,280,54
060373021021,589.6,405.5,159.2,586,437,149
060373017011,511.2,336.7,147.0,505,336,169
060373017012,623.2,389.2,196.8,607,393,214
060373016012,348.4,233.2,96.6,382,268,114
060373016022,317.7,236.2,66.0,290,208,82
060373016013,411.9,285.1,106.0,358,278,80
060373016021,795.5,573.3,165.1,652,463,189
060373015021,571.9,345.4,189.6,429,315,114
060373015011,244.2,152.2,76.4,341,234,107
060373012052,147.4,87.5,50.4,198,117,81
060373012051,374.0,213.6,134.8,468,279,189
060373012063,409.8,255.6,129.6,401,249,152
060373017023,294.9,188.9,95.4,252,172,80
060373017024,265.6,169.2,86.3,246,174,72
060373017022,449.3,283.4,147.1,429,320,109
060373017021,433.2,267.5,144.2,427,318,109
060373023012,663.2,447.2,174.3,462,345,117
060373023011,487.2,332.6,126.5,399,269,130
060373018013,387.2,258.1,108.8,364,250,114
060373018012,689.4,459.6,190.5,598,415,183
060373018011,259.8,171.5,74.4,177,120,57
060373018022,516.8,341.4,147.5,399,300,99
060373012062,432.2,274.6,132.1,416,287,129
060373012061,479.7,303.2,146.0,476,362,114
060373013001,350.3,199.8,129.4,503,300,203
060373012053,347.0,193.3,129.2,343,214,129
060373013002,601.9,345.4,225.3,612,345,267
060373012064,310.7,196.3,94.5,364,271,93
060373012041,517.4,349.8,134.4,475,358,117
060373012043,477.1,321.5,121.7,402,302,100
060373012032,885.0,519.4,308.6,880,601,279
060373015012,376.4,211.6,141.9,369,251,118
060373014003,265.6,146.0,103.4,304,199,105
060373014002,609.6,334.0,242.6,585,390,195
060373014004,452.0,225.4,198.8,433,254,179
060373014001,456.0,242.0,188.6,478,282,196
060373101004,680.2,324.0,320.3,793,453,340
060373018021,615.6,411.7,163.8,471,332,139
060373020022,639.4,391.7,205.0,631,471,160
060373019004,786.2,506.8,232.5,723,503,220
060373022013,479.9,307.4,141.1,315,242,73
060373020021,266.4,166.4,82.2,264,194,70
060373020023,225.5,136.6,73.5,205,148,57
060373012042,432.3,293.6,115.0,377,284,93
060373012031,714.1,445.9,230.2,650,438,212
060371216001,633.4,435.9,165.9,613,431,182
060371220003,381.6,282.9,79.6,345,244,101
060371220001,640.8,438.6,169.0,262,194,68
060371216002,301.0,207.3,79.6,293,191,102
060371190011,693.0,520.9,137.7,111,76,35
060371190012,280.5,220.4,48.3,195,147,48
060371190013,454.7,357.2,78.3,4,3,1
060371190023,293.0,238.3,40.0,166,125,41
060371210103,318.4,225.1,78.1,2,2,0
060371210201,217.7,153.9,53.4,151,107,44
060371210101,288.5,217.0,57.4,97,73,24
060371210102,456.9,349.2,83.8,178,135,43
060371210203,266.8,197.8,57.2,181,136,45
060371210202,461.1,348.3,92.9,413,279,134
060371218011,634.0,502.0,92.0,350,275,75
060371218012,260.2,211.1,37.3,233,190,43
060371218023,269.8,218.9,38.7,173,139,34
060371218022,357.7,278.3,61.5,330,253,77
060371218021,309.7,253.4,41.4,250,199,51
060371212211,215.8,180.4,25.2,175,136,39
060371212212,488.9,398.6,65.0,3,3,0
060371210104,456.4,353.9,75.1,3,2,1
060371212102,300.1,231.7,55.8,105,85,20
060371212101,527.3,418.9,79.2,27,21,6
060371211021,302.6,167.0,118.0,237,150,87
060371212221,580.9,478.5,64.2,296,232,64
060371212223,370.6,306.2,48.3,3,2,1
060371048212,362.0,313.8,26.6,136,116,20
060371048211,524.4,419.0,72.1,406,325,81
060371046202,473.5,423.5,32.7,461,400,61
060371046102,295.1,252.9,26.9,211,179,32
060371046201,308.8,264.6,28.1,257,221,36
060371048102,392.2,320.4,57.2,129,105,24
060371048101,266.0,226.2,29.4,51,45,6
060371048103,740.7,625.4,86.5,90,75,15
060371046101,467.6,424.9,28.3,316,270,46
060371043202,215.5,192.0,13.1,223,198,25
060371043201,529.7,467.1,36.8,507,451,56
060371043203,209.2,185.3,13.2,194,182,12
060371047013,143.3,126.9,9.0,95,89,6
060371047012,267.3,236.8,16.8,182,160,22
060371047011,232.6,197.8,20.8,236,207,29
060371047041,943.7,804.2,84.9,541,474,67
060371041081,463.9,416.8,29.3,334,307,27
060371041052,999.4,834.1,105.9,703,630,73
060371047032,253.2,212.8,25.6,0,0,0
060371047031,231.9,194.9,23.4,5,4,1
060371041083,350.6,309.4,26.6,254,228,26
060371041082,601.2,515.0,57.8,403,341,62
060371219002,456.4,375.0,52.3,487,398,89
060371219003,247.9,203.7,28.4,183,142,41
060371221211,383.7,314.6,48.7,323,261,62
060371212222,203.0,167.7,26.5,134,109,25
060371211011,353.4,269.3,68.6,283,210,73
060371221223,187.0,154.3,20.5,163,138,25
060371211023,342.8,261.3,66.5,305,230,75
060371211012,380.2,278.5,76.8,314,240,74
060371221212,356.4,287.3,54.4,268,214,54
060371222003,205.6,172.3,22.0,158,129,29
060371221221,104.9,86.5,11.5,49,45,4
060371221222,190.4,157.1,20.9,178,141,37
060371222001,307.4,259.0,32.5,231,177,54
060371033001,1019.1,448.6,495.3,912,388,524
060371211022,266.3,125.7,123.7,276,116,160
060373201004,484.8,404.3,51.5,323,256,67
060371061122,1268.9,893.4,299.8,1171,748,423
060371061142,330.1,276.6,32.4,222,177,45
060371042011,323.4,290.6,18.7,276,258,18
060371042012,474.9,428.2,26.2,333,312,21
060371042013,431.8,389.0,24.1,305,289,16
060371042031,512.8,447.4,39.1,320,282,38
060371042032,507.9,445.2,36.6,484,440,44
060371042041,399.1,353.4,25.2,234,208,26
060371042042,384.4,313.2,50.6,293,246,47
060371061132,571.3,404.8,129.9,574,400,174
060371041051,402.9,329.1,50.3,290,230,60
060371041031,656.7,542.0,81.1,503,426,77
060371061121,794.0,585.0,163.0,640,458,182
060371061111,643.4,447.5,164.8,724,491,233
060371061112,1235.7,838.1,331.4,978,656,322
060371041032,758.9,636.8,84.3,593,520,73
060371041241,579.7,445.5,102.1,531,434,97
060371438002,683.3,503.2,153.1,101,72,29
060371436031,1095.0,856.3,169.1,479,391,88
060371436041,505.3,397.3,77.5,331,250,81
060371436021,519.6,411.0,86.0,146,108,38
060371436022,1047.6,818.1,191.1,743,552,191
060371941023,378.3,323.2,40.6,316,260,56
060371438001,543.7,449.0,65.2,344,273,71
060371432001,718.6,556.3,116.3,157,121,36
060371432003,689.1,548.2,103.6,58,45,13
060371435003,861.9,684.2,136.7,738,587,151
060371434003,444.1,347.7,72.7,438,348,90
060371435004,570.3,454.9,89.0,482,378,104
060371434004,798.6,639.1,122.5,718,554,164
060371247004,609.2,477.8,104.1,633,475,158
060371247003,1001.4,809.2,139.9,603,473,130
060371247002,572.5,431.1,119.6,592,448,144
060371435002,669.8,531.5,104.2,663,544,119
060371434002,1120.5,921.0,156.4,1043,802,241
060371247001,508.9,379.9,110.4,534,357,177
060371245001,599.0,436.5,131.8,563,408,155
060371249031,965.3,691.7,216.0,857,654,203
060371240001,371.2,255.7,96.2,467,252,215
060371244003,678.0,403.0,247.0,677,417,260
060371435001,648.9,513.7,100.2,557,461,96
060371434001,1046.2,843.5,158.1,877,710,167
060371436023,830.0,687.0,114.0,231,187,44
060371433001,378.3,300.9,60.1,78,51,27
060371251004,387.1,304.1,62.4,1,0,1
060371240002,598.0,460.6,108.9,567,437,130
060371433002,882.9,689.4,149.4,228,177,51
060371240003,702.5,531.2,138.2,636,485,151
060371240004,715.6,526.1,159.4,647,440,207
060371249032,559.5,421.6,98.8,444,353,91
060371244002,547.6,345.0,165.6,545,377,168
060371238002,851.7,609.3,192.6,766,572,194
060371238003,738.5,520.7,173.3,608,443,165
060371249021,1230.3,959.5,199.3,1034,790,244
060371251002,1403.6,1097.4,213.1,520,409,111
060371251003,397.1,311.7,62.8,120,93,27
060371251001,639.0,477.6,132.5,183,150,33
060371239022,868.9,665.8,153.8,98,73,25
060371252001,588.5,473.9,79.9,295,244,51
060371244001,402.5,304.9,77.0,426,310,116
060371237003,433.8,322.1,87.3,336,246,90
060371237004,375.7,270.5,87.4,367,259,108
060371237002,276.2,180.5,82.5,331,237,94
060373113002,855.0,551.0,242.0,755,447,308
060373113003,789.0,567.0,180.0,737,472,265
060373116005,428.9,292.6,111.6,395,274,121
060373116004,701.4,487.8,174.5,634,441,193
060373117006,467.6,312.8,129.9,512,342,170
060373115001,995.7,690.3,251.4,879,579,300
060373115003,1021.0,714.7,253.3,957,661,296
060373108005,684.5,448.5,206.3,659,425,234
060373115002,1021.0,748.0,224.0,933,678,255
060373117002,458.8,309.4,122.5,472,311,161
060373117003,412.2,280.4,106.0,336,221,115
060373109005,552.9,360.8,158.1,525,316,209
060373109006,565.6,358.0,170.3,520,320,200
060373108004,507.0,341.1,140.0,542,338,204
060373111002,778.2,525.8,203.0,701,484,217
060373111001,711.8,471.2,201.0,707,456,251
060373111003,465.4,346.8,91.8,389,279,110
060373112002,615.9,419.2,149.5,524,380,144
060373112001,505.6,327.0,134.8,509,335,174
060373113001,380.7,234.3,113.5,336,208,128
060373110002,387.3,240.2,114.9,370,237,133
060373110003,742.5,483.0,213.1,664,433,231
060373110001,305.0,197.2,88.1,316,197,119
060373110004,369.4,240.3,106.1,335,200,135
060373105012,691.9,532.9,122.9,449,338,111
060373105013,292.2,222.8,52.7,193,152,41
060373105011,249.9,187.4,46.3,198,143,55
060373109004,603.0,399.1,170.3,580,368,212
060373109002,783.9,488.7,242.6,691,429,262
060373109003,380.4,249.1,109.9,367,231,136
060373104003,674.0,416.8,212.7,583,388,195
060373104002,574.3,332.9,200.0,550,313,237
060373106013,413.6,302.3,84.1,416,293,123
060373106011,466.3,345.5,89.8,459,329,130
060373117004,532.8,363.4,138.3,365,244,121
060373117005,391.0,261.8,105.6,464,280,184
060373117001,918.8,603.6,257.8,731,479,252
060373108003,570.4,405.1,127.6,503,346,157
060373118012,697.2,493.8,155.2,643,457,186
060373118021,651.7,486.0,121.2,578,418,160
060373016023,398.8,296.5,82.9,381,280,101
060371911202,404.8,321.1,64.4,293,241,52
060371916201,630.4,518.0,76.9,599,469,130
060371911201,573.1,451.2,88.6,467,367,100
060371915003,521.4,415.7,77.7,273,211,62
060371926103,526.3,440.9,49.2,356,304,52
060371912041,599.4,470.0,91.2,433,345,88
060371915001,286.9,223.3,48.9,312,208,104
060371915002,417.1,324.7,71.1,287,190,97
060371912032,268.5,205.1,45.4,243,188,55
060371912031,459.5,350.9,77.6,311,240,71
060371911101,613.3,457.3,119.3,403,336,67
060371911102,188.7,140.7,36.7,141,117,24
060371905202,601.0,436.1,119.3,385,297,88
060371905201,374.2,261.0,84.1,221,179,42
060371904021,968.0,775.0,139.0,740,649,91
060371892023,667.3,561.1,76.2,608,517,91
060371893002,654.1,494.1,132.2,634,448,186
060371893003,399.6,340.4,44.6,376,307,69
060371892022,359.7,302.4,41.0,289,228,61
060371904011,894.6,733.1,115.7,679,605,74
060371904012,407.4,335.3,48.5,319,281,38
060371912012,944.7,513.1,351.4,649,443,206
060371892011,811.3,678.3,90.3,644,550,94
060371894002,497.2,431.8,42.2,449,416,33
060371894003,814.9,707.5,80.3,799,696,103
060371894001,869.4,743.5,95.4,893,748,145
060371893001,717.0,619.6,77.6,731,594,137
060371256003,473.1,327.9,120.8,468,311,157
060371255022,611.1,461.1,115.4,231,179,52
060371256002,516.0,356.2,133.8,510,341,169
060373116001,647.9,459.1,152.0,651,448,203
060373116003,389.1,275.7,91.3,298,211,87
060373116002,1496.7,1136.0,287.5,1169,831,338
060373114001,499.7,359.0,106.8,586,404,182
060373114002,733.0,480.0,218.0,708,483,225
060373112003,532.1,359.5,127.1,430,282,148
060371277122,532.5,396.6,98.2,301,225,76
060371277121,356.5,265.4,65.8,256,189,67
060371273002,546.3,423.0,98.4,539,411,128
060371278052,276.3,216.0,43.3,298,227,71
060371278041,1090.7,800.9,198.9,950,731,219
060371278051,277.1,216.7,43.4,153,129,24
060371272103,746.3,574.1,132.4,658,492,166
060371272102,941.7,738.0,151.8,317,258,59
060371412021,326.8,252.7,60.0,398,295,103
060371412022,750.1,574.5,138.7,522,408,114
060371413042,543.6,416.7,98.0,449,321,128
060371412023,453.9,350.9,85.0,449,349,100
060371412013,412.1,321.2,68.9,404,317,87
060371412012,633.8,503.7,91.0,526,412,114
060371287023,774.5,595.8,144.8,864,651,213
060371287022,698.3,533.6,134.4,714,530,184
060371287024,517.5,400.1,90.6,469,380,89
060371288023,604.1,476.5,91.1,558,469,89
060371285002,1287.9,971.7,240.1,1200,931,269
060371289102,656.5,490.6,141.5,530,397,133
060371284001,438.4,334.7,80.4,423,339,84
060371284002,428.6,327.3,78.6,432,323,109
060371285001,824.9,639.9,137.5,598,472,126
060371286012,523.0,402.9,92.2,422,330,92
060371286023,706.5,534.7,140.2,701,523,178
060371412011,854.3,695.2,97.6,731,592,139
060371411022,999.5,758.9,200.6,1008,779,229
060371411021,435.1,326.1,90.1,403,304,99
060371411012,1388.7,1059.7,244.0,1195,947,248
060371411011,769.0,593.0,146.0,743,572,171
060371246003,684.8,516.8,133.8,542,399,143
060371287021,698.4,535.0,135.3,583,441,142
060371286022,419.5,326.0,71.7,417,335,82
060371246001,436.5,337.8,80.5,469,368,101
060371246002,593.5,459.2,109.5,501,381,120
060371245002,630.0,486.0,107.0,656,529,127
060371283022,311.4,256.9,39.7,227,188,39
060371283032,361.2,298.0,46.1,222,188,34
060371283031,173.5,143.1,22.1,147,120,27
060371278061,318.9,256.4,45.2,213,175,38
060371278053,242.7,195.1,34.4,230,180,50
060371281021,692.6,553.3,92.5,558,433,125
060371282102,400.0,336.3,44.7,237,202,35
060371282101,530.0,445.7,59.3,381,318,63
060371281022,412.8,329.0,53.9,219,178,41
060371237001,201.5,143.4,49.6,211,163,48
060371234202,242.2,172.4,59.6,234,158,76
060371234203,246.2,175.2,60.6,181,141,40
060371238001,447.7,328.5,94.1,438,330,108
060371233043,379.6,274.1,84.5,333,241,92
060371233031,254.5,183.7,56.6,209,148,61
060371233042,253.2,182.8,56.3,186,138,48
060371234101,594.5,462.0,102.0,443,344,99
060371234102,262.5,204.0,45.0,277,214,63
060371220002,568.9,387.7,160.4,608,422,186
060371234201,528.8,428.0,75.0,370,297,73
060371233032,509.7,400.5,83.5,440,345,95
060371233041,574.6,430.5,113.7,417,317,100
060371239012,291.6,215.7,59.8,1,1,0
060371239021,269.1,203.0,50.2,67,52,15
060371239013,321.8,251.1,52.4,102,80,22
060371239011,740.3,584.9,113.2,272,216,56
060371232042,177.3,139.6,27.9,153,126,27
060371232033,208.4,164.1,32.8,224,189,35
060371233011,414.1,335.2,61.8,302,253,49
060371233013,217.1,175.7,32.4,182,151,31
060371233012,746.6,540.1,171.6,688,440,248
060371224102,181.4,150.1,23.5,99,84,15
060371224101,473.6,391.9,61.5,332,274,58
060371433003,653.9,513.8,115.0,54,38,16
060371433005,756.9,601.7,120.7,189,151,38
060371433004,568.4,439.5,94.4,241,190,51
060371252003,540.7,428.4,84.3,4,3,1
060371254022,441.0,338.9,73.2,85,63,22
060371254021,807.3,635.7,117.8,366,301,65
060371254023,880.5,717.0,103.6,331,276,55
060371254011,988.1,801.3,113.2,118,97,21
060371252002,616.7,497.5,91.3,148,114,34
060371241023,434.1,344.9,60.6,283,223,60
060371242041,429.3,341.6,55.7,125,98,27
060371242042,349.7,278.4,45.3,69,57,12
060371432002,522.1,402.3,86.3,124,97,27
060371255021,1108.3,870.9,162.3,320,254,66
060374811034,132.3,99.3,24.9,150,109,41
060374811032,219.5,164.7,41.4,249,186,63
060374811031,375.0,281.3,70.7,291,226,65
060374322011,379.2,265.1,95.8,443,284,159
060374322023,446.7,332.8,95.0,459,302,157
060374801022,440.3,290.9,125.0,381,252,129
060374812021,718.8,479.2,200.3,615,373,242
060374812022,476.9,316.7,134.2,522,324,198
060374812023,353.7,234.7,99.8,344,217,127
060374801021,434.5,273.7,135.8,448,252,196
060374801023,587.1,379.3,175.1,591,318,273
060374322022,219.9,164.3,46.4,253,170,83
060374322021,429.0,303.0,109.0,451,303,148
060374812012,396.7,243.6,139.2,221,139,82
060374812013,326.9,200.8,103.2,208,131,77
060374801012,219.5,135.7,68.9,200,112,88
060374801013,468.1,273.9,167.2,496,300,196
060374800123,479.2,281.6,169.8,502,276,226
060374812011,258.5,157.7,82.7,3,2,1
060374320006,510.9,287.6,190.6,521,303,218
060374321023,347.1,195.4,129.4,409,220,189
060374801011,500.8,279.4,184.5,357,214,143
060374642003,405.0,231.5,152.4,434,232,202
060374642004,417.5,238.7,157.1,457,247,210
060374800021,402.7,238.9,145.1,400,217,183
060374800022,511.9,296.0,188.2,570,292,278
060374800112,674.9,419.1,221.7,724,429,295
060374631022,520.3,318.7,181.3,592,258,334
060374632002,725.5,509.7,174.2,784,511,273
060374632003,329.1,245.2,62.7,277,201,76
060374632001,540.5,374.8,135.5,614,392,222
060374800124,282.7,166.1,100.2,175,89,86
060374318003,561.4,312.7,223.6,599,295,304
060374800122,332.6,185.3,132.4,151,90,61
060374800111,561.7,364.1,156.3,169,105,64
060374800121,347.7,214.5,111.8,99,61,38
060374318002,657.5,388.5,234.9,631,326,305
060374307241,591.3,376.2,175.8,580,349,231
060374631023,445.5,310.3,110.9,516,305,211
060374631011,279.6,182.2,76.0,312,211,101
060374609001,543.1,456.9,60.3,497,446,51
060374620022,173.2,148.2,17.1,165,149,16
060374620021,572.2,493.2,53.4,333,295,38
060374620011,560.2,494.2,41.6,601,539,62
060374620012,432.1,372.3,39.0,363,311,52
060374615023,357.1,307.0,29.1,265,230,35
060374615022,888.6,768.3,77.1,634,559,75
060374615024,186.0,160.6,14.8,187,161,26
060374622012,380.6,310.5,46.7,393,303,90
060374622013,417.4,340.5,51.3,404,344,60
060374622022,496.2,390.1,71.8,535,391,144
060374622021,443.8,348.9,64.2,496,348,148
060374621002,882.0,743.3,93.6,597,532,65
060374622011,466.3,384.0,57.4,507,342,165
060374621001,422.4,349.8,47.4,466,386,80
060374623011,634.9,508.4,80.8,553,446,107
060374623012,363.0,291.3,44.6,301,244,57
060374623013,273.0,210.7,44.1,160,128,32
060374621003,667.3,555.9,71.6,675,602,73
060374615012,552.8,463.9,55.8,371,320,51
060374615013,700.8,592.4,67.8,700,576,124
060374615011,455.3,389.3,42.5,505,428,77
060374615021,470.1,407.6,38.0,397,356,41
060374610001,403.3,346.3,30.2,338,304,34
060374603024,420.8,366.9,30.1,427,383,44
060374611003,417.2,345.9,50.2,489,421,68
060374611004,491.4,407.4,60.4,347,304,43
060374611002,834.6,658.8,130.4,744,636,108
060374603023,606.7,541.2,40.1,578,524,54
060374603012,521.1,451.8,44.4,567,513,54
060374603013,447.1,387.6,38.1,444,399,45
060374603011,595.5,502.1,60.4,617,546,71
060374611001,507.7,411.6,69.7,472,400,72
060374602004,486.7,398.9,61.9,458,404,54
060374602005,847.1,704.5,98.6,932,828,104
060374602002,545.6,475.2,42.9,506,436,70
060374602003,718.4,578.8,95.8,725,599,126
060374623022,314.6,240.3,46.2,247,198,49
060374623021,469.6,358.7,68.9,363,284,79
060374623023,411.8,318.0,60.8,381,292,89
060374624003,387.8,306.8,57.4,375,292,83
060374623014,426.8,338.3,61.3,391,299,92
060374624004,497.0,392.6,74.6,426,338,88
060374627004,408.6,318.2,60.6,354,276,78
060374627003,576.9,440.9,98.7,197,145,52
060590863012,651.8,433.5,184.6,550,312,238
060590863051,702.5,396.4,266.0,760,359,401
060590863043,669.7,384.4,248.1,591,342,249
060590863011,829.0,618.0,160.0,605,434,171
060590864054,434.4,320.8,89.4,260,168,92
060590864053,551.6,407.2,113.6,412,284,128
060590864052,325.2,249.4,55.0,197,144,53
060590864051,301.8,231.6,51.0,270,187,83
060590864023,491.2,302.7,169.0,496,273,223
060590864062,402.6,244.7,139.7,295,156,139
060590864022,380.3,238.6,129.3,337,185,152
060590863061,366.9,210.9,131.6,417,204,213
060590863063,502.4,266.1,205.2,585,240,345
060590863062,436.0,250.6,156.3,223,143,80
060590863053,543.8,300.9,215.1,437,191,246
060590863052,424.7,198.0,203.1,531,237,294
060590863041,683.1,318.5,326.8,593,303,290
060590863042,244.0,142.3,88.8,271,137,134
060590864064,323.2,191.3,109.2,313,170,143
060590864063,315.1,186.5,106.9,267,141,126
060590864071,643.6,381.3,224.8,785,411,374
060590864072,636.6,377.6,222.4,630,343,287
060590864043,358.8,252.0,88.9,306,177,129
060590115021,302.4,176.1,108.3,233,124,109
060590864061,197.9,125.4,60.2,143,75,68
060590864021,717.4,454.5,218.3,620,368,252
060590115022,492.0,290.0,164.0,461,266,195
060590115023,665.0,385.0,231.0,649,356,293
060590115042,468.0,295.8,137.9,241,185,56
060590115045,475.7,300.6,140.2,261,184,77
060590115032,239.9,151.6,70.7,377,164,213
060590016023,616.6,228.1,353.6,584,198,386
060590115031,483.4,205.3,249.0,517,241,276
060590117201,367.7,282.2,64.2,124,88,36
060590117203,138.3,106.7,23.7,136,111,25
060590117202,352.9,269.1,63.1,318,241,77
060590117141,257.2,162.2,81.3,51,30,21
060590117222,447.9,182.2,247.1,446,190,256
060590115044,351.1,225.0,86.0,368,235,133
060590115041,308.9,192.2,80.8,324,200,124
060590117213,403.7,270.0,101.8,502,275,227
060590117212,411.2,275.0,103.7,239,173,66
060590117211,264.5,176.9,66.7,200,151,49
060590117221,383.8,200.8,162.2,366,177,189
060590117161,670.1,328.5,309.0,533,239,294
060590117121,426.8,276.9,130.3,446,239,207
060590117123,606.3,380.1,190.8,635,370,265
060590117162,1526.9,754.5,700.0,1540,684,856
060590762014,456.3,200.3,231.5,475,168,307
060590762013,670.1,294.2,340.0,584,249,335
060590762015,913.0,504.7,354.3,559,303,256
060590762083,698.0,322.8,333.7,807,325,482
060710021091,1107.0,749.6,282.6,1080,797,283
060710021092,256.0,173.4,65.4,0,0,0
060650479002,905.2,371.2,492.7,802,325,477
060650418102,779.2,310.9,433.8,724,344,380
060650479004,870.3,341.2,494.7,754,330,424
060650479001,837.5,325.5,480.2,770,294,476
060650479003,991.1,405.5,544.6,834,372,462
060650479005,1306.0,558.0,673.0,1165,572,593
060650418101,848.0,362.0,445.0,722,349,373
060650419092,397.8,177.2,201.0,436,154,282
060650418103,881.5,390.1,450.9,840,392,448
060650418121,637.9,277.3,313.5,684,285,399
060650418122,689.0,294.8,348.8,643,260,383
060650418131,598.1,315.3,254.7,473,267,206
060650418132,762.7,407.5,316.8,817,395,422
060650416002,365.1,246.0,95.1,266,189,77
060650416003,141.5,98.3,32.6,109,82,27
060650416004,252.6,175.4,58.1,221,148,73
060650416001,255.1,177.1,58.7,196,150,46
060650415002,233.7,166.6,52.8,190,139,51
060650418093,896.3,449.1,400.8,885,428,457
060650418091,343.0,167.0,159.3,406,209,197
060650418133,486.6,313.0,145.2,331,212,119
060650418092,567.6,300.9,233.9,453,250,203
060650414101,291.6,195.9,79.2,150,121,29
060650419091,530.5,243.0,264.4,405,219,186
060650414111,334.1,252.0,65.6,399,269,130
060650414102,295.9,216.2,64.4,146,113,33
060650414112,349.8,271.9,61.2,274,199,75
060650408091,562.5,313.7,216.5,483,281,202
060650408092,546.0,302.0,212.9,396,228,168
060650482002,610.4,348.4,226.3,616,356,260
060650482001,1002.9,556.9,388.3,788,435,353
060650408212,817.3,471.8,297.9,804,443,361
060650408121,1375.2,442.5,849.8,1207,481,726
060650408132,1283.3,413.8,802.9,887,342,545
060650407013,385.4,104.6,266.9,274,97,177
060650407012,521.4,141.4,361.1,308,120,188
060650407011,201.8,56.2,138.5,428,108,320
060650408211,740.7,432.7,264.2,532,350,182
060590758111,864.9,340.2,474.8,850,315,535
060590758133,938.8,369.2,520.2,1092,422,670
060590758093,583.9,179.6,371.7,648,196,452
060590758132,384.3,195.4,167.7,192,118,74
060590219152,1212.4,494.8,655.9,1276,439,837
060590762021,441.0,254.0,159.0,343,177,166
060590864073,563.2,333.1,196.5,419,250,169
060590219032,607.3,281.5,290.9,641,244,397
060590219033,583.6,293.4,253.7,499,240,259
060590218131,14.1,7.6,6.1,14,7,7
060590219162,1012.5,354.1,604.8,1082,383,699
060590219031,678.1,259.1,378.4,603,226,377
060590758091,563.6,166.9,363.0,651,153,498
060590758142,521.8,167.8,330.6,507,143,364
060590758092,693.8,218.1,436.8,671,161,510
060590758141,1200.0,508.0,635.0,1230,462,768
060590219151,958.7,368.4,544.6,1001,388,613
060590218212,960.7,511.3,375.6,748,446,302
060590218213,624.6,337.2,253.3,485,210,275
060590218201,768.0,229.0,501.0,759,230,529
060590218122,979.8,440.2,475.2,1156,489,667
060590218071,794.2,356.8,385.2,619,268,351
060590218123,549.8,247.0,266.6,615,281,334
060590218124,698.0,313.6,338.5,527,274,253
060590218121,502.1,137.2,337.4,531,134,397
060590218022,733.7,245.3,450.1,757,233,524
060590218024,653.2,204.8,419.3,512,178,334
060590219121,868.2,322.9,508.3,1002,336,666
060590219161,1075.3,417.2,611.1,986,403,583
060590219204,1850.1,846.8,909.2,1637,729,908
060590219051,873.1,360.0,478.5,970,407,563
060590219191,772.5,340.3,392.9,1017,411,606
060590219192,739.5,325.7,376.1,476,192,284
060590219052,1118.1,448.7,614.6,1081,443,638
060590218163,938.0,356.4,541.1,912,341,571
060590885013,397.8,296.0,83.2,497,285,212
060590885012,376.2,280.0,78.8,233,143,90
060590885011,994.0,571.0,347.0,1069,509,560
060590885022,452.0,290.0,140.0,389,193,196
060590884022,553.4,363.7,159.5,463,283,180
060590885023,261.9,186.5,63.6,120,74,46
060590891062,313.7,238.7,59.5,163,89,74
060590891023,479.9,365.2,91.0,410,271,139
060590891021,697.6,502.5,162.6,665,396,269
060590891042,539.3,395.0,119.8,411,231,180
060590891051,303.3,208.9,79.4,177,116,61
060590891071,925.0,611.6,266.1,1056,574,482
060590891022,411.4,283.4,107.7,423,244,179
060590891041,229.2,157.9,60.0,204,135,69
060590891043,284.0,195.6,74.4,198,107,91
060590753021,674.0,448.0,189.6,497,325,172
060590891061,549.0,390.0,145.0,439,237,202
060590885021,920.0,621.0,260.0,697,348,349
060590891072,713.0,485.0,193.0,633,389,244
060590761033,805.6,540.3,221.4,799,439,360
060590884012,902.0,557.0,304.0,906,418,488
060590884013,437.9,267.2,148.8,393,203,190
060590884011,562.2,344.2,190.1,537,297,240
060590875032,803.0,453.6,300.1,817,406,411
060590884021,624.5,374.8,210.9,622,362,260
060590875051,540.1,339.4,166.4,629,347,282
060590875052,337.8,212.3,104.1,209,158,51
060590875053,409.7,257.5,126.2,196,110,86
060590875033,207.7,123.4,72.0,257,158,99
060599800001,4.8,3.3,1.2,22,12,10
060590884032,896.0,624.3,219.3,730,481,249
060590884031,965.7,659.9,234.0,999,601,398
060590875034,258.8,193.4,46.3,176,124,52
060590875031,201.1,151.0,35.2,85,65,20
060590761034,383.6,261.3,98.7,248,142,106
060590761031,182.0,120.4,49.1,344,203,141
060590761032,416.6,283.8,107.2,379,234,145
060590875044,403.2,278.1,105.5,363,222,141
060590875042,431.6,321.5,83.8,250,172,78
060590875043,187.0,149.6,23.7,63,43,20
060590875041,125.4,100.3,15.9,173,96,77
060590874032,278.3,212.4,49.7,138,99,39
060590874031,270.2,206.2,48.2,282,210,72
060590863031,598.5,394.2,163.4,95,64,31
060590761011,1448.1,955.2,391.0,545,327,218
060590740063,781.6,552.4,180.0,367,273,94
060590740062,425.4,300.6,98.0,478,308,170
060590741072,907.5,506.1,341.3,569,330,239
060590741111,354.4,216.1,117.0,447,217,230
060590740061,323.5,218.5,82.5,175,115,60
060590741112,385.8,281.4,82.0,343,246,97
060590740052,467.8,360.7,83.8,350,246,104
060590741113,806.6,594.4,166.3,929,606,323
060590740051,448.9,346.1,80.4,317,234,83
060590740053,429.0,298.2,102.6,206,118,88
060590762022,553.9,237.5,283.4,574,235,339
060590762011,570.6,296.8,238.7,616,272,344
060590762082,379.1,175.0,177.9,463,225,238
060590762081,706.3,326.2,331.4,743,309,434
060590762084,338.2,156.2,158.7,231,127,104
060590762023,909.2,381.4,476.5,736,304,432
060590762012,516.3,217.7,263.6,454,171,283
060590762024,569.0,231.9,302.4,535,228,307
060590117223,355.8,186.1,150.4,308,151,157
060590218211,930.0,459.3,410.5,792,366,426
060590016022,629.3,235.6,352.5,673,223,450
060590117081,598.8,351.2,186.8,534,328,206
060590016025,252.2,119.8,108.2,363,172,191
060590015053,1052.6,506.1,491.2,1098,470,628
060590015054,710.7,320.2,339.7,647,242,405
060590015051,423.2,209.4,181.9,553,232,321
060590015052,1139.8,487.7,567.7,1106,488,618
060590015042,662.9,332.8,276.7,521,253,268
060590015033,433.0,209.2,196.8,267,143,124
060590117073,452.5,255.0,160.6,285,176,109
060590117071,1502.6,666.8,738.4,1721,675,1046
060590117115,377.9,255.3,91.5,157,104,53
060590115043,254.8,154.7,70.1,206,133,73
060590117082,300.8,198.2,76.9,186,123,63
060590117114,310.7,209.0,75.2,303,205,98
060590117113,187.4,128.3,44.6,252,172,80
060590117083,663.8,284.9,337.4,750,336,414
060590117072,655.8,273.2,340.6,697,271,426
060590752022,538.7,450.9,60.5,537,447,90
060590752021,578.2,475.6,70.6,471,363,108
060590753022,913.9,607.4,257.1,708,492,216
060590753033,426.9,283.7,120.1,615,332,283
060590751003,580.8,415.4,131.4,455,294,161
060590761022,403.1,263.3,111.1,14,7,7
060590761023,639.3,451.1,161.5,554,296,258
060590761024,108.0,70.6,29.8,228,127,101
060590753011,440.9,313.2,95.3,388,257,131
060590753013,617.9,390.0,192.0,614,373,241
060590751004,411.8,298.0,86.7,442,296,146
060590751002,570.6,390.1,138.9,480,317,163
060590750041,541.7,376.5,131.2,154,122,32
060590753032,489.2,307.5,151.9,846,481,365
060590753031,296.6,186.4,92.1,132,97,35
060590750031,258.1,197.8,47.0,102,74,28
060590753012,530.6,320.8,181.7,600,318,282
060590760003,648.7,391.2,213.0,476,260,216
060590760002,1041.8,658.1,306.6,886,472,414
060590760004,718.3,434.0,228.5,629,347,282
060590760005,526.7,331.0,162.3,404,253,151
060590761021,265.8,186.1,63.2,326,195,131
060590863032,662.2,361.3,271.5,676,354,322
060590761014,458.9,267.0,158.9,491,282,209
060590761012,519.0,302.0,179.7,546,312,234
060590761013,448.4,260.9,155.3,241,151,90
060590750042,259.9,218.2,24.2,176,138,38
060590744053,137.7,115.7,12.9,83,69,14
060590744061,215.9,158.1,44.9,80,74,6
060590754012,657.5,428.2,188.7,786,463,323
060590754011,802.1,450.2,294.6,988,523,465
060590744052,579.4,424.4,120.5,336,265,71
060590744051,375.8,275.2,78.2,112,93,19
060590754034,392.9,287.8,81.7,523,348,175
060590750022,531.6,389.3,110.6,315,262,53
060590744062,233.6,171.1,48.6,249,198,51
060590754032,301.4,220.8,62.7,262,169,93
060590744063,376.1,275.5,78.2,217,174,43
060590754043,361.9,265.0,75.3,410,261,149
060590750023,540.7,396.1,112.5,132,118,14
060590754033,990.9,593.6,330.7,758,485,273
060590754044,467.7,284.6,151.1,340,203,137
060590759024,482.7,274.1,167.7,417,220,197
060590759022,812.0,461.0,290.9,713,398,315
060590754031,532.5,318.5,178.6,577,324,253
060590754052,494.8,295.9,165.9,471,246,225
060590757013,492.3,295.0,166.6,362,202,160
060590755052,791.2,432.5,300.8,795,401,394
060590754051,610.9,365.4,204.9,658,343,315
060590755041,1336.9,645.2,621.6,1312,546,766
060590754042,633.0,337.0,260.6,528,277,251
060590754041,485.5,297.8,158.2,574,291,283
060590758064,522.3,268.8,217.8,563,264,299
060590757012,448.5,290.1,130.2,354,225,129
060590758062,492.3,213.9,253.6,507,234,273
060590219233,677.6,306.6,343.8,416,211,205
060590219212,1607.4,669.9,867.1,1314,494,820
060590219053,774.0,283.0,459.0,752,303,449
060590218072,1086.7,415.5,621.3,1088,419,669
060590219211,701.0,194.0,474.0,877,273,604
060590218262,563.8,210.9,317.6,484,189,295
060590219221,924.7,416.0,462.2,919,378,541
060590219224,720.5,325.8,360.3,672,303,369
060590219223,331.5,156.7,157.0,371,175,196
060590219222,319.3,155.5,145.5,268,132,136
060590219243,1051.1,521.0,471.7,1089,508,581
060590218261,788.3,294.8,444.1,569,283,286
060590219232,670.0,297.0,338.0,646,273,373
060590219242,830.9,395.0,383.3,792,373,419
060590218272,722.1,295.4,385.5,844,330,514
060590218251,988.1,312.0,625.3,1127,329,798
060590218301,693.3,225.9,430.5,786,257,529
060590218304,840.2,274.1,521.4,861,283,578
060590218302,952.9,280.8,628.7,969,281,688
060590218252,798.3,271.8,482.7,748,274,474
060590218241,536.6,162.3,349.5,656,211,445
060590218242,802.1,234.9,529.2,994,290,704
060590218271,848.9,315.8,498.1,782,267,515
060590218281,527.7,180.7,322.1,730,208,522
060710001163,437.2,222.5,196.8,468,230,238
060710001161,731.9,359.0,326.3,816,434,382
060374033241,306.0,163.0,132.5,446,241,205
060374033251,1023.9,574.6,389.2,1047,566,481
060374033253,247.4,135.1,98.7,265,152,113
060374033244,240.8,127.5,105.8,400,188,212
060374033252,514.6,280.9,205.3,548,292,256
060374033242,502.7,287.9,191.6,633,334,299
060374033221,732.8,437.8,250.5,845,432,413
060374033222,859.9,482.4,334.3,756,415,341
060374033232,743.8,452.6,263.3,834,472,362
060374033192,637.1,383.1,210.3,685,420,265
060374033233,513.4,301.6,187.9,482,273,209
060590219134,725.6,476.9,207.8,472,320,152
060590219183,372.0,195.2,153.0,330,163,167
060590219181,813.9,336.0,430.6,801,354,447
060590219133,765.1,389.4,332.0,700,326,374
060590758101,800.0,288.1,474.2,884,290,594
060590758102,909.1,298.2,569.8,949,278,671
060590219131,460.7,185.4,250.8,475,148,327
060590756031,713.8,291.9,362.1,761,300,461
060590756033,660.2,279.1,326.3,579,278,301
060590756061,1085.6,393.7,614.1,1305,428,877
060590756063,1096.0,413.9,612.2,1020,364,656
060590756043,472.2,175.2,266.6,422,151,271
060590756041,794.6,309.6,435.8,873,319,554
060590756042,1176.6,515.3,592.1,1190,442,748
060590219142,652.2,285.1,324.5,723,286,437
060590219141,1056.1,520.5,472.9,1039,529,510
060590219182,1168.7,575.0,522.2,1185,564,621
060590219132,769.0,387.0,333.4,631,309,322
060590219171,867.0,294.1,527.7,900,289,611
060590219173,603.8,179.1,392.5,571,157,414
060590524181,662.1,425.7,198.5,716,451,265
060590524173,1244.8,719.8,456.3,1363,689,674
060590524183,1764.7,1173.3,491.3,1018,595,423
060590524182,1459.5,969.8,407.3,1336,828,508
060590524171,963.8,431.4,490.1,954,516,438
060590524174,463.5,239.9,203.8,550,283,267
060590525259,643.6,369.1,234.2,630,329,301
060590525253,365.2,203.8,141.0,452,238,214
060590524172,533.7,209.7,300.1,679,196,483
060590524214,521.2,288.1,201.0,404,252,152
060590524211,909.5,535.5,310.6,990,493,497
060590524212,444.7,249.7,163.3,689,342,347
060590525262,1231.1,658.6,486.1,1245,674,571
060590524202,2205.0,1307.0,788.0,2321,1221,1100
060650408072,919.7,346.1,526.0,873,364,509
060650417033,358.5,256.4,80.8,163,102,61
060650408071,436.9,197.7,213.5,476,208,268
060650466022,624.7,178.1,412.6,1093,347,746
060650466021,386.2,109.9,254.7,501,185,316
060650406161,1265.8,734.2,479.6,705,401,304
060650466011,883.7,258.4,596.2,288,91,197
060710001131,1267.6,647.2,573.2,1145,562,583
060710001152,1753.9,962.5,712.9,1522,805,717
060710005041,241.2,144.2,83.2,363,185,178
060710005033,493.8,272.2,195.0,414,205,209
060710005031,461.3,254.3,182.2,325,184,141
060710005042,815.0,345.0,437.0,796,348,448
060710019032,944.5,503.1,390.4,23,10,13
060710122001,1727.2,879.7,792.0,180,89,91
060710019013,836.7,415.8,374.9,792,395,397
060710019012,678.9,345.6,302.8,648,315,333
060710019052,415.1,211.4,185.2,407,211,196
060710019054,937.7,450.7,443.1,919,450,469
060710018042,1166.2,661.9,453.6,1008,549,459
060710005012,601.2,341.2,227.9,624,383,241
060710006051,495.0,361.7,108.7,375,254,121
060710006043,497.9,274.1,189.2,553,331,222
060710006032,890.7,490.4,343.7,592,330,262
060710006052,641.0,442.3,165.3,500,347,153
060710006041,770.7,435.1,301.9,801,456,345
060710006042,465.8,286.4,158.4,385,240,145
060710006061,631.8,381.9,224.0,582,325,257
060710006062,513.2,310.1,182.0,365,249,116
060590756071,453.0,235.5,188.4,464,212,252
060590756073,501.0,254.7,220.6,505,249,256
060590755042,696.4,305.7,332.3,631,296,335
060590757021,724.0,304.4,356.2,695,305,390
060590757014,1024.2,442.2,512.7,905,377,528
060590757011,331.7,139.5,176.9,754,270,484
060590758082,1081.0,451.0,556.0,1084,427,657
060590757022,588.3,247.2,289.5,547,185,362
060590757023,554.2,228.2,282.2,541,226,315
060590757031,1365.6,538.5,733.2,1320,506,814
060590757032,1453.2,579.5,780.2,1116,387,729
060590758081,927.0,450.0,423.0,830,369,461
060590758072,945.8,425.7,445.1,1107,434,673
060590758051,399.0,223.0,147.5,297,146,151
060590758053,356.0,199.0,131.5,361,184,177
060590758151,1017.9,465.2,487.1,1131,496,635
060590758123,624.1,253.5,330.1,597,237,360
060590758161,754.8,371.4,330.8,521,311,210
060590758153,366.1,179.8,160.8,435,196,239
060590758162,494.5,251.3,209.9,580,304,276
060590758152,699.3,355.5,296.8,399,220,179
060590758124,541.7,213.0,294.1,527,211,316
060590758122,625.2,236.2,350.0,633,239,394
060590758071,470.5,224.1,210.4,477,227,250
060590758073,365.7,174.2,163.5,211,135,76
060590626253,640.9,308.0,298.5,574,293,281
060590626252,512.5,264.4,230.8,644,364,280
060590626251,473.3,244.2,213.2,572,309,263
060590626472,389.2,202.7,174.0,488,252,236
060590626463,984.6,515.0,438.4,837,419,418
060590626474,497.5,256.7,224.0,486,244,242
060590626461,479.8,252.9,212.2,365,197,168
060590626464,553.2,291.6,244.7,532,277,255
060590626471,519.0,283.0,200.0,388,201,187
060590626211,655.4,339.9,258.4,649,352,297
060590524102,586.9,189.5,383.2,530,176,354
060590525181,1488.0,964.0,427.0,749,444,305
060590626224,310.0,146.0,140.0,4,2,2
060590524101,505.1,272.0,192.3,347,157,190
060590524113,468.8,224.7,217.3,478,206,272
060590524103,747.5,359.0,340.0,720,373,347
060590524104,548.5,263.4,249.5,676,324,352
060590524081,586.1,243.7,312.4,647,236,411
060590524084,683.9,284.3,364.6,732,307,425
060590525155,397.6,252.0,117.4,342,231,111
060590525213,373.5,236.8,110.3,315,214,101
060590755154,2798.6,1724.3,929.3,1226,699,527
060590525151,560.0,363.1,168.6,594,349,245
060590525153,728.6,456.8,228.9,668,416,252
060590525154,541.5,339.5,170.1,490,321,169
060590525152,449.8,296.3,136.4,527,302,225
060590525273,298.1,192.8,86.7,379,218,161
060590525274,293.0,189.5,85.2,217,132,85
060590525024,605.0,286.0,284.0,604,258,346
060590525023,860.5,501.6,292.2,804,437,367
060590755153,952.7,682.1,210.2,633,412,221
060590755121,443.7,296.0,118.8,296,194,102
060590755152,392.6,281.1,86.6,456,321,135
060590525022,753.5,366.9,346.4,838,371,467
060590525021,683.8,338.8,312.3,713,315,398
060590755122,532.0,316.8,179.3,490,279,211
060590755142,312.5,219.5,68.1,136,97,39
060590755141,463.5,325.5,100.9,474,277,197
060590755051,644.9,343.5,249.8,522,312,210
060590755061,725.6,383.4,297.1,779,394,385
060590639063,1186.6,595.1,497.4,1008,541,467
060590639023,429.9,256.8,139.1,234,170,64
060590639051,730.6,360.9,318.2,726,373,353
060590639024,498.7,247.0,219.7,285,188,97
060590639041,617.8,304.3,257.9,754,330,424
060590630043,682.8,252.4,401.8,616,219,397
060590630062,973.8,318.5,612.3,1000,368,632
060590630061,745.2,249.5,459.7,875,318,557
060590627011,1012.8,391.3,571.1,1159,443,716
060590630052,403.0,146.5,240.7,322,137,185
060590627025,580.7,229.1,316.1,588,262,326
060590627012,571.2,240.3,296.3,607,267,340
060590627021,524.5,204.5,296.2,554,182,372
060590627023,809.0,351.4,411.1,809,432,377
060590626421,430.6,175.4,234.7,499,179,320
060590627024,491.3,212.2,256.8,458,220,238
060590627022,427.1,167.7,243.0,474,199,275
060590626423,742.8,285.4,420.6,971,329,642
060590626422,517.2,204.0,288.1,668,269,399
060590630071,914.2,345.9,522.4,1029,274,755
060590630081,560.9,212.3,320.6,573,196,377
060590626444,802.4,303.6,458.6,860,374,486
060590630072,965.9,365.5,552.0,1172,407,765
060590626442,1097.0,415.1,626.9,1154,480,674
060590630042,1217.7,460.8,695.9,832,504,328
060590626441,841.7,318.5,481.0,1089,373,716
060590626434,482.7,190.7,273.4,512,198,314
060590626454,376.7,166.9,191.8,405,178,227
060590626452,343.6,150.7,175.1,412,176,236
060590626453,625.4,274.3,318.8,442,226,216
060590631032,602.9,281.0,275.0,606,306,300
060590631031,845.1,354.9,439.7,811,364,447
060590630104,807.0,306.9,451.6,831,309,522
060590630041,1090.3,453.8,576.2,1108,498,610
060590630074,686.9,289.8,358.9,815,294,521
060590630044,858.7,375.4,434.9,842,344,498
060590631023,672.7,320.2,301.1,609,315,294
060590631022,713.8,379.0,285.4,707,387,320
060590631024,813.0,385.3,358.4,755,422,333
060590631021,974.9,477.7,421.2,916,509,407
060590639043,413.6,217.2,160.0,164,109,55
060590639081,615.0,292.0,288.0,576,261,315
060590636053,335.1,205.8,110.4,102,67,35
060590636033,829.3,353.8,421.5,794,408,386
060590634001,374.1,159.6,190.1,536,226,310
060590634003,367.6,156.8,186.8,468,185,283
060590633023,588.8,258.5,292.1,573,285,288
060590630102,1081.4,461.3,549.6,595,401,194
060590633024,499.5,226.5,236.9,476,216,260
060590633013,321.0,154.0,143.0,278,158,120
060590633011,520.2,277.2,198.0,440,281,159
060590633012,549.2,296.6,204.6,516,308,208
060590637023,355.7,195.6,134.1,250,142,108
060590637022,211.2,116.1,79.6,138,89,49
060590637021,322.7,197.8,101.0,357,213,144
060590632022,548.7,257.9,252.6,464,264,200
060590632021,371.5,174.5,168.8,302,159,143
060590637025,266.4,186.1,59.4,161,123,38
060590633022,543.7,251.0,251.0,451,224,227
060590633021,420.0,165.0,218.0,517,238,279
060590630101,611.7,256.9,317.8,546,243,303
060590639061,424.5,267.7,124.3,477,319,158
060590632013,657.6,317.9,286.5,595,333,262
060590632024,339.5,159.5,154.2,365,189,176
060590632023,498.8,227.3,241.8,550,284,266
060590632012,576.4,275.1,255.5,549,293,256
060590638072,545.1,275.9,236.1,470,272,198
060590638071,1187.0,642.4,459.7,1236,606,630
060590639053,736.0,367.3,318.8,838,432,406
060590638021,862.5,392.0,419.7,768,385,383
060590638062,765.6,332.8,375.2,604,267,337
060590639022,577.0,347.0,173.0,496,349,147
060590638061,414.4,194.2,179.8,453,251,202
060590639062,363.2,227.7,105.6,237,169,68
060590632011,588.4,290.1,241.3,567,297,270
060590740054,497.8,336.3,126.9,664,406,258
060590740044,911.0,634.0,230.0,917,557,360
060590740041,722.3,487.9,184.1,525,348,177
060590740043,596.9,403.2,152.1,629,368,261
060590740031,808.9,632.7,134.5,537,427,110
060590740042,315.0,212.8,80.3,139,97,42
060590747011,490.4,403.9,63.1,335,284,51
060590747012,595.1,490.1,76.6,360,319,41
060590741021,389.7,320.9,50.2,358,284,74
060590741091,465.4,383.3,59.9,329,236,93
060590741022,565.8,466.0,72.8,552,407,145
060590741023,573.0,468.0,81.0,406,323,83
060590748062,489.4,430.3,39.1,412,352,60
060590747023,396.9,349.0,31.7,175,148,27
060590747013,629.8,553.8,50.3,475,417,58
060590748013,319.4,278.0,25.5,381,341,40
060590748061,276.2,243.5,18.0,181,159,22
060590748052,248.9,219.5,16.2,234,204,30
060590748051,434.0,382.7,28.2,170,142,28
060590748012,357.4,308.2,32.3,265,231,34
060590748011,340.0,293.1,30.7,194,163,31
060590749012,219.2,187.9,22.9,280,212,68
060590751001,534.1,457.7,55.8,140,113,27
060590741031,408.9,337.6,48.0,395,299,96
060590741032,363.0,299.7,42.6,302,246,56
060590742004,699.0,576.8,82.3,422,328,94
060590742003,886.9,732.2,104.2,697,596,101
060590741033,488.1,403.0,57.3,354,279,75
060590747022,494.3,415.9,56.3,328,286,42
060590747021,470.7,396.1,53.7,353,290,63
060590746014,464.4,352.8,83.7,446,337,109
060590746015,458.3,344.2,86.4,345,262,83
060590749021,268.4,231.5,22.8,209,184,25
060590749023,319.2,275.2,27.1,173,148,25
060590749022,271.2,230.2,26.3,158,140,18
060590749013,256.3,223.8,22.9,172,144,28
060590749011,299.2,261.2,26.8,292,260,32
060590749015,294.5,257.1,26.3,125,104,21
060590746012,292.1,245.3,29.9,148,117,31
060590746011,260.4,219.1,27.0,174,147,27
060590746013,232.5,195.6,24.1,128,110,18
060590750032,348.8,289.8,42.7,140,108,32
060590750021,294.3,244.6,36.0,242,175,67
060590750024,182.4,151.6,22.3,332,232,100
060590749014,235.1,195.4,28.8,152,119,33
060590750033,267.0,221.9,32.7,82,65,17
060590743002,509.1,398.2,84.7,415,354,61
060590744031,299.8,257.3,27.4,266,215,51
060590743001,416.7,363.5,37.1,338,286,52
060590745022,453.0,395.1,40.3,228,197,31
060590742001,237.4,207.1,21.1,168,145,23
060590742002,309.9,270.3,27.6,233,202,31
060590746023,428.8,361.8,45.6,326,275,51
060590746025,324.8,274.5,34.9,236,186,50
060590746024,417.6,353.1,43.0,384,320,64
060590745021,891.0,739.0,109.0,714,569,145
060590745012,191.5,164.3,17.5,60,51,9
060590745011,323.7,275.9,31.0,159,138,21
060590744032,276.2,237.0,25.3,160,135,25
060590745013,91.3,78.3,8.4,15,13,2
060590746022,234.8,195.2,22.6,129,111,18
060590746021,154.0,128.0,14.8,80,70,10
060590745014,300.1,254.5,29.7,262,221,41
060590744071,308.0,278.0,17.0,160,135,25
060590744082,230.4,174.8,43.6,311,230,81
060590744072,624.3,405.0,176.2,484,314,170
060590744083,285.2,217.6,53.5,142,101,41
060590744081,372.5,280.0,75.9,299,198,101
060590752012,513.1,417.5,67.5,413,340,73
060590755132,620.8,379.3,190.8,411,201,210
060590755131,770.7,519.0,204.0,790,508,282
060590755073,673.0,367.6,258.6,526,281,245
060590755071,707.1,399.6,254.9,629,329,300
060590755072,239.2,160.8,59.6,167,113,54
060590755062,846.2,374.1,407.4,869,390,479
060590525113,445.8,223.2,196.4,463,236,227
060590525112,363.0,181.8,159.9,397,205,192
060590525281,276.2,163.3,96.7,359,201,158
060590525284,305.0,180.4,106.8,142,99,43
060590525283,506.4,299.4,173.5,495,292,203
060590525282,348.4,205.9,119.0,536,278,258
060590525272,1427.7,821.2,530.7,1502,767,735
060590525271,1385.3,808.8,501.3,1415,745,670
060590525258,695.4,477.6,173.9,236,140,96
060590525255,530.6,335.4,167.1,223,128,95
060590525052,868.5,447.9,380.1,908,477,431
060590525051,322.8,185.5,118.6,310,175,135
060590525054,590.2,337.4,221.9,526,251,275
060590525261,684.4,388.9,245.4,708,387,321
060590525053,235.0,154.7,65.9,278,160,118
060590525254,537.0,310.6,194.8,398,241,157
060590525256,462.4,257.9,179.0,503,245,258
060590525257,767.0,443.6,278.2,963,523,440
060590525252,420.7,233.9,163.8,472,260,212
060590525245,832.3,474.2,309.0,755,410,345
060590525243,518.4,301.2,186.5,539,308,231
060590525242,435.2,276.1,134.6,571,333,238
060590525251,995.0,616.0,347.0,923,518,405
060590525244,428.5,273.2,131.3,365,241,124
060590525241,634.6,312.1,285.6,608,265,343
060590756062,367.8,170.1,176.9,360,149,211
060590756032,759.5,299.7,410.8,719,270,449
060590756074,452.1,251.6,177.3,384,212,172
060590756075,316.9,176.4,124.3,523,273,250
060590218162,979.2,340.5,592.5,1081,389,692
060590218172,431.3,160.2,242.2,471,170,301
060590218161,644.4,175.6,440.3,734,194,540
060590218171,1425.7,521.9,797.8,1291,475,816
060590218303,824.0,374.0,417.0,885,361,524
060590218293,860.0,346.0,479.0,948,360,588
060590218021,775.0,267.9,472.1,738,223,515
060590218224,1152.3,387.8,708.7,1054,300,754
060590218223,650.9,249.3,369.1,548,220,328
060590218221,821.4,293.0,481.8,669,214,455
060590218152,395.5,197.5,177.7,260,94,166
060590218291,1313.6,406.6,836.0,1322,401,921
060590218231,1902.1,697.3,1109.5,1718,662,1056
060590218292,1079.8,366.6,661.7,980,330,650
060590219202,676.2,296.8,346.2,543,226,317
060590219201,319.6,136.0,169.1,498,176,322
060590219203,682.8,292.0,356.3,874,377,497
060374087061,466.0,250.7,189.1,556,274,282
060374087041,788.0,497.0,241.0,930,570,360
060374082113,426.3,264.3,141.3,498,283,215
060374082122,585.0,370.0,178.0,639,386,253
060374081411,1035.4,813.8,160.0,994,734,260
060374081402,303.1,249.4,34.1,203,169,34
060374081412,228.7,186.0,28.3,183,155,28
060374081372,409.9,302.9,81.4,397,294,103
060374081371,669.3,464.8,169.4,575,389,186
060374082121,747.4,493.5,232.3,791,459,332
060374033041,684.4,397.5,253.2,972,524,448
060374081362,574.5,383.6,161.3,594,417,177
060374034012,470.0,280.0,165.0,407,240,167
060374033051,662.1,410.6,221.5,732,413,319
060374033042,1161.5,667.9,425.0,1164,657,507
060374081341,1035.0,718.0,276.0,1095,681,414
060590014011,639.0,268.2,327.8,666,279,387
060590014042,191.7,133.0,46.0,174,127,47
060590014014,330.0,229.1,79.1,202,130,72
060590016024,621.7,292.0,294.5,675,330,345
060590016014,547.8,225.1,293.5,529,223,306
060590016012,429.4,190.4,214.8,589,228,361
060590016016,779.0,348.0,392.4,675,250,425
060590016013,506.6,208.1,271.6,561,194,367
060590016011,550.2,243.3,279.0,387,168,219
060590016021,391.9,194.6,180.6,457,175,282
060590015034,538.0,192.0,315.0,437,134,303
060590015032,361.6,173.6,166.4,497,203,294
060590014041,709.1,395.7,268.1,456,258,198
060590015011,949.6,434.0,462.8,1042,454,588
060590014021,1047.8,594.2,395.6,945,529,416
060590014032,874.5,359.8,464.7,920,375,545
060590014022,813.8,351.0,417.1,781,305,476
060590014031,746.3,283.3,417.6,843,307,536
060590015071,548.0,274.5,243.9,441,230,211
060590015012,1449.5,619.7,747.5,1183,476,707
060590015013,982.8,371.0,545.5,1196,446,750
060590320563,1070.5,468.8,533.7,982,405,577
060590320534,705.5,352.2,315.3,707,363,344
060590320343,661.0,255.0,376.0,643,265,378
060590320342,1799.0,742.0,956.0,1664,677,987
060590320494,1167.9,533.5,563.5,1221,491,730
060590320372,779.0,329.8,408.8,542,205,337
060590320532,678.2,300.7,349.0,894,416,478
060590320531,1424.1,572.2,776.1,1564,628,936
060590320562,467.6,217.3,219.6,366,209,157
060590320533,864.2,400.0,411.5,570,279,291
060590320451,727.9,245.9,432.4,683,261,422
060590320561,604.9,242.8,330.9,409,152,257
060590320463,1190.9,363.5,781.8,1373,384,989
060590320464,1065.5,309.9,705.6,728,222,506
060590320452,783.1,271.1,456.6,787,317,470
060590320462,859.5,269.8,560.7,854,290,564
060590320461,502.6,152.1,329.6,420,126,294
060590320444,769.2,243.7,487.9,1101,387,714
060590320442,724.2,230.5,455.9,691,220,471
060590320341,749.2,318.6,389.7,871,405,466
060590320333,401.6,170.8,208.9,356,154,202
060590320483,651.9,314.6,302.6,533,241,292
060590320484,834.4,405.4,380.2,802,388,414
060590320493,815.8,365.5,397.8,845,411,434
060590320474,643.0,344.0,258.0,441,229,212
060590524283,480.5,208.9,235.3,441,197,244
060374017043,903.3,618.3,236.1,629,449,180
060374002043,862.6,379.1,433.5,988,422,566
060374016012,1305.5,601.4,631.1,1290,606,684
060374002062,1485.5,821.6,562.2,1613,868,745
060374021012,468.9,408.3,38.8,398,351,47
060374020012,503.0,357.0,119.0,455,309,146
060374020011,859.6,575.6,227.8,757,490,267
060374019022,1066.5,727.4,270.7,1309,877,432
060374019021,610.4,482.8,92.9,578,463,115
060374020022,499.9,344.5,126.7,277,196,81
060374019023,666.1,530.9,99.3,749,643,106
060374019024,869.3,693.2,129.6,898,653,245
060374018002,1440.2,878.5,469.3,1540,905,635
060374020023,606.5,417.8,158.6,673,455,218
060374020021,686.7,451.8,200.4,612,417,195
060374019011,218.1,195.1,6.4,476,440,36
060374019012,330.9,295.9,9.6,401,376,25
060374002074,1.9,0.7,1.1,6,1,5
060374057011,423.2,287.7,108.5,390,252,138
060374057021,806.9,555.8,203.8,979,634,345
060374057022,663.3,433.1,183.0,662,398,264
060374057012,234.0,152.8,64.5,49,33,16
060374057013,553.7,391.2,131.5,325,235,90
060374058002,628.5,401.0,189.9,578,385,193
060374058003,701.7,462.8,195.6,660,455,205
060374045011,536.4,436.6,64.8,490,374,116
060374060003,351.0,213.1,115.4,336,189,147
060374060002,697.2,434.7,206.4,673,412,261
060374045031,819.3,621.2,151.2,788,579,209
060374058001,562.3,363.6,165.7,469,313,156
060374044021,424.3,296.7,95.2,457,320,137
060374044023,284.8,210.0,57.0,268,195,73
060374044022,339.2,253.5,60.6,368,244,124
060374006023,523.6,344.6,136.9,513,329,184
060374044012,424.6,311.8,87.2,333,241,92
060374044024,339.9,260.5,57.9,274,208,66
060374043022,282.9,202.9,59.9,289,216,73
060374043021,447.9,321.3,94.7,372,293,79
060374044013,305.9,229.9,58.3,325,228,97
060374043012,344.3,258.9,65.0,279,206,73
060374044011,310.9,233.0,61.1,243,187,56
060374006032,495.4,311.9,147.0,436,273,163
060374043013,220.0,168.7,39.0,278,200,78
060374043014,144.8,111.1,25.7,250,197,53
060374006022,417.5,274.1,112.2,452,320,132
060374300032,1610.6,914.5,609.7,1658,938,720
060374300034,378.4,230.5,129.3,302,179,123
060374300033,0.0,0.0,0.0,0,0,0
061070006003,104.0,87.8,12.3,78,68,10
061070006002,141.0,119.2,16.7,91,72,19
061070002015,223.7,178.4,31.1,161,117,44
060190065011,654.7,435.1,193.5,457,269,188
060190065022,388.8,294.7,80.1,335,241,94
060190065012,171.5,143.6,20.3,139,121,18
060190065013,177.9,147.5,22.9,239,196,43
060190065021,324.5,259.5,53.2,274,204,70
061070024004,445.5,106.6,322.1,458,97,361
061070024001,1500.3,464.2,966.5,937,352,585
061070020072,962.5,344.2,569.7,685,271,414
061070016024,290.3,55.6,223.4,240,58,182
061070021002,368.0,115.8,235.8,358,120,238
061070022023,584.5,316.1,235.4,317,196,121
061070022031,658.7,369.2,254.9,590,317,273
061070016021,187.8,56.4,126.8,47,21,26
061070016023,443.0,173.5,242.9,372,163,209
061070015021,713.6,204.5,470.4,687,186,501
061070014004,237.1,67.9,159.0,294,78,216
061070025001,199.8,69.7,121.6,241,83,158
061070016012,226.2,146.9,63.5,166,102,64
061070016022,364.0,239.5,102.2,304,202,102
061070016014,190.4,123.7,53.5,186,124,62
061070016011,250.4,162.0,70.8,292,166,126
061070014001,555.5,289.3,247.2,503,212,291
061070016013,178.4,115.8,50.1,145,99,46
061070015012,1055.5,324.8,669.2,993,365,628
061070015022,289.8,94.3,177.9,359,116,243
061070015023,542.4,161.6,346.2,316,113,203
061070015011,664.2,195.1,430.2,713,233,480
061070013022,511.4,218.9,252.3,443,208,235
061070013024,779.1,343.0,387.2,677,279,398
061070009004,442.1,271.6,141.9,265,166,99
061070020061,556.8,174.1,356.4,682,194,488
061070009005,159.5,101.6,46.9,137,80,57
061070024005,1046.0,331.5,668.5,556,193,363
061070020071,1607.6,576.2,952.6,1507,565,942
061070030021,261.9,124.0,120.5,235,127,108
061070022032,220.9,124.9,84.3,183,84,99
061070030022,272.2,185.7,73.8,237,147,90
061070030012,185.3,115.4,60.8,162,110,52
061070030013,237.7,163.5,63.1,214,147,67
061070030011,216.4,117.3,86.1,129,82,47
061070023034,428.3,149.3,255.2,499,178,321
061070022022,146.6,79.0,58.5,127,79,48
061070029011,335.1,185.5,127.7,244,145,99
061070023041,178.7,87.5,79.6,191,80,111
061070023032,896.0,253.9,611.1,940,287,653
061070029032,442.2,152.8,265.6,306,152,154
061070022021,299.6,154.1,127.1,147,100,47
061070022041,584.2,315.0,232.0,584,298,286
061070022043,177.9,100.7,66.2,152,92,60
061070022042,319.0,180.5,118.7,343,190,153
061070023035,256.2,90.1,152.1,295,88,207
061070029013,73.0,42.1,26.2,59,30,29
061070023033,352.5,133.2,198.9,447,128,319
061070023021,336.9,125.7,191.6,326,122,204
061070023022,783.9,274.3,467.8,1030,403,627
061070023031,459.3,121.0,322.8,515,145,370
061070020062,1434.1,432.0,916.3,1377,448,929
061070010051,1227.3,397.3,763.3,1149,371,778
061070010065,234.3,75.6,147.1,210,77,133
061070020042,1120.4,397.8,655.6,906,354,552
061070029042,374.3,232.0,124.4,424,212,212
061070029012,229.1,141.7,76.3,241,183,58
060290047023,182.4,151.1,21.2,138,107,31
060290048002,319.2,246.4,60.8,254,205,49
060290048003,333.1,280.1,43.7,356,308,48
060290048004,371.3,313.3,47.8,257,215,42
060290050042,236.4,170.6,53.7,174,118,56
060290050041,816.1,563.7,220.4,719,472,247
060290049014,225.8,165.5,50.0,297,187,110
060290049025,417.1,306.5,90.5,412,284,128
060290049012,140.1,110.2,22.4,116,83,33
060290050043,394.6,271.6,106.0,534,321,213
060290050031,348.8,240.3,94.4,338,215,123
060290049024,287.9,211.5,62.5,282,179,103
060290046044,523.8,388.8,102.3,399,247,152
060290048001,423.0,346.0,60.0,391,309,82
060290049011,183.0,144.4,28.9,137,95,42
060290049013,132.2,104.3,20.9,169,131,38
060290049023,352.2,266.0,65.7,294,204,90
060290049022,402.1,306.1,77.6,361,248,113
060290049021,363.4,278.0,71.7,293,202,91
061070044002,162.1,138.6,18.4,92,75,17
061070043004,311.6,267.7,26.0,290,243,47
061070032004,180.8,117.8,52.3,181,120,61
061070013012,819.4,358.1,411.7,851,380,471
061070013023,643.3,282.1,322.5,670,228,442
061070015024,321.6,102.0,198.4,299,111,188
061070026013,340.1,230.6,90.2,173,99,74
061070026025,130.7,69.9,55.6,108,69,39
061070025004,205.4,101.8,94.7,227,126,101
061070028002,190.7,123.8,55.9,92,51,41
061070025003,176.0,91.1,78.5,138,83,55
061070026021,178.6,112.0,57.2,127,85,42
061070026023,235.0,160.7,62.4,266,157,109
061070028001,297.4,195.1,84.4,207,123,84
061070026011,290.1,202.4,72.3,97,66,31
061070026024,167.9,117.6,39.4,122,73,49
061070026022,188.2,131.9,44.2,233,158,75
061070026012,161.2,112.3,40.9,27,19,8
061070036012,495.4,225.1,242.2,519,238,281
061070036013,437.2,192.7,220.3,385,163,222
061070036011,409.4,173.4,212.0,540,208,332
061070036014,414.8,180.0,210.2,315,148,167
061070036022,232.7,130.1,91.5,261,122,139
061070029033,165.1,79.1,74.3,187,85,102
061070029034,318.8,130.6,175.9,329,119,210
061070029031,892.2,294.0,561.0,627,214,413
061070023042,275.4,95.2,165.4,264,96,168
061070024002,652.9,202.9,423.0,392,152,240
061070023023,437.9,141.5,273.7,391,149,242
061070020041,344.2,137.3,191.3,327,127,200
061070020043,441.7,176.2,245.5,592,237,355
061070020035,450.5,172.0,250.1,379,179,200
061070020034,454.2,173.9,252.1,541,209,332
061070020031,392.3,150.2,217.8,437,171,266
061070019024,402.6,135.3,241.2,371,144,227
061070020073,401.5,151.3,229.3,344,151,193
061070017015,513.9,191.7,296.1,334,141,193
061070020091,490.4,197.8,265.1,552,205,347
061070020092,597.7,230.6,327.4,623,253,370
061070020082,263.3,111.0,140.4,267,104,163
060630001005,328.6,126.1,173.6,406,198,208
060630001002,291.4,162.9,110.1,426,277,149
060630001003,314.4,125.1,162.3,441,236,205
060630001004,807.4,309.0,427.9,734,323,411
060630004003,376.2,139.6,196.2,444,231,213
060350402003,156.5,47.5,92.3,200,92,108
060350402002,489.2,163.1,277.4,582,322,260
060170320003,87.3,51.6,26.4,129,74,55
060170320001,352.9,213.2,105.4,332,216,116
060179900000,0.0,0.0,0.0,0,0,0
060610220143,268.9,186.3,61.4,297,216,81
060610220111,230.9,135.9,69.5,309,178,131
060610220142,382.3,266.5,88.9,386,279,107
060610220112,555.5,376.5,137.1,403,273,130
060610221001,319.5,208.9,82.7,398,289,109
060610221002,125.0,79.4,34.1,205,140,65
060610223001,117.2,74.4,31.9,138,100,38
060610223002,241.5,153.4,65.8,206,130,76
060610222002,108.8,71.0,29.3,121,84,37
060610222001,423.7,277.8,113.7,456,328,128
060619900000,0.0,0.0,0.0,0,0,0
060610201043,230.1,152.4,61.5,265,176,89
060610201041,213.5,141.4,57.0,223,152,71
060610201042,311.3,185.9,99.1,399,276,123
060910100005,393.6,117.0,250.8,147,47,100
060570012042,544.1,365.3,134.3,565,397,168
060570012041,495.2,328.3,121.7,455,326,129
060570012051,951.8,601.2,275.9,1065,697,368
060570012031,461.6,316.3,113.1,467,314,153
060570012043,377.0,257.9,92.5,321,211,110
060570012032,479.9,323.9,119.8,492,322,170
060570012033,561.7,377.0,141.8,664,477,187
060570012062,412.9,280.4,102.6,305,213,92
061090031003,795.9,296.4,457.9,717,330,387
061090031004,1055.7,375.7,617.0,1204,478,726
060090004002,237.8,72.4,141.5,210,96,114
060090004001,254.1,79.4,149.8,401,187,214
060170306012,1406.8,443.8,872.9,1296,544,752
060170307012,1520.2,614.1,808.4,1322,575,747
060170307011,1864.8,785.6,950.8,1918,830,1088
060170318003,1124.4,513.4,538.8,808,382,426
060170318002,1614.3,724.0,803.4,1383,653,730
060170307091,1354.9,503.3,757.2,1440,589,851
060170308082,1992.1,673.7,1186.7,1529,634,895
060170307102,538.9,196.2,314.4,410,176,234
060170308012,776.7,244.3,478.6,714,251,463
060170308083,1065.6,408.6,573.4,990,389,601
060170308081,541.4,197.1,294.1,504,205,299
060170308102,561.0,202.4,330.8,604,205,399
060170308101,990.8,354.6,546.5,828,356,472
060170308011,1427.1,445.4,880.0,1452,519,933
060170308031,2080.9,743.7,1180.6,1841,758,1083
060170308032,1143.4,347.5,732.1,1187,452,735
060170308041,1495.2,443.2,962.5,1409,490,919
060170308043,1439.7,489.3,847.7,1362,520,842
060170308092,788.4,287.5,439.8,746,312,434
060170308033,840.0,289.7,505.0,654,259,395
060170308042,667.1,211.2,406.5,751,299,452
060170315032,1247.2,394.3,764.5,1127,435,692
060170315031,411.2,123.6,257.9,493,193,300
060610207103,896.0,337.1,491.6,913,362,551
060610207101,752.9,266.6,430.4,832,314,518
060610206062,547.4,220.6,283.1,552,220,332
060670082112,489.4,160.3,297.0,487,192,295
060670082111,1030.3,333.0,627.8,976,376,600
060670082031,1006.7,336.0,597.4,1111,400,711
060610206063,865.0,359.8,460.3,887,368,519
060670082083,481.4,185.6,252.9,479,235,244
060670082084,519.5,187.3,288.7,506,217,289
060670082082,507.5,193.7,271.9,479,204,275
060670082072,406.4,167.2,197.2,379,149,230
060670082073,338.1,129.3,171.3,303,145,158
060670082074,335.6,128.4,170.0,330,160,170
060670082075,819.3,356.5,383.4,813,352,461
060670082081,419.4,134.3,253.6,423,155,268
060670082091,1051.8,456.5,532.0,1031,480,551
060670084042,529.0,249.6,239.0,543,295,248
060670084041,334.1,157.6,150.9,258,121,137
060670084032,969.7,506.7,388.2,941,460,481
060670084033,737.4,380.7,299.9,629,352,277
060610206061,1104.8,435.7,600.3,1145,396,749
060610206051,1082.7,420.3,601.5,1108,410,698
060610207112,658.6,316.6,294.1,523,276,247
060610207113,430.6,204.4,195.2,500,240,260
060610207102,688.8,307.4,332.0,854,351,503
060610207171,373.8,175.9,174.2,217,112,105
060610207172,1157.1,526.9,568.1,1247,574,673
060610224001,1151.8,523.9,571.2,1005,414,591
060610224002,1443.3,631.2,754.4,908,414,494
060610206053,977.9,410.0,509.2,910,379,531
060610206042,1386.4,528.5,778.1,1432,493,939
060610211082,997.3,404.0,510.8,966,463,503
060610211081,302.7,120.0,157.2,215,98,117
060610211033,522.1,200.2,285.4,450,191,259
060610211092,1370.9,529.6,754.6,1159,510,649
060610205022,361.1,131.7,198.0,412,184,228
060610204021,886.4,448.5,377.7,955,513,442
060610215011,612.4,220.4,352.9,545,199,346
060610215013,708.8,235.2,421.8,669,265,404
060610204022,1157.4,528.7,527.6,1145,600,545
060610215021,1423.5,616.1,705.6,1423,668,755
060610204012,248.1,130.0,98.4,225,121,104
060610215012,1600.5,571.2,915.3,1360,592,768
060610203003,397.5,171.2,191.7,494,253,241
060610215022,571.6,247.0,277.6,581,282,299
060610203001,965.8,503.4,386.6,1006,587,419
060610218023,431.8,168.4,225.8,536,235,301
060610218024,557.8,200.6,317.9,543,239,304
060170306023,634.1,224.0,365.2,701,311,390
060050002001,513.3,195.6,281.4,553,237,316
060050003011,440.3,130.4,279.0,365,137,228
060050002005,433.5,150.4,254.3,466,169,297
060050002004,479.0,175.0,269.7,493,183,310
060050002002,826.7,312.1,463.4,889,433,456
060050004011,758.3,247.9,474.7,827,350,477
060090004006,339.9,119.2,190.8,264,128,136
060050004024,604.6,187.4,369.3,590,251,339
060050004022,437.0,139.3,272.7,453,184,269
060050004021,884.4,313.6,516.2,1054,457,597
060050001014,370.2,126.7,223.2,450,207,243
060050001011,766.9,302.1,418.3,973,444,529
060170315042,427.0,137.0,261.2,460,204,256
060170314024,417.8,155.8,242.0,468,173,295
060170306032,541.6,197.2,305.7,482,211,271
060170309011,1114.6,402.1,642.0,1102,480,622
060170306033,746.2,217.2,469.4,756,276,480
060170306024,667.4,243.9,372.9,711,337,374
060170306025,479.0,171.2,274.3,473,219,254
060170309012,719.3,252.3,419.3,707,290,417
060170306022,1141.8,353.1,698.1,1238,505,733
060170306011,1497.1,574.5,820.1,1568,663,905
060610219012,1047.6,339.7,629.4,1029,421,608
060610219023,415.2,141.7,240.9,340,155,185
060610219022,1114.4,455.8,592.0,1254,534,720
060610220023,1162.8,371.4,717.9,1165,461,704
060610202002,1422.4,390.9,907.3,1512,637,875
060570001051,445.0,135.7,272.7,510,216,294
060570001052,330.2,102.5,201.5,397,151,246
060570001053,680.5,235.5,385.5,570,227,343
060570001043,518.4,194.8,281.1,585,250,335
060170315022,1407.1,476.4,837.3,1219,496,723
060170312002,1170.8,503.2,581.8,1011,482,529
060170311001,1192.8,542.7,552.2,1148,606,542
060170312001,957.9,361.3,536.1,1039,452,587
060170312003,366.8,157.9,175.1,234,126,108
060170314022,927.1,330.7,525.5,916,431,485
060170306031,387.8,111.8,243.5,396,155,241
060610220133,576.1,199.1,341.2,521,237,284
060610220132,546.2,189.8,322.8,561,259,302
060570007012,1095.4,548.1,444.1,1177,649,528
060570008013,1215.5,651.5,441.6,1096,654,442
060570007016,780.5,350.4,358.3,773,393,380
060610210461,279.5,117.7,146.1,284,140,144
060610210462,596.3,248.0,316.1,843,377,466
060610210451,805.7,350.7,391.5,1065,556,509
060610210032,304.7,114.7,172.1,418,161,257
060610209012,511.2,243.9,224.7,416,226,190
060610209011,341.4,161.4,154.5,412,227,185
060610208062,646.0,280.0,321.8,727,360,367
060610208061,884.6,377.2,430.1,937,484,453
060610209083,823.6,394.6,333.6,603,360,243
060610208052,428.1,185.9,208.4,480,223,257
060610210031,488.2,234.6,208.5,561,294,267
060610210033,600.5,222.2,344.0,656,250,406
060610210036,233.7,98.0,114.8,221,130,91
060610210343,302.7,129.0,154.3,360,159,201
060610210341,898.3,382.0,458.7,837,377,460
060610210342,680.0,308.0,331.0,635,302,333
060610210035,938.9,392.6,485.8,901,411,490
060610228001,1899.0,835.0,950.0,1452,647,805
060610207131,849.2,356.6,434.1,628,303,325
060610207122,253.7,106.7,127.4,306,139,167
060610207121,588.1,250.2,292.9,543,245,298
060610207123,533.0,236.8,258.2,710,377,333
060610207132,613.1,273.1,299.1,795,378,417
060610207111,757.2,350.3,361.6,751,340,411
060610210034,206.7,99.8,89.6,322,160,162
060610211292,550.8,215.3,286.7,653,336,317
060610211282,925.5,380.7,466.9,961,451,510
060610211281,396.0,171.1,195.5,380,165,215
060610211291,724.3,284.0,380.3,813,366,447
060610211062,745.8,293.0,400.8,943,391,552
060610211061,367.8,144.8,198.2,446,187,259
060610211034,401.4,154.0,220.2,415,191,224
060670087051,1967.4,1086.7,740.7,802,480,322
060670087041,643.8,365.6,235.5,615,347,268
060670087042,474.2,269.4,173.5,354,202,152
060670087052,1541.5,768.4,632.1,313,175,138
060050001013,459.4,148.9,283.2,465,193,272
060050001012,346.0,127.5,196.3,575,243,332
060090004005,306.7,104.7,174.7,256,128,128
060090004003,561.5,210.4,306.7,518,253,265
060610233001,1262.2,501.1,655.0,733,342,391
060610214031,240.2,100.8,121.6,169,81,88
060610214034,462.8,194.2,234.4,530,249,281
060610211301,905.9,380.8,444.9,1095,539,556
060610229001,1873.0,861.0,865.0,1643,765,878
060610211312,1511.1,686.0,735.7,1256,571,685
060610213092,706.9,298.2,355.4,845,369,476
060610235001,2951.8,983.6,1797.8,2036,784,1252
060610236001,2193.3,946.1,1188.7,2128,952,1176
060610237002,1530.7,640.1,838.5,1427,598,829
060610211311,818.3,311.3,432.4,855,373,482
060610211231,1460.1,589.0,788.6,1468,618,850
060610211233,2076.9,813.4,1150.7,2107,852,1255
060610211232,876.0,394.0,415.0,882,416,466
060610213091,635.7,235.6,357.0,610,233,377
060610211222,749.8,313.5,373.3,701,340,361
060610236002,1384.7,569.3,770.5,1601,693,908
060610211221,1299.4,539.3,688.5,1335,534,801
060610238001,2196.4,999.0,1136.2,2463,1144,1319
060610237001,1649.9,758.6,845.4,1537,719,818
060610214035,492.4,199.6,257.8,469,201,268
060610214032,346.2,144.3,175.7,324,148,176
060610214033,375.0,170.8,170.8,382,192,190
060610213044,578.2,164.7,371.4,613,190,423
060610214012,753.7,261.4,433.8,459,181,278
060610214011,537.8,189.8,306.0,514,240,274
060610213043,872.1,234.4,585.3,744,263,481
060610212042,595.4,194.3,357.1,529,189,340
060610211031,459.8,142.3,279.0,454,194,260
060610211032,296.9,91.9,180.1,241,103,138
060610212032,1148.5,342.8,709.8,1097,415,682
060610212031,1294.4,420.6,764.9,1147,444,703
060610206021,957.0,301.0,582.5,947,331,616
060610212033,943.4,292.1,574.3,1041,379,662
060610212041,1000.3,328.3,602.4,1021,414,607
060610205013,675.9,236.0,390.5,690,280,410
060610206022,468.6,145.0,301.2,539,199,340
060610206023,435.1,134.9,278.8,507,194,313
060610205012,495.1,183.1,268.0,512,223,289
060610220021,510.9,177.3,298.4,593,300,293
060570005012,938.7,442.2,402.5,1007,564,443
060570007021,1287.8,559.3,621.4,1232,640,592
060570007013,703.5,365.1,280.9,805,436,369
060570007015,943.1,412.3,446.6,906,432,474
060570007011,576.5,244.6,272.0,570,310,260
060570007014,631.2,262.6,307.3,563,268,295
060570008011,915.0,536.5,270.5,1071,705,366
060610202004,264.6,70.9,169.4,266,107,159
060910100002,226.3,74.9,136.0,406,148,258
060570012064,409.8,276.7,102.1,248,176,72
060570012063,731.6,486.4,183.7,643,449,194
060570012053,292.9,194.1,74.8,285,205,80
060570012061,313.5,210.3,78.3,251,174,77
060570012065,559.7,376.6,141.9,589,392,197
060570012052,1066.2,679.6,296.5,1042,707,335
060910100001,349.6,139.1,189.4,455,191,264
060170305053,566.4,330.6,179.1,461,320,141
060170305052,392.4,209.1,139.4,322,197,125
060170305022,561.5,351.3,168.8,532,386,146
060170304023,363.6,225.7,110.2,317,216,101
060170305021,454.9,281.2,139.6,480,335,145
060170304025,243.7,141.5,80.9,178,131,47
060170305023,468.8,280.4,151.7,415,280,135
060170304021,132.5,72.1,47.2,151,107,44
060170309021,1214.6,404.0,736.0,1135,424,711
060170309023,944.0,324.1,549.2,840,305,535
060170309022,754.3,245.4,462.1,830,316,514
060170315021,1191.1,388.3,714.4,1130,440,690
060170315023,561.3,187.4,333.8,491,205,286
060770037002,294.4,153.9,129.0,316,189,127
060770021003,252.9,219.2,22.8,269,230,39
060770020003,286.3,219.5,54.9,367,279,88
060770027014,512.0,344.0,154.0,464,277,187
060770027011,176.4,107.6,56.2,155,86,69
060770027013,361.0,231.8,111.7,342,237,105
060770027012,181.5,116.6,56.2,199,133,66
060770027021,251.0,184.5,52.8,221,149,72
060770027022,276.2,200.9,62.2,248,184,64
060770027023,271.8,192.6,71.0,283,199,84
060770036023,357.2,129.5,204.3,329,131,198
060770032134,464.0,298.8,141.6,475,280,195
060770032162,359.6,229.0,103.7,438,273,165
060770032101,710.1,418.1,256.1,824,453,371
060770032141,448.2,237.3,183.5,518,291,227
060770032142,905.9,490.9,366.3,892,487,405
060770032131,378.2,240.9,117.0,334,229,105
060770032132,385.7,229.9,135.2,359,207,152
060770032172,396.0,245.0,120.0,410,276,134
060770032161,520.3,344.2,145.2,597,371,226
060770031091,321.2,190.4,106.5,285,194,91
060770032171,410.9,262.3,117.4,272,175,97
060770032032,971.0,482.0,427.0,924,491,433
060770032052,724.9,363.4,313.0,792,427,365
060770032051,399.0,177.2,193.3,428,188,240
060770032133,203.3,136.0,57.5,234,148,86
060770032102,455.6,245.5,184.2,428,242,186
060770032093,605.4,307.5,261.5,680,347,333
060770032084,432.8,256.2,148.8,457,291,166
060170317001,1495.0,621.2,770.5,1118,497,621
060170307092,1258.3,500.5,670.2,1322,587,735
060170307101,1305.4,521.1,690.6,1475,606,869
060170318001,378.3,181.6,172.9,314,146,168
060170307062,1731.3,737.0,869.7,1525,661,864
060170307061,1809.1,745.8,945.0,1645,725,920
060170307103,975.3,359.1,564.5,794,327,467
060670086001,622.6,204.8,385.4,604,214,390
060170307041,1811.9,624.8,1078.9,1344,457,887
060670085121,1009.2,474.7,479.6,928,419,509
060670085131,1177.0,608.3,493.3,360,158,202
060170307042,1552.1,672.6,795.3,1346,598,748
060670085083,1049.1,510.0,463.1,1265,547,718
060170308072,1090.1,418.2,576.8,967,368,599
060170308071,951.5,388.9,492.2,970,410,560
060170308091,437.3,145.9,252.0,452,186,266
060670085122,548.3,285.1,222.1,673,326,347
060670086004,379.1,122.3,238.9,301,101,200
060670094043,1651.0,499.2,1070.7,1452,483,969
060670086002,1717.8,600.5,1032.4,1894,640,1254
060670086003,1525.4,523.2,903.2,1382,523,859
060050003031,904.9,314.4,537.6,1014,465,549
060050003032,1581.6,479.5,1006.4,1516,527,989
060050003012,734.6,189.2,500.5,495,176,319
060050003041,809.8,276.9,481.0,801,332,469
060050005003,536.2,200.8,303.6,496,230,266
060770043022,668.2,263.6,371.8,694,281,413
060770043023,577.6,186.2,354.3,643,235,408
060770043021,400.9,173.2,197.1,372,189,183
060770043024,384.2,166.0,188.9,361,181,180
060770042041,319.4,139.9,155.3,243,119,124
060770042043,465.3,160.5,269.4,372,145,227
060770043031,680.4,234.7,399.6,712,269,443
060770042042,541.7,188.1,316.2,680,261,419
060770042014,374.0,125.0,230.0,429,172,257
060770042032,545.8,201.1,307.2,583,226,357
060770042011,437.2,145.1,262.8,590,228,362
060770042031,572.7,277.1,251.3,563,282,281
060770044043,241.2,153.6,66.0,184,123,61
060770044032,296.3,182.8,85.5,282,162,120
060770044022,578.7,305.6,243.4,473,237,236
060770044031,339.2,232.9,80.6,211,147,64
060770044042,173.0,118.8,41.1,163,124,39
060770045021,284.5,191.7,83.0,262,155,107
060770045022,217.5,153.5,57.8,157,95,62
060770045012,462.6,228.0,202.1,335,163,172
060770045011,402.8,157.1,223.5,461,178,283
060770046004,562.4,167.2,364.8,506,166,340
060770041052,1112.0,399.3,646.2,943,417,526
060770041041,1857.2,622.1,1120.6,2008,726,1282
060770041051,724.2,260.6,414.2,862,287,575
060770046003,529.3,136.4,370.8,547,150,397
060770041053,541.0,169.0,343.0,570,197,373
060670095021,834.2,301.1,476.7,615,236,379
060670095033,321.8,130.2,169.7,331,136,195
060670095023,462.3,206.9,221.0,406,203,203
060670095022,1156.2,458.7,607.6,1067,458,609
060670095024,483.4,218.7,228.6,435,214,221
060770042021,1002.7,298.8,655.6,1064,357,707
060670095041,608.0,282.8,288.1,595,298,297
060670095012,584.4,296.3,260.0,437,239,198
060670095031,353.2,156.4,172.2,284,145,139
060670095032,242.9,107.6,118.5,276,142,134
060670094072,1058.0,413.0,566.0,969,425,544
060670040082,676.6,494.8,149.3,724,513,211
060670040081,1182.8,854.5,270.7,1232,872,360
060670040043,1292.7,909.9,318.8,1179,801,378
060670040041,1097.7,702.9,333.6,1316,819,497
060670040042,1072.9,731.6,284.9,1093,724,369
060670040091,724.4,507.3,179.2,663,458,205
060670040052,935.5,666.6,222.6,986,652,334
060670040051,572.0,397.0,151.0,643,386,257
060670040103,530.9,387.4,119.0,519,362,157
060670040093,681.6,484.6,157.0,739,549,190
060670040102,813.8,585.0,182.9,843,583,260
060670040053,625.7,429.6,157.9,753,483,270
060670040092,534.6,367.1,134.9,416,290,126
060670040063,543.6,371.8,149.1,587,370,217
060670040064,557.4,381.2,152.9,605,397,208
060670040122,394.7,268.1,104.1,494,316,178
060670040101,890.5,655.4,189.2,825,622,203
060670040014,800.0,542.0,214.0,846,553,293
060670040013,953.2,659.9,234.8,968,614,354
060670034003,819.3,598.5,178.4,1056,668,388
060670034001,560.7,438.2,103.3,514,457,57
060670040062,707.0,520.8,148.2,695,510,185
060670039003,590.9,427.8,116.2,684,452,232
060670040061,511.6,370.9,99.4,375,300,75
060670040012,647.7,476.4,137.1,572,405,167
060670034002,686.2,506.5,143.9,686,484,202
060670040011,634.8,464.5,135.6,580,422,158
060670039001,522.3,373.3,113.5,605,433,172
060670039002,629.9,457.2,129.7,648,455,193
060670033002,820.2,611.5,151.5,680,513,167
060670033003,1010.6,748.8,212.9,974,656,318
060670096351,1230.4,813.3,346.6,1170,750,420
060670096352,997.6,656.7,282.4,897,586,311
060670096353,41.0,18.6,19.6,44,19,25
060670096382,175.1,64.7,99.3,220,61,159
060670096301,1509.2,1077.3,348.0,1013,708,305
060670096304,813.7,553.8,217.5,418,289,129
060670096302,747.2,522.3,176.9,570,388,182
060670096363,637.6,432.8,166.4,561,370,191
060670096362,918.7,615.8,254.0,696,468,228
060670096361,522.2,346.3,154.6,452,298,154
060670096303,541.4,345.2,165.4,543,352,191
060670096372,1025.7,693.8,267.5,693,467,226
060670096373,840.1,580.5,212.6,565,383,182
060670096324,503.9,331.9,146.1,444,279,165
060670096321,508.3,340.3,142.2,400,252,148
060670096371,374.4,250.6,97.3,291,197,94
060670096322,902.8,623.9,237.5,623,387,236
060670096323,711.7,498.7,182.2,1081,711,370
060670093091,882.8,336.2,473.4,889,379,510
060670093092,372.2,141.8,199.6,406,154,252
060670096221,349.7,215.6,119.5,209,152,57
060670096222,2077.0,1314.9,653.9,2093,1245,848
060670096191,401.0,268.3,112.6,310,212,98
060670096192,1635.9,1094.7,450.6,1476,964,512
060670096193,1272.2,852.1,345.8,1344,867,477
060670096223,611.3,408.4,168.7,484,327,157
060670096181,687.4,445.2,202.1,647,396,251
060670096171,651.2,370.5,242.7,410,254,156
060670096172,1398.7,760.9,552.9,1604,787,817
060670096364,654.7,433.4,196.1,446,283,163
060670096224,346.6,186.4,138.3,370,220,150
060670096151,598.4,393.5,166.2,626,395,231
060670096152,560.3,356.7,171.1,558,359,199
060670096153,929.9,618.6,255.5,854,537,317
060670096012,785.9,612.6,129.2,830,664,166
060670096013,742.1,578.4,122.8,782,619,163
060670096141,1059.3,733.3,255.8,1097,733,364
060670096103,532.9,403.8,93.3,529,404,125
060670096102,615.2,460.4,113.4,492,360,132
060670096332,411.1,333.7,60.8,373,305,68
060670096331,352.9,286.3,52.2,324,239,85
060670087033,1547.4,784.6,651.8,1484,756,728
060670087021,1016.8,520.7,445.1,1261,564,697
060670087022,744.9,381.8,326.5,857,400,457
060670080064,850.5,342.7,445.4,755,309,446
060670080063,897.7,429.7,408.1,940,440,500
060670080053,707.4,353.1,305.3,826,409,417
060670082041,1135.8,467.3,579.3,1202,513,689
060670080062,736.6,341.7,345.0,811,368,443
060670080061,923.3,410.9,439.1,910,423,487
060670082063,1030.4,407.0,528.7,919,410,509
060670080052,1430.0,666.0,657.2,1458,680,778
060670080051,546.7,278.4,245.6,574,284,290
060670082071,426.7,186.5,199.0,301,137,164
060670085041,452.5,230.8,186.3,268,134,134
060670085043,280.1,142.8,115.3,302,157,145
060670085042,1343.4,656.4,581.4,1436,710,726
060670085081,1192.8,645.1,456.5,964,498,466
060670085082,889.1,463.4,358.6,853,448,405
060670084031,873.1,399.0,406.9,622,309,313
060670085071,777.3,368.2,350.5,295,114,181
060670085072,781.7,386.3,331.3,795,389,406
060670085132,380.4,179.8,174.7,421,192,229
060670082042,1000.4,419.2,498.0,1041,433,608
060670082062,1126.4,446.2,583.7,1140,503,637
060670082032,1436.7,509.2,835.8,1461,550,911
060670081451,651.6,223.2,383.1,774,285,489
060670082061,393.5,155.9,201.3,370,177,193
060670074031,535.7,294.5,199.0,491,271,220
060670073011,652.1,359.2,234.4,612,369,243
060670073012,265.1,140.8,99.6,255,140,115
060670074022,605.6,318.4,234.3,692,365,327
060670074021,537.6,266.5,228.9,478,259,219
060670074023,361.8,188.9,145.3,392,226,166
060670074062,633.7,321.3,252.3,581,334,247
060670074063,513.1,264.7,204.8,471,253,218
060670074061,612.7,333.9,239.7,716,425,291
060670074172,623.0,295.5,285.6,608,338,270
060670074271,466.6,227.5,205.3,524,319,205
060670074273,1179.2,583.0,513.5,1141,622,519
060670074272,427.9,208.6,190.1,486,276,210
060670074261,378.9,191.5,157.6,363,218,145
060670074312,683.5,310.9,317.3,695,398,297
060670074311,618.1,279.0,287.8,620,330,290
060670074301,750.5,360.4,337.4,630,362,268
060670074302,979.4,489.6,428.0,1135,566,569
060610225002,1085.8,395.8,636.7,814,309,505
060610225001,889.6,430.7,417.6,691,334,357
060670094031,996.9,290.7,648.6,985,328,657
060670093102,593.4,257.2,290.0,711,317,394
060670093104,620.5,298.0,276.6,642,345,297
060670093103,773.0,338.0,376.1,780,377,403
060670093101,636.0,284.8,300.3,666,331,335
060670093251,484.9,167.5,297.1,472,155,317
060670093281,414.0,246.7,148.1,383,232,151
060670093282,1110.7,655.7,400.2,805,471,334
060670093283,495.3,283.6,182.7,362,200,162
060670094071,1131.0,483.0,567.0,979,479,500
060670094073,1681.4,694.5,884.5,1467,683,784
060670073013,109.9,59.9,32.2,133,71,62
060670094042,908.8,284.5,581.9,902,319,583
060670093105,529.6,223.7,266.1,418,207,211
060670093073,668.4,282.3,335.9,837,367,470
060670093072,997.0,556.0,394.0,876,482,394
060670093143,426.4,197.6,203.3,430,228,202
060670093142,1103.0,644.5,390.8,1053,590,463
060670093312,990.4,597.4,334.4,811,443,368
060670093313,1284.7,752.8,463.4,1013,614,399
060670093311,717.9,412.8,264.2,769,441,328
060670093224,717.1,488.3,194.0,706,438,268
060670093141,726.5,477.7,209.9,483,271,212
060670093112,1509.7,922.1,494.4,1411,813,598
060670093121,664.7,408.8,223.3,703,440,263
060670093122,1408.6,970.4,370.6,1121,719,402
060670093123,355.5,253.5,85.9,330,218,112
060670093111,798.0,464.9,276.3,790,439,351
060670093291,318.1,200.4,100.3,338,195,143
060670093292,463.5,292.0,146.2,348,233,115
060670093242,825.4,345.3,436.5,854,328,526
060670093241,573.6,243.0,298.4,538,205,333
060670093321,699.0,288.7,376.1,596,264,332
060670093262,503.7,282.2,195.7,615,311,304
060670093301,1853.8,1043.9,712.6,1440,699,741
060670093261,656.8,402.0,218.5,615,350,265
060670093263,756.4,363.6,352.9,932,463,469
060670088011,318.1,162.3,127.5,332,188,144
060670090052,201.0,106.0,80.0,206,111,95
060670094041,708.2,224.6,452.9,658,189,469
060670091111,832.1,482.8,282.8,818,522,296
060670091093,514.0,297.5,178.7,602,372,230
060670091112,585.9,396.1,154.0,517,363,154
060670091113,637.0,370.0,211.4,711,425,286
060670091121,701.0,448.9,203.3,715,450,265
060670091102,265.3,204.9,48.2,290,233,57
060670091101,169.7,131.1,30.8,121,103,18
060670091051,422.6,265.0,116.2,376,257,119
060670091052,354.9,222.6,97.6,362,242,120
060670091053,335.5,210.4,92.2,411,249,162
060670091062,606.6,383.8,183.3,747,433,314
060670091061,803.8,506.7,244.8,772,496,276
060670091082,518.4,292.3,189.9,539,277,262
060670091081,563.2,321.4,200.3,634,353,281
060670091092,764.4,432.2,271.5,833,492,341
060670091094,433.3,232.2,165.4,501,275,226
060670091063,480.7,297.5,151.9,497,306,191
060670091083,670.7,371.6,256.3,531,314,217
060670091122,639.8,372.7,215.1,701,429,272
060670091091,465.3,246.3,180.4,496,278,218
060670091031,714.5,402.3,251.1,675,366,309
060670091032,514.5,289.7,180.9,558,338,220
060670058033,682.0,387.1,256.3,660,355,305
060670058032,743.3,396.9,304.3,774,357,417
060670057025,602.5,349.6,208.1,567,319,248
060670057021,615.0,356.9,210.3,592,301,291
060670058031,889.8,465.1,370.4,1010,490,520
060670058013,901.5,515.0,320.1,959,510,449
060670058014,581.9,314.4,226.3,735,392,343
060670091072,1147.0,691.9,345.6,1138,737,401
060670058041,669.2,357.4,271.3,746,349,397
060670058042,1035.8,559.6,412.7,1019,578,441
060670090042,449.3,260.4,153.2,462,292,170
060670090051,834.0,490.0,278.8,832,526,306
060670090041,822.7,490.7,268.9,903,575,328
060670091071,404.1,222.9,148.6,492,271,221
060670089092,334.0,184.2,122.8,267,129,138
060670077023,1040.0,577.0,405.0,1092,529,563
060670090061,660.0,366.0,247.0,636,381,255
060670090062,726.9,433.5,238.4,709,454,255
060670090063,212.1,126.5,69.6,183,125,58
060670089091,535.1,300.6,194.2,710,405,305
060670089111,346.1,184.0,134.6,385,196,189
060670089102,792.9,422.0,309.9,715,423,292
060670078024,495.1,267.5,193.1,712,350,362
060670089101,574.6,290.9,244.1,631,341,290
060770010003,728.4,370.6,310.3,728,389,339
060770010002,499.1,267.0,208.5,495,303,192
060770010004,342.1,153.1,171.3,396,146,250
060770010001,408.3,228.3,150.9,440,264,176
060770031142,609.4,347.2,229.7,692,387,305
060770031082,625.8,361.9,226.0,509,316,193
060770031081,472.2,267.3,178.6,690,349,341
060770031083,474.0,280.9,157.1,475,312,163
060770031062,548.3,279.3,245.1,600,319,281
060770031061,778.9,358.8,390.0,945,462,483
060770031144,917.2,402.0,462.9,998,452,546
060770031143,986.8,436.0,494.1,1032,448,584
060770031063,427.3,230.7,181.9,363,208,155
060770031121,683.0,387.0,266.0,695,381,314
060770031094,660.3,349.9,272.2,743,409,334
060770031092,758.9,381.7,327.6,786,403,383
060770009004,228.5,165.8,49.8,311,224,87
060770009005,280.5,203.5,61.1,168,131,37
060770009002,380.9,258.7,98.6,353,239,114
060770011025,270.1,172.0,83.0,222,165,57
060770011023,216.0,139.3,67.2,280,173,107
060770011024,247.0,148.0,82.5,244,158,86
060770011013,549.2,325.6,196.7,573,345,228
060770011012,544.0,311.9,211.7,549,335,214
060770009003,369.1,223.5,121.6,381,260,121
060770009001,303.0,183.4,99.8,394,289,105
060770011022,362.9,211.8,126.6,385,217,168
060770011021,367.2,212.6,128.8,439,267,172
060770011011,629.6,357.8,223.4,708,444,264
060770012004,432.9,256.9,150.6,522,314,208
060770012001,758.5,465.6,246.8,525,322,203
060770012003,406.5,245.2,137.0,509,348,161
060770012002,331.2,205.3,105.5,627,384,243
060770031122,611.0,309.0,279.0,635,302,333
060770031133,328.3,232.8,76.6,435,275,160
060770031134,242.6,172.0,56.6,209,147,62
060770031132,312.1,221.3,72.8,226,175,51
060770004023,203.4,154.9,37.8,192,130,62
060770004024,441.1,313.7,102.4,354,257,97
060770004021,204.6,155.9,37.9,220,158,62
060770004022,177.4,135.3,32.7,119,91,28
060770013004,273.7,168.3,83.7,348,236,112
060770013001,420.8,267.7,124.9,329,225,104
060770013002,500.1,313.5,150.2,544,360,184
060770001003,83.4,62.2,15.0,29,22,7
060770007001,142.1,110.8,21.3,128,114,14
060770006001,124.9,105.2,15.8,65,56,9
060770001001,218.2,168.3,37.7,264,201,63
060770005002,178.4,130.4,40.8,81,63,18
060770005001,228.9,159.9,55.2,211,165,46
060770016001,211.2,154.5,44.8,179,122,57
060770015004,324.0,192.2,104.9,286,180,106
060770013003,404.6,254.8,129.7,499,316,183
060770014004,588.1,370.4,188.6,509,298,211
060770033081,266.9,180.3,73.6,398,263,135
060770033122,210.7,145.0,54.9,98,75,23
060770033123,143.0,95.9,39.9,54,33,21
060770014002,300.6,189.1,99.3,264,158,106
060770014001,259.2,159.6,88.3,295,168,127
060770014003,304.2,191.3,100.4,313,208,105
060770033051,349.5,214.4,115.4,412,251,161
060770033052,416.4,255.4,137.5,468,273,195
060770033132,240.2,174.9,50.9,199,165,34
060770033131,198.5,144.5,42.1,272,181,91
060770033121,128.6,93.6,27.3,146,104,42
060770034071,267.0,183.1,67.6,309,189,120
060770034072,306.0,209.9,77.4,266,186,80
060770034093,368.9,275.7,77.4,285,218,67
060770034092,417.7,312.1,87.6,362,262,100
060770034091,366.6,272.6,80.1,292,210,82
060770034101,498.7,386.8,93.5,444,299,145
060770034103,230.7,173.7,48.3,316,213,103
060770034102,603.4,466.0,115.0,562,383,179
060770019004,118.8,98.9,15.9,154,132,22
060770006002,145.1,123.1,16.4,145,117,28
060770019002,340.5,314.3,16.1,293,261,32
060770020001,226.4,194.4,22.6,325,287,38
060770020002,243.1,212.3,21.3,232,200,32
060770015003,391.2,251.7,105.2,405,260,145
060770018001,283.8,180.8,82.9,324,230,94
060770018002,365.9,253.4,93.9,440,309,131
060770016002,162.4,112.5,41.7,176,119,57
060770017003,165.5,135.1,25.1,158,126,32
060770019003,261.2,210.9,39.7,220,188,32
060770019001,249.9,201.7,38.0,292,254,38
060770051232,297.9,170.1,109.7,313,168,145
060770051271,1064.1,702.0,299.5,890,633,257
060770051272,640.5,425.0,179.9,431,309,122
060770038031,174.8,115.5,47.4,308,213,95
060770038032,650.7,433.4,179.9,268,202,66
060770038011,2323.0,1868.8,377.2,1743,1420,323
060770038013,746.0,574.1,138.4,551,428,123
060770008011,219.8,177.2,34.9,218,189,29
060770025042,453.0,373.0,67.0,421,350,71
060770008013,509.0,412.0,75.0,349,273,76
060770025041,442.0,374.1,53.7,402,310,92
060770025032,254.0,213.8,31.6,241,186,55
060770008012,667.0,548.0,96.0,586,448,138
060770034051,257.7,189.7,54.9,296,210,86
060770034053,264.2,194.5,56.3,203,138,65
060770034052,191.1,140.7,40.7,223,156,67
060770034043,465.0,273.4,169.6,381,277,104
060770034044,319.0,187.6,116.4,483,256,227
060770034042,199.6,146.9,39.9,227,163,64
060770034041,190.4,140.1,38.1,152,114,38
060770032082,1902.8,1025.1,769.4,1627,873,754
060770041061,388.2,122.2,252.1,316,112,204
060770035005,436.0,182.0,234.0,467,189,278
060770035002,600.6,238.0,337.5,646,282,364
060770035001,675.4,299.0,344.5,666,307,359
060770043052,1497.4,567.5,835.0,1520,600,920
060770043073,277.7,105.6,151.6,233,94,139
060770043071,702.6,257.4,403.2,614,250,364
060770043072,538.6,205.9,292.0,610,275,335
060770043082,526.2,301.4,193.6,318,180,138
060770043081,264.8,151.6,97.4,468,251,217
060770043051,889.3,335.3,495.0,843,327,516
060770043034,1091.9,324.8,704.0,1101,342,759
060770043033,324.6,125.3,174.4,317,116,201
060770043032,569.4,165.0,373.5,490,159,331
060770042015,700.0,224.0,429.0,738,281,457
060770042013,653.0,234.0,374.0,620,250,370
060770042012,591.9,196.3,355.8,432,189,243
060770031111,682.3,444.0,201.2,597,389,208
060770031112,654.7,441.0,172.8,731,486,245
060770031093,434.2,236.1,169.1,419,250,169
060770031101,424.7,208.6,185.9,535,286,249
060770031131,335.0,236.0,81.0,314,229,85
060770031103,411.7,276.0,112.7,336,232,104
060770031102,282.4,189.3,77.3,296,207,89
060770033053,496.3,307.0,156.5,562,309,253
060770033062,433.2,285.3,121.5,473,295,178
060770038023,1124.6,887.4,190.1,806,640,166
060770038022,326.7,247.2,63.4,255,191,64
060770038021,438.0,337.0,82.6,388,308,80
060770038012,501.0,364.0,120.0,417,307,110
060770025031,242.0,201.1,31.8,212,175,37
060770024021,256.7,218.8,29.7,281,226,55
060770024011,345.6,304.8,28.7,328,284,44
060770024012,262.3,223.6,27.4,264,219,45
060770007004,229.6,179.8,37.6,198,160,38
060770007002,185.0,144.2,27.8,158,120,38
060770007003,163.3,127.6,26.6,142,125,17
060770024022,188.4,160.2,20.5,199,165,34
060770024013,384.6,326.4,41.1,394,326,68
060770023003,273.4,228.7,31.5,227,193,34
060770023001,261.0,218.3,30.1,270,226,44
060770023002,243.0,203.2,28.0,224,194,30
060770028002,414.8,369.5,32.3,366,335,31
060770022011,240.0,215.0,20.0,246,229,17
060770022023,245.7,217.8,19.6,221,198,23
060770022022,321.7,254.6,54.6,310,262,48
060770022012,357.0,324.7,22.5,359,345,14
060770022021,301.2,256.4,35.0,256,211,45
060770021001,306.1,270.4,22.1,333,313,20
060770003002,153.4,121.4,24.8,196,151,45
060770001004,136.7,108.2,22.1,101,66,35
060770001002,184.1,130.5,42.5,168,123,45
060770004014,183.3,127.0,44.8,269,192,77
060770003001,294.8,204.3,72.0,246,171,75
060770004012,165.9,114.9,40.5,191,140,51
060770004013,454.2,310.2,117.2,509,366,143
060770004011,247.5,169.0,63.9,231,164,67
060770032083,547.3,303.4,209.2,538,314,224
060770032081,1652.3,992.5,566.8,1410,837,573
060770032053,353.1,170.5,151.6,369,204,165
060770032031,807.0,363.0,397.0,930,453,477
060770032091,521.5,258.4,229.6,610,302,308
060770032092,417.1,209.1,181.9,384,220,164
060770033071,406.1,269.4,115.0,515,344,171
060770033073,339.5,225.5,96.1,367,246,121
060770033072,386.4,254.1,109.9,394,274,120
060770033101,395.0,256.0,117.0,455,291,164
060770033102,765.0,540.0,196.0,688,474,214
060770033111,417.4,274.0,117.9,518,320,198
060770033112,368.6,242.0,104.1,349,232,117
060770033061,653.8,460.6,157.3,575,418,157
060770034061,421.6,306.1,98.2,367,272,95
060770034062,308.4,223.9,71.8,353,242,111
060770034031,313.0,230.2,70.8,296,190,106
060770034032,421.4,307.4,97.7,389,275,114
060770034033,420.7,290.4,112.5,437,266,171
060670047022,474.2,338.4,117.4,441,328,113
060670047011,315.9,224.8,78.7,425,267,158
060670047012,273.3,202.5,49.3,247,187,60
060670046012,296.2,228.7,53.3,215,158,57
060670046014,244.9,183.8,50.3,196,142,54
060670046011,190.3,148.0,33.6,274,192,82
060670046013,210.1,157.1,43.8,288,221,67
060670044013,295.4,222.5,50.3,314,231,83
060670044012,262.8,199.9,43.2,188,146,42
060670044014,229.3,166.1,46.8,260,188,72
060670096164,469.6,277.4,162.5,431,270,161
060670096163,1082.6,659.2,352.3,1102,605,497
060670096154,509.1,333.4,143.3,523,310,213
060670096162,347.5,193.7,133.8,358,203,155
060670096161,766.5,427.3,295.2,807,447,360
060670096143,836.5,571.7,219.1,638,442,196
060670096142,743.4,503.0,203.6,694,447,247
060670096121,1670.9,1061.3,503.5,1467,924,543
060670096122,626.8,375.9,212.7,523,326,197
060670096393,567.2,399.7,135.7,512,353,159
060670096155,719.8,507.3,172.3,590,414,176
060670096391,273.3,200.8,60.9,362,241,121
060670096392,297.8,218.8,66.4,209,155,54
060670096091,777.5,609.8,132.6,757,550,207
060670096092,577.9,451.5,100.6,577,446,131
060670096081,624.0,487.6,113.1,503,382,121
060670096082,1606.5,1262.1,271.7,1140,858,282
060670096101,413.9,318.8,67.3,340,280,60
060670096064,379.6,276.4,86.4,358,269,89
060670096063,837.7,625.1,176.8,867,678,189
060670096062,376.7,292.5,68.8,380,287,93
060670096112,1606.1,1067.5,436.2,822,515,307
060670096111,307.8,198.3,92.9,362,228,134
060670093082,1217.7,538.9,590.6,1310,601,709
060670093083,680.3,308.7,323.3,617,304,313
060670093081,708.9,357.5,287.5,651,346,305
060670093071,785.1,367.0,360.5,592,307,285
060670093231,1725.1,907.4,717.0,1299,653,646
060670093232,919.6,545.5,324.3,993,594,399
060670093221,1330.9,965.6,304.3,893,622,271
060670093222,1133.1,793.2,288.8,1082,706,376
060670093223,1005.4,649.7,310.4,966,610,356
060670093203,378.5,288.2,71.9,400,285,115
060670093201,401.5,313.6,69.7,388,292,96
060670093202,578.2,418.3,128.3,523,346,177
060670093211,795.3,565.5,186.9,828,566,262
060670093212,1100.3,792.3,252.8,1085,714,371
060670070181,485.7,380.0,73.3,483,361,122
060670071072,1250.2,848.2,316.4,1128,743,385
060670071071,307.2,198.7,86.6,278,174,104
060670070202,767.5,486.0,214.6,552,384,168
060670070162,1101.2,761.7,267.5,970,687,283
060670070172,601.0,453.6,111.8,515,382,133
060670070103,337.7,235.7,75.7,263,191,72
060670070102,696.5,486.1,156.2,640,444,196
060670070101,392.7,274.1,88.1,374,268,106
060670070111,761.4,554.7,147.4,699,524,175
060670070112,214.6,156.3,41.6,284,209,75
060670070113,723.4,525.7,151.2,590,425,165
060670070122,684.9,510.6,130.0,757,567,190
060670070152,601.9,424.3,138.4,570,407,163
060670071021,0.0,0.0,0.0,0,0,0
060670071031,901.3,661.0,191.0,675,493,182
060670071022,1436.3,1047.0,311.3,1148,787,361
060670071011,106.5,39.8,56.5,132,56,76
060670071032,612.0,450.1,129.6,458,356,102
060670070191,203.3,159.0,30.7,148,126,22
060670070182,1215.0,911.0,246.0,990,757,233
060670071062,1114.4,803.1,249.6,1108,762,346
060670071063,722.3,515.6,168.0,626,437,189
060670071023,1075.8,663.5,380.6,954,562,392
060670071041,1606.1,1141.7,359.5,1536,1093,443
060670071042,1407.2,981.0,346.3,1301,923,378
060670071024,1062.7,692.2,318.6,994,645,349
060670071061,448.2,321.9,99.0,471,333,138
060670071052,1032.2,746.9,226.4,806,574,232
060670071051,908.3,643.5,207.5,854,584,270
060670024002,954.2,717.9,189.5,954,684,270
060670024004,549.2,411.7,111.8,547,381,166
060670024001,1016.6,763.4,204.7,1001,696,305
060670024003,464.0,370.0,67.0,459,366,93
060670023003,675.6,532.5,105.1,677,523,154
060670023002,605.8,476.3,92.1,611,473,138
060670027001,410.8,339.7,50.9,257,217,40
060670025001,564.2,466.5,69.8,582,485,97
060670025002,556.6,462.8,68.1,581,471,110
060670026002,485.1,405.3,58.8,434,366,68
060670026003,507.2,423.7,61.4,493,424,69
060670026001,581.6,448.8,73.4,476,390,86
060670019003,742.7,587.5,90.8,670,571,99
060670019002,331.8,262.3,40.6,264,223,41
060670020001,310.1,248.3,33.5,228,184,44
060670018001,426.3,345.3,48.5,391,333,58
060670019001,532.3,428.2,63.6,416,365,51
060670018002,374.7,304.8,41.2,289,245,44
060670007001,527.9,395.6,92.6,193,153,40
060670011011,306.0,239.2,43.8,379,277,102
060670053011,123.0,103.2,14.9,151,119,32
060670006001,135.5,103.4,20.7,250,204,46
060670062021,265.2,164.2,83.9,254,172,82
060670012003,582.5,470.5,69.5,573,487,86
060670012001,719.6,579.9,90.1,604,488,116
060670012002,540.8,435.9,55.9,519,432,87
060670005001,579.1,466.2,58.2,508,447,61
060670005003,371.9,293.6,40.3,349,285,64
060670006002,225.9,178.4,24.5,144,117,27
060670053012,187.0,153.8,23.1,81,63,18
060670070072,245.2,177.1,54.6,185,133,52
060670013003,626.8,515.4,52.5,613,515,98
060670011012,574.8,462.0,60.4,485,402,83
060670013001,513.2,402.8,50.5,464,405,59
060670013002,523.8,411.2,51.5,525,454,71
060670004003,767.9,631.7,75.1,748,641,107
060670014003,614.5,501.2,62.7,602,504,98
060670004004,423.7,356.8,36.6,456,398,58
060670005002,608.5,514.8,48.5,524,454,70
060670027004,420.0,348.0,40.5,331,306,25
060670037001,581.0,482.6,69.9,427,370,57
060670027002,410.6,333.1,36.1,368,309,59
060670036001,502.5,390.0,75.1,513,397,116
060670028001,365.9,297.4,34.6,305,275,30
060670028002,223.9,182.2,21.4,170,153,17
060670027003,204.2,163.3,16.8,190,175,15
060670028003,354.0,294.0,39.2,365,328,37
060670018003,254.6,206.8,24.2,187,163,24
060670018005,573.5,466.0,57.6,570,473,97
060670018004,462.0,375.3,44.0,402,349,53
060670015003,459.4,350.1,73.7,424,348,76
060670015004,417.9,315.5,71.0,437,340,97
060670015005,781.2,610.3,116.4,723,571,152
060670015002,690.0,487.2,162.4,701,470,231
060670015001,514.5,380.0,103.6,496,345,151
060670044021,188.1,144.3,29.6,207,174,33
060670044023,246.7,194.6,36.4,178,159,19
060670044011,205.2,157.4,32.3,265,224,41
060670030005,487.8,369.6,91.8,460,351,109
060670030004,590.4,433.7,125.8,619,458,161
060670031023,303.1,212.1,72.2,238,170,68
060670029002,587.0,463.2,89.8,598,470,128
060670029001,779.0,614.8,119.2,709,572,137
060670017003,497.0,345.2,115.1,386,279,107
060670017004,361.5,250.1,84.7,443,324,119
060670017005,600.2,405.1,146.6,528,377,151
060670017001,777.1,594.9,124.5,756,601,155
060670017002,508.9,389.6,81.5,486,375,111
060670016005,772.2,489.3,214.7,754,496,258
060670016001,902.8,622.5,211.6,851,508,343
060670016002,608.6,440.6,128.8,632,445,187
060670014002,477.1,367.7,64.6,494,409,85
060670014001,342.9,264.3,46.4,322,256,66
060670004002,518.3,427.8,56.1,522,449,73
060670004001,335.4,277.1,36.0,338,289,49
060670003003,1075.6,817.5,201.7,1063,795,268
060670003001,517.4,396.8,91.4,543,389,154
060670069004,468.3,300.6,130.3,395,260,135
060670069005,433.7,278.4,120.7,499,311,188
060670002003,661.0,485.3,132.2,678,467,211
060670003002,476.8,366.8,82.3,485,381,104
060670002004,544.0,400.3,110.6,586,417,169
060670002001,481.2,354.1,97.8,455,340,115
060670002002,593.5,438.7,118.8,558,391,167
060670070143,650.7,502.6,104.3,662,529,133
060670070144,427.7,328.3,69.1,451,347,104
060670070114,215.9,171.7,28.4,143,118,25
060670070142,753.5,564.9,140.0,727,550,177
060670043001,466.7,371.4,69.5,489,425,64
060670043004,488.8,388.3,73.2,422,353,69
060670042011,268.3,226.8,30.1,247,200,47
060670042012,597.9,495.4,75.5,623,503,120
060670043002,588.6,498.3,70.3,598,529,69
060670042013,721.7,571.8,113.4,788,645,143
060670038004,293.0,227.5,48.1,415,351,64
060670038002,454.8,353.1,74.7,484,403,81
060670038003,259.5,201.5,42.6,241,207,34
060670038001,598.4,458.1,103.5,677,516,161
060670042022,411.6,358.4,37.9,461,402,59
060670042023,447.4,389.6,41.1,381,329,52
060670043003,470.3,381.3,68.7,547,460,87
060670096011,200.7,162.7,29.3,215,169,46
060670042032,587.0,487.4,72.4,466,385,81
060670042031,637.3,542.3,75.4,503,438,65
060670042021,552.7,475.2,64.2,600,507,93
060670045021,262.5,201.8,46.1,300,192,108
060670041003,621.5,481.5,104.3,479,385,94
060670041001,543.6,375.5,133.7,504,354,150
060670035021,522.6,371.1,119.5,606,445,161
060670035023,338.1,238.2,79.0,325,229,96
060670033001,686.5,512.5,125.9,794,545,249
060670035022,397.8,283.5,90.0,346,234,112
060670035013,364.4,273.1,64.0,251,202,49
060670035011,359.1,269.2,63.1,356,266,90
060670035012,522.5,391.7,91.8,605,428,177
060670041002,192.4,152.5,28.1,200,161,39
060670045012,218.8,168.5,36.1,127,98,29
060670045011,303.6,236.7,50.9,322,258,64
060670036002,271.7,210.2,41.1,222,181,41
060670037002,326.7,266.7,44.0,254,215,39
060670049033,334.4,284.3,30.3,308,269,39
060670049032,407.5,346.4,36.9,316,293,23
060670049031,754.0,601.3,112.9,726,564,162
060670049061,467.7,361.9,84.6,388,320,68
060670049062,328.3,254.0,59.4,346,248,98
060670049042,711.6,509.7,167.9,765,534,231
060670049052,613.6,486.9,100.7,408,343,65
060670049043,547.5,399.8,120.6,490,358,132
060670049053,412.2,324.9,71.5,416,295,121
060670096343,292.1,239.7,40.2,340,253,87
060670096342,201.1,165.0,27.7,217,178,39
060670096341,509.8,418.3,70.1,406,347,59
060670049041,633.7,426.5,169.3,604,404,200
060670050022,331.6,253.9,61.9,363,266,97
060670045023,290.4,227.7,45.9,415,307,108
060670045022,312.4,245.0,49.4,221,174,47
060670046022,115.8,87.8,21.2,173,136,37
060670046023,323.4,239.5,67.2,280,206,74
060670046021,366.1,278.6,65.2,403,293,110
060670044022,421.2,307.8,87.6,388,283,105
060670047021,601.0,457.0,121.0,588,442,146
060670046015,560.6,406.2,130.4,535,411,124
060670093191,554.2,407.7,117.2,631,449,182
060670093192,250.4,184.2,52.9,244,158,86
060670093193,384.3,283.3,83.2,323,224,99
060670093171,877.8,575.9,241.4,842,566,276
060670093173,781.0,510.0,216.2,814,527,287
060670093172,518.3,338.2,144.0,567,348,219
060670049051,579.8,463.5,89.1,779,617,162
060670096061,237.5,199.6,26.9,209,165,44
060670050021,440.4,337.1,82.1,456,334,122
060670048021,653.8,454.0,156.7,589,383,206
060670048012,293.9,233.8,45.0,395,317,78
060670050023,737.0,537.0,169.0,740,518,222
060670050012,677.6,513.0,135.3,502,385,117
060670050013,683.3,531.2,122.7,723,533,190
060670050011,599.1,423.9,149.1,793,521,272
060670048022,425.5,311.4,88.5,458,311,147
060670048013,317.2,258.0,46.2,335,260,75
060670048011,199.9,148.6,39.1,305,214,91
060670032022,586.5,422.6,125.9,536,374,162
060670032021,310.1,214.0,70.8,360,257,103
060670032023,289.2,199.5,66.0,361,224,137
060670031022,412.6,281.9,104.2,438,274,164
060670031021,302.3,206.5,76.4,298,194,104
060670048014,274.4,226.5,37.2,286,250,36
060670032032,352.5,288.9,48.5,297,220,77
060670032031,239.6,196.4,33.0,234,190,44
060670032041,349.8,267.7,64.4,381,281,100
060670032043,328.7,251.5,60.5,298,237,61
060670032042,207.6,158.8,38.2,187,137,50
060670031012,243.3,171.9,54.7,205,138,67
060670031014,235.5,166.4,52.9,203,147,56
060670031013,314.7,222.3,70.7,312,223,89
060670093181,589.0,423.0,139.0,584,400,184
060670051011,483.4,328.7,128.4,465,332,133
060670051012,619.6,421.3,164.6,646,453,193
060670093161,658.3,447.9,174.1,759,485,274
060670093162,583.5,422.0,127.3,398,298,100
060670054022,396.8,288.7,76.5,418,311,107
060670054021,633.1,399.2,183.6,479,316,163
060670055061,312.3,214.4,66.3,334,244,90
060670001001,1231.0,801.0,342.0,1232,817,415
060670054043,323.7,192.8,110.0,428,232,196
060670054045,452.8,264.2,159.0,576,306,270
060670054044,762.5,480.3,225.4,701,424,277
060670055082,692.5,483.1,156.3,604,453,151
060670055103,599.3,437.2,112.4,649,463,186
060670055081,305.1,212.9,68.9,328,226,102
060670055091,535.1,369.3,117.5,302,233,69
060670055092,93.8,63.8,21.4,225,174,51
060670055023,587.7,413.9,134.6,524,391,133
060670055101,428.0,310.0,78.6,455,349,106
060670055102,270.5,202.2,44.9,318,254,64
060670055062,387.3,266.0,82.2,468,322,146
060670055052,341.8,251.6,64.4,230,167,63
060670055053,455.2,299.6,119.7,475,337,138
060670052042,491.5,309.9,153.3,461,293,168
060670052043,623.6,350.8,223.0,667,376,291
060670052041,279.0,188.9,67.9,432,247,185
060670052052,535.4,362.6,130.3,593,405,188
060670052022,682.6,398.0,231.4,660,385,275
060670052021,820.5,532.4,225.1,985,606,379
060670052044,455.7,255.6,163.4,427,237,190
060670052045,375.7,210.8,134.7,394,227,167
060670055083,435.8,287.7,117.2,512,345,167
060670056061,549.0,295.0,227.0,557,297,260
060670054042,611.8,333.9,246.4,626,309,317
060670056051,603.0,381.0,175.5,569,384,185
060670056062,561.0,354.0,163.5,634,439,195
060670056014,634.6,423.3,176.9,639,403,236
060670056013,313.7,208.6,87.9,378,238,140
060670054041,874.0,490.0,324.0,920,458,462
060670057023,759.0,431.2,266.5,760,451,309
060670057022,665.0,377.8,233.5,689,362,327
060670056052,568.6,352.2,172.2,565,361,204
060670056063,390.7,242.0,118.3,446,284,162
060670056064,354.8,219.8,107.5,388,219,169
060670057024,443.3,257.4,157.7,438,233,205
060670057012,457.9,230.0,198.1,464,214,250
060670057011,720.1,399.5,263.3,771,412,359
060670057013,594.0,335.5,209.5,575,320,255
060670055021,204.1,133.3,58.5,158,116,42
060670062022,485.5,308.5,144.6,471,300,171
060670055022,505.9,333.4,142.7,624,401,223
060670063001,329.8,213.9,98.1,326,206,120
060670063002,333.3,216.2,99.1,356,226,130
060670063003,251.9,168.7,67.4,214,135,79
060670062023,158.4,108.3,40.4,125,85,40
060670055051,601.5,350.5,201.7,681,409,272
060670074133,407.6,199.5,176.7,395,197,198
060670062012,493.7,318.5,139.1,572,363,209
060670062014,533.3,323.9,169.4,494,298,196
060670065004,361.7,300.8,44.2,285,254,31
060670065002,320.3,267.5,38.1,380,347,33
060670064005,249.1,169.0,61.2,214,150,64
060670064004,228.2,154.9,56.1,226,154,72
060670064003,185.8,126.1,45.7,217,136,81
060670064002,319.4,162.0,127.1,264,144,120
060670064001,293.6,149.0,116.9,288,161,127
060670061021,392.2,228.1,135.4,389,230,159
060670062013,617.1,358.9,213.0,623,374,249
060670056012,501.5,294.5,172.6,530,314,216
060670056011,415.2,245.2,142.1,448,273,175
060670061023,318.8,191.2,107.4,410,219,191
060670061022,593.5,356.0,199.9,571,332,239
060670062011,302.6,177.8,100.3,188,131,57
060670061011,488.2,286.8,161.8,580,322,258
060670061012,663.9,371.6,248.6,717,428,289
060670061013,415.1,232.4,155.4,453,279,174
060670060024,388.2,221.0,129.1,409,243,166
060670060023,377.8,215.1,125.6,451,277,174
060670060025,475.9,270.9,158.3,418,250,168
060670060043,328.2,156.9,147.2,430,217,213
060670060041,335.9,198.2,109.8,412,231,181
060670060042,424.3,225.4,165.8,614,324,290
060670060022,538.0,317.4,175.8,311,195,116
060670060032,757.3,435.9,263.4,670,368,302
060670059013,1542.3,836.8,587.2,1539,806,733
060670075041,350.1,158.3,164.1,421,192,229
060670060031,770.0,444.0,271.0,729,393,336
060670074132,600.7,314.8,246.0,601,342,259
060670074131,445.1,229.0,191.3,406,241,165
060670074241,478.1,255.5,185.4,469,305,164
060670071053,651.2,459.5,144.9,467,320,147
060670072082,749.8,281.9,426.2,697,304,393
060670072083,567.4,210.0,324.3,505,240,265
060670072081,261.7,99.8,148.0,300,122,178
060670072091,571.1,222.3,320.6,558,267,291
060670072092,700.4,259.7,404.1,661,285,376
060670072021,485.2,187.6,266.9,449,201,248
060670072061,650.1,206.9,396.9,676,276,400
060670072072,490.3,180.3,271.1,384,148,236
060670072071,580.5,177.8,363.3,480,172,308
060670072062,962.6,331.7,555.6,723,285,438
060670072073,531.7,181.8,308.7,475,193,282
060670072022,433.1,170.9,234.1,419,206,213
060670072023,368.3,139.6,205.0,347,154,193
060670074171,344.8,126.6,189.1,400,203,197
060670074262,299.7,149.9,128.6,362,217,145
060670058011,509.0,284.6,184.5,524,282,242
060670058012,847.6,447.0,340.1,752,427,325
060670059041,424.3,220.2,169.4,486,259,227
060670059043,467.2,246.5,187.3,539,291,248
060670059042,509.3,265.2,203.5,493,261,232
060670059032,255.3,134.8,98.8,307,175,132
060670059031,644.7,344.0,244.5,464,275,189
060670060021,360.7,169.2,165.4,308,165,143
060670059044,912.2,488.4,354.5,934,499,435
060670075042,434.0,213.2,187.3,436,217,219
060670059011,1004.5,474.8,453.2,1081,549,532
060670059012,722.0,355.6,315.2,873,383,490
060670074242,351.1,187.6,136.2,449,276,173
060670075032,656.6,351.0,253.8,719,461,258
060670075033,161.8,85.7,62.3,143,72,71
060670075034,364.7,193.3,140.4,440,205,235
060670075015,511.0,312.0,141.0,467,309,158
060670075014,469.1,253.2,182.2,304,178,126
060670075031,157.2,82.7,66.1,252,136,116
060670077021,948.4,532.4,363.1,1060,544,516
060670077022,396.6,222.6,151.9,320,169,151
060670077015,661.0,344.9,268.9,574,300,274
060670077014,362.6,176.5,158.0,376,215,161
060670077013,332.2,161.7,144.8,322,183,139
060670089112,303.2,186.3,96.2,175,128,47
060670078023,747.9,415.9,283.1,635,370,265
060670077012,777.9,387.3,330.1,748,418,330
060670076023,619.4,308.1,266.6,697,373,324
060670077011,404.9,205.9,163.8,434,237,197
060670076024,369.2,187.5,151.9,378,211,167
060670076021,559.2,290.2,222.7,463,227,236
060670076022,561.4,287.9,231.9,572,299,273
060670078022,445.6,236.0,177.3,476,271,205
060670078021,612.6,324.4,243.8,573,307,266
060670078011,772.7,391.0,324.8,586,324,262
060670078012,699.9,351.8,299.2,808,408,400
060670076011,802.0,415.8,320.4,813,438,375
060670076013,863.6,436.5,366.9,748,391,357
060670076014,543.8,293.0,210.6,621,320,301
060670076012,725.6,396.8,260.2,674,405,269
060670081172,463.8,226.5,207.2,504,273,231
060670081332,422.1,206.6,188.8,375,218,157
060670081331,444.7,219.3,194.4,411,235,176
060670079052,1023.2,507.3,451.3,1160,580,580
060670079062,558.6,268.8,249.0,495,277,218
060670079061,1298.8,632.3,561.5,1362,692,670
060670079034,577.8,267.5,267.5,521,256,265
060670079035,531.9,244.3,248.7,596,296,300
060670079032,518.2,237.7,240.8,503,273,230
060670070121,772.8,588.7,133.8,750,584,166
060670070041,663.5,535.6,83.7,582,493,89
060670070042,845.4,613.9,175.9,725,543,182
060670070132,564.0,419.1,105.7,490,387,103
060670070131,487.8,367.7,91.0,513,370,143
060670070043,496.0,372.2,93.1,438,345,93
060670070141,431.0,319.7,87.4,531,383,148
060670070071,702.0,521.6,141.8,731,569,162
060670070012,194.2,139.9,43.6,169,113,56
060670070013,201.2,145.0,45.2,139,109,30
060670070011,468.4,350.3,89.4,394,277,117
060670068001,466.8,352.3,87.1,442,339,103
060670070073,661.5,505.4,122.9,620,463,157
060670071064,609.0,400.0,177.6,542,343,199
060670067025,275.9,224.5,35.0,306,273,33
060670067021,373.3,303.7,47.3,292,240,52
060670067024,257.8,209.7,32.7,299,270,29
060670068003,271.5,206.9,49.8,197,144,53
060670068002,361.7,276.2,66.2,300,231,69
060670069002,272.8,192.4,59.0,270,204,66
060670068004,259.9,183.3,56.2,147,106,41
060670069003,199.2,140.5,43.0,159,131,28
060670069001,147.2,103.8,31.8,209,140,69
060670066004,212.7,153.1,45.1,177,111,66
060670063004,178.5,122.8,43.2,175,112,63
060670066005,278.4,191.8,67.1,206,144,62
060670067023,254.4,198.9,42.5,197,163,34
060670066002,252.5,188.7,47.0,212,178,34
060670066001,262.6,196.2,48.9,255,221,34
060670066003,236.3,176.5,44.0,238,159,79
060670067012,691.4,491.8,160.4,705,481,224
060670067011,535.0,398.6,111.4,476,383,93
060670067013,356.8,243.5,90.1,345,243,102
060670072041,943.5,589.3,297.2,901,607,294
060670065003,263.2,217.2,34.0,289,267,22
060670067022,350.4,289.1,45.2,270,230,40
060670067014,496.8,351.1,120.6,411,314,97
060670065001,199.7,141.2,48.5,193,117,76
060670065005,292.5,206.7,71.0,331,204,127
060670072042,585.3,322.8,231.0,556,312,244
060670030003,743.8,533.1,172.7,675,465,210
060670029003,399.7,294.4,73.8,426,314,112
060670029004,689.5,491.1,142.2,737,514,223
060670030002,474.0,311.6,120.7,500,338,162
060670016003,594.6,426.6,128.8,542,400,142
060670016004,451.0,323.5,97.7,452,333,119
060670052012,510.1,404.1,68.1,380,317,63
060670052011,265.8,210.5,35.5,366,313,53
060670054031,626.4,425.4,166.8,762,462,300
060670054032,800.6,543.6,213.2,696,411,285
060670001002,595.2,418.5,142.6,601,411,190
060670001003,502.8,353.5,120.4,477,326,151
060670074321,764.1,349.5,351.7,764,385,379
060670074322,942.9,435.5,436.3,975,514,461
060670074212,1579.9,716.8,753.0,1387,667,720
060670074211,1025.2,497.2,452.5,1141,588,553
060670081313,283.7,141.7,119.2,441,248,193
060670081311,329.2,148.4,153.1,329,158,171
060670081314,551.9,257.3,256.6,466,247,219
060670075011,470.7,223.5,208.1,488,282,206
060670074222,306.0,154.7,127.4,243,150,93
060670081302,617.0,272.3,301.4,639,317,322
060670081303,369.2,174.1,167.2,455,229,226
060670081301,392.4,165.2,200.6,447,202,245
060670081343,718.7,340.2,316.6,682,401,281
060670081342,892.7,417.8,413.8,659,341,318
060670081171,345.7,168.8,144.5,362,203,159
060670081312,739.1,326.2,374.5,807,387,420
060670081352,577.2,262.4,269.3,493,272,221
060670081341,474.5,208.3,226.4,580,268,312
060670081351,336.8,153.1,157.1,351,203,148
060670081321,825.5,341.6,436.5,976,442,534
060670081322,940.0,386.0,488.9,937,411,526
060670081113,681.7,269.7,359.4,696,320,376
060670074213,882.8,453.0,370.5,685,344,341
060670081292,674.8,300.3,321.3,595,298,297
060670081291,632.6,281.5,301.2,691,324,367
060670081271,709.3,319.1,329.3,725,380,345
060670081272,1004.0,413.6,513.5,944,453,491
060670081131,989.7,386.2,524.2,767,378,389
060610209081,615.6,235.4,340.2,530,218,312
060610210351,787.6,338.1,387.0,882,429,453
060610210353,1005.4,425.6,505.0,904,363,541
060610210352,1563.0,707.0,748.0,1369,643,726
060610210402,1126.1,504.2,582.9,1077,481,596
060610210403,943.4,391.1,523.5,1019,458,561
060610210392,565.1,236.5,314.4,662,261,401
060610210391,854.4,407.2,430.2,901,395,506
060610210401,686.6,285.0,382.7,798,347,451
060670080101,345.9,164.3,153.8,468,206,262
060670080104,732.9,345.1,328.3,698,370,328
060670080103,722.0,326.1,338.8,797,386,411
060670080071,676.3,295.6,320.0,847,375,472
060670080072,849.7,371.4,402.0,710,328,382
060670089082,738.8,393.8,285.5,786,432,354
060670089072,486.5,255.9,190.5,461,276,185
060670089071,347.1,195.8,123.1,333,193,140
060670089083,391.0,194.0,183.0,401,180,221
060670087032,646.9,328.0,272.6,483,282,201
060670089123,399.5,203.5,166.6,455,233,222
060670089121,439.7,224.0,183.2,436,226,210
060670089122,659.9,338.2,270.9,691,386,305
060670087031,997.0,509.0,441.0,996,437,559
060670080094,540.5,275.5,217.3,646,352,294
060670080093,745.0,385.2,291.5,695,403,292
060670080083,817.5,388.9,366.9,774,366,408
060670080082,814.2,370.5,389.2,873,421,452
060670081392,546.9,290.8,205.4,721,391,330
060670080092,539.6,260.6,238.1,475,243,232
060670080091,541.9,261.7,239.1,596,298,298
060670080081,900.3,396.6,448.8,849,396,453
060670074032,642.6,353.8,234.0,714,398,316
060670074231,451.2,280.3,140.0,561,397,164
060670074232,551.6,370.3,139.8,297,219,78
060670074024,337.9,176.2,136.6,387,232,155
060670074064,307.0,168.0,120.0,370,216,154
060670074141,654.0,324.1,282.9,567,328,239
060670074281,488.0,241.9,211.1,638,358,280
060670074292,284.6,159.6,104.2,388,212,176
060670074291,487.6,273.4,178.5,426,254,172
060670074293,445.9,250.0,163.3,406,245,161
060670074152,661.6,356.9,258.4,807,419,388
060670074162,649.6,341.7,261.3,672,383,289
060670074161,753.2,380.0,317.8,692,383,309
060670075013,246.2,114.8,110.2,302,170,132
060670075012,323.1,150.7,144.7,361,192,169
060670074142,519.0,253.6,229.7,541,312,229
060670074282,542.5,255.3,251.0,601,310,291
060670074151,505.9,256.7,212.6,598,310,288
060670074303,875.6,449.4,374.4,741,447,294
060670074333,768.3,404.1,323.1,664,340,324
060670074332,872.0,428.5,384.5,874,465,409
060670074331,714.7,348.3,316.9,701,404,297
060670074221,504.5,233.1,238.3,416,239,177
060670081421,671.9,289.2,338.3,637,313,324
060670081422,397.2,171.3,195.8,472,245,227
060670081431,883.3,353.8,463.9,768,348,420
060670081432,575.2,196.6,338.8,602,223,379
060610207141,1097.8,405.2,617.8,1068,454,614
060610207142,977.8,381.6,526.0,1108,499,609
060670081391,507.8,272.7,187.0,384,209,175
060670081382,427.5,214.8,171.3,579,270,309
060670081381,282.1,148.8,107.0,282,132,150
060670081442,1067.6,461.0,525.4,908,402,506
060670081202,543.0,233.0,271.4,693,344,349
060670081203,472.6,231.8,204.0,321,179,142
060670081201,689.4,257.2,387.6,728,327,401
060670081221,428.8,165.4,232.6,496,199,297
060670081222,830.0,320.8,449.3,866,387,479
060670081223,406.6,168.7,200.4,352,171,181
060670081456,520.2,190.6,289.4,531,220,311
060670081455,589.5,206.0,336.9,597,241,356
060670081452,624.5,226.0,352.5,600,265,335
060670081454,708.6,261.8,398.9,694,299,395
060670081453,380.0,135.2,215.1,366,152,214
060670081441,347.2,130.7,194.7,341,150,191
060670081242,763.0,313.3,396.4,868,356,512
060670081241,1422.4,553.8,781.6,1475,594,881
060610207151,665.6,250.9,366.0,752,340,412
060670081252,488.7,185.2,264.4,438,186,252
060670081251,1128.2,427.5,624.8,1181,505,676
060670081253,841.6,318.9,466.9,809,338,471
060610207152,835.3,289.6,495.9,796,279,517
060610209082,781.2,334.5,377.6,757,394,363
060610210452,397.9,163.8,203.7,260,115,145
060610210463,994.5,420.8,494.7,808,363,445
060610208053,385.0,184.6,158.6,356,186,170
060610210383,736.8,301.5,367.3,679,319,360
060610210381,454.8,186.9,232.1,577,252,325
060610210382,1014.7,424.0,514.0,990,450,540
060610210371,975.9,410.9,502.3,998,449,549
060610210384,1215.8,513.8,605.9,1334,556,778
060610209084,465.6,196.0,234.6,419,195,224
060610210442,979.9,377.2,535.6,1034,422,612
060610210443,943.7,393.0,494.2,930,419,511
060610210432,1008.3,383.2,561.3,965,411,554
060610210431,642.4,236.6,364.7,761,299,462
060610210441,717.6,296.4,377.3,630,264,366
060670081194,488.3,201.4,239.8,523,253,270
060670081193,393.5,164.0,199.1,446,203,243
060670081195,359.7,147.0,181.3,445,213,232
060670081192,648.0,274.9,328.5,595,279,316
060670081354,556.7,239.8,277.3,520,260,260
060670081191,601.2,249.4,302.7,505,279,226
060670081353,410.2,181.0,198.5,500,252,248
060670081114,642.7,280.2,314.5,641,300,341
060670081362,625.8,285.1,301.4,822,400,422
060670081361,407.5,185.6,196.3,319,144,175
060670081372,495.5,217.7,244.8,450,218,232
060670081383,544.0,239.8,267.5,650,315,335
060670081371,464.6,200.7,234.5,385,189,196
060670081411,343.0,148.2,173.1,407,205,202
060670081415,469.1,225.8,198.2,343,208,135
060670081414,453.1,214.4,196.5,273,151,122
060670081413,303.2,123.1,159.6,293,134,159
060670081401,543.5,226.9,278.9,640,292,348
060670081402,606.3,251.4,313.1,555,247,308
060670081412,509.4,206.8,268.1,470,230,240
060670081111,648.8,264.5,329.0,601,267,334
060670081112,803.2,308.8,434.5,827,375,452
060670081132,339.5,142.3,168.7,377,169,208
060670081281,439.9,171.6,240.3,440,223,217
060670081282,462.3,180.7,252.0,442,195,247
060610208051,898.0,352.0,470.0,978,417,561
060670079031,350.0,153.5,168.5,465,215,250
060670079033,296.1,130.6,141.9,375,192,183
060670079042,745.7,336.2,352.0,739,376,363
060670079043,619.5,284.3,289.7,586,253,333
060670088012,1397.9,668.1,617.1,1237,658,579
060670090071,310.2,198.8,90.2,325,240,85
060670090072,358.8,227.2,106.8,315,212,103
060670090081,377.0,210.5,142.4,439,277,162
060670090083,465.0,259.5,175.6,344,218,126
060670090082,391.8,206.8,146.5,476,281,195
060670089053,489.2,254.5,186.5,488,283,205
060670089052,685.1,341.5,272.6,591,309,282
060670089051,560.0,273.2,227.4,590,313,277
060670090112,735.8,361.2,329.4,547,301,246
060670090111,1120.7,553.8,498.2,773,390,383
060670090101,777.2,508.3,218.0,524,343,181
060670090102,425.2,283.2,111.8,452,258,194
060670090103,236.0,157.2,62.1,245,174,71
060670089131,389.0,174.5,181.2,370,168,202
060670089132,510.4,229.0,237.8,619,332,287
060670089133,608.5,309.3,248.7,662,359,303
060670078014,659.0,315.8,298.1,625,303,322
060670078013,457.9,223.1,205.0,494,243,251
060670089081,848.7,397.9,381.6,722,362,360
060670089073,406.5,197.1,170.6,425,226,199
060670089074,327.5,158.9,137.4,385,205,180
060670079051,1067.0,526.8,468.1,1099,527,572
060670079041,626.6,262.5,312.4,699,371,328
060670079044,419.1,192.4,190.5,378,177,201
060670080102,773.2,337.5,375.1,659,306,353
060050004012,427.6,176.1,222.3,385,194,191
060050004014,467.0,175.4,266.5,594,240,354
060050004013,852.3,317.5,486.7,833,396,437
060050005002,520.5,176.1,313.3,498,206,292
060050005001,672.6,223.7,408.6,593,258,335
060050004023,458.2,164.2,261.5,473,222,251
060170315041,702.7,220.2,425.3,861,373,488
060170315044,854.0,281.7,510.1,825,357,468
060170310001,272.7,128.1,122.2,300,156,144
060610216042,1181.6,412.1,708.4,1117,412,705
060610216041,777.1,249.4,486.6,749,250,499
060570001024,778.4,330.3,405.4,902,418,484
060570004021,833.7,287.0,488.3,782,309,473
060610218022,1273.5,536.0,653.2,1222,541,681
060610216031,748.7,283.1,426.8,1205,516,689
060610216033,469.0,165.0,281.0,457,198,259
060610216032,416.6,181.5,210.2,140,86,54
060610218021,598.8,218.6,348.9,708,323,385
060610218013,408.9,153.1,233.8,390,131,259
060610218012,1129.2,389.4,670.9,1081,407,674
060610218011,1015.5,356.1,602.4,1038,441,597
060610218014,364.5,111.0,231.6,363,115,248
060610219021,1132.4,433.2,619.6,1123,511,612
060570001033,487.4,162.5,295.7,547,179,368
060570001031,446.1,136.0,285.1,501,199,302
060570001032,890.7,343.0,490.7,805,343,462
060570001023,1203.1,476.3,639.5,1252,549,703
060570001021,748.6,305.8,395.4,912,360,552
060570001022,1017.9,403.1,542.1,1007,433,574
060570001042,815.3,331.1,426.1,837,352,485
060570006001,534.4,268.2,204.6,520,292,228
060570005011,499.8,246.1,206.7,532,294,238
060570005022,489.4,226.9,214.4,494,284,210
060570006003,862.1,378.1,401.9,904,446,458
060570007022,1147.5,496.2,552.8,1115,566,549
060570006005,611.1,312.3,240.6,591,360,231
060570006002,385.9,187.9,159.1,317,191,126
060570006004,367.9,183.0,149.9,257,158,99
060570001041,498.8,207.9,255.7,495,218,277
060570005021,432.6,239.2,146.1,473,276,197
060570005014,493.6,262.9,176.9,538,303,235
060570005015,320.3,178.4,106.4,274,157,117
060570008021,830.4,539.8,202.3,651,463,188
060570008022,1380.3,905.7,329.3,1279,922,357
060570008023,474.7,250.7,185.8,534,278,256
060610220022,1454.6,506.7,819.7,1557,725,832
060070025001,120.5,48.3,62.7,165,89,76
060070028003,354.2,149.3,176.0,302,185,117
060070028005,189.7,80.0,94.3,183,89,94
060070028002,214.7,88.1,110.4,186,112,74
060070028004,164.5,69.3,81.7,167,83,84
060070030012,180.5,75.7,91.1,143,89,54
060070030014,162.7,77.1,70.2,113,67,46
060070030011,194.3,80.7,96.1,338,165,173
060070030024,312.7,99.6,188.5,125,70,55
060070030013,186.4,89.4,79.3,133,80,53
060070028001,216.3,86.3,115.0,202,96,106
060070027004,303.4,97.7,183.6,298,114,184
060070027001,299.1,94.6,184.0,370,151,219
060070027005,473.5,163.2,276.1,508,230,278
060070027003,273.1,80.5,172.3,268,113,155
060070027002,402.7,126.8,247.6,327,124,203
060070031004,510.8,157.6,318.3,513,208,305
060070030023,245.2,73.8,151.3,222,105,117
060070027006,355.6,104.0,225.7,328,144,184
060070031002,440.1,127.4,283.1,444,166,278
060070031003,322.4,93.7,206.6,321,136,185
060070026021,596.0,175.5,389.1,680,257,423
060070031001,657.3,172.8,446.0,640,218,422
060070026013,465.8,115.4,317.5,450,154,296
060070025003,236.3,97.5,120.2,130,72,58
060070025002,324.4,128.4,172.7,292,164,128
060070026023,437.6,127.6,288.5,404,128,276
060070026012,442.8,128.6,290.6,448,171,277
060070026011,297.1,72.4,207.7,231,81,150
060570001037,810.8,293.3,472.3,775,258,517
060570001035,1047.5,378.9,610.1,981,358,623
060570001034,439.2,158.9,255.8,403,137,266
060570001036,495.4,155.3,312.7,564,203,361
060610219011,732.5,283.1,391.3,750,356,394
061090051004,612.8,223.9,348.9,659,266,393
061090011003,571.7,219.1,315.2,742,335,407
061090011001,496.1,191.3,272.5,616,287,329
061090011002,435.2,171.5,235.7,425,212,213
061090011004,241.8,110.8,116.4,245,151,94
061090012002,544.2,236.1,275.7,514,264,250
061090012004,157.1,71.5,76.5,184,102,82
061090012003,491.4,229.1,220.4,414,233,181
061090041001,633.7,276.9,318.2,613,288,325
061090041002,569.7,207.5,332.4,483,213,270
061090051006,563.9,166.8,364.2,519,198,321
061090041003,1122.6,336.2,722.8,812,333,479
061090042002,1501.6,665.9,745.6,1432,694,738
061090022006,424.0,136.1,261.5,609,251,358
061090022005,790.1,264.4,484.0,833,331,502
061090032001,722.8,233.3,443.7,737,322,415
061090032002,321.9,115.4,184.6,314,132,182
061090022004,729.8,261.4,411.7,688,326,362
061090032005,444.8,142.1,264.9,359,168,191
061090032006,309.3,98.8,184.2,270,115,155
061090032003,478.2,163.9,279.5,463,211,252
061090031002,704.8,255.0,416.5,701,354,347
061090022003,466.6,164.9,280.4,362,164,198
061090022002,297.0,109.2,169.2,229,111,118
061090031001,610.9,242.8,336.1,642,300,342
060650451241,681.3,279.3,377.1,652,299,353
060650451251,1341.1,554.7,733.4,1430,507,923
060650451092,855.5,491.5,321.0,855,494,361
060650451202,877.0,491.8,342.4,629,392,237
060650451091,638.1,357.7,249.2,558,318,240
060650451102,617.8,345.7,241.7,545,338,207
060650451101,1293.6,720.5,509.7,1067,646,421
060650451151,936.6,422.2,478.2,1160,488,672
060650451141,454.1,199.6,236.8,621,288,333
060650451142,496.1,207.9,268.4,434,157,277
060650451161,673.0,330.9,313.4,594,313,281
060650451171,802.9,399.3,368.9,786,376,410
060650451172,1021.4,506.3,470.9,826,427,399
060650451181,890.3,460.5,389.9,1058,545,513
060650451034,421.7,189.7,220.7,368,170,198
060650451081,554.1,308.3,218.3,345,222,123
060650451192,259.3,141.1,104.5,283,152,131
060650451083,609.9,326.8,249.4,388,227,161
060650451191,784.4,371.9,379.6,647,363,284
060650451082,766.0,356.6,375.7,820,424,396
060650449301,1175.8,597.2,530.6,949,458,491
060650449291,894.0,422.0,437.4,1016,409,607
060650449292,818.6,435.4,348.6,597,295,302
060650449191,634.8,297.0,318.5,685,314,371
060650451221,711.9,218.1,471.3,837,260,577
060650451231,459.1,140.6,303.9,614,213,401
060650449281,601.8,266.6,310.6,573,227,346
060650451232,592.9,258.5,301.0,508,228,280
060650449112,880.1,412.3,430.4,799,379,420
060650449111,1190.8,574.4,564.8,1037,518,519
060650449193,1254.2,549.1,674.0,1149,499,650
060650449194,132.0,57.8,70.9,133,61,72
060650449192,549.8,202.6,331.0,575,226,349
060650449282,1078.2,397.4,649.0,1148,474,674
060650451211,821.9,379.0,410.0,754,307,447
060650451201,212.7,100.8,103.1,241,79,162
060650451203,600.3,284.6,290.9,458,223,235
060650452154,944.0,400.0,497.0,863,360,503
060650452142,1310.6,487.6,771.8,1236,474,762
060650452141,1459.6,506.3,893.1,1202,452,750
060650452331,991.8,402.3,537.9,988,484,504
060650451213,1041.9,369.7,638.3,994,329,665
060650451212,866.1,307.3,530.7,907,339,568
060650452153,1357.3,624.8,678.4,1142,501,641
060650452332,634.2,285.7,308.1,415,183,232
060650452151,1213.6,506.1,649.6,1195,517,678
060650452122,427.3,193.5,217.2,561,237,324
060650452152,197.0,89.2,100.1,208,84,124
060650452121,548.3,248.4,278.7,570,299,271
060710099041,580.1,354.1,195.4,370,213,157
060710099042,684.1,415.2,224.6,645,416,229
060710099051,741.5,434.4,266.6,709,440,269
060710099053,687.0,400.1,250.4,541,321,220
060710099121,423.6,222.2,179.7,297,176,121
060710099123,492.6,239.7,230.3,524,255,269
060710099122,374.3,182.1,175.0,446,201,245
060719802001,1.0,1.0,0.0,8,4,4
060710099052,665.2,406.5,215.2,398,255,143
060710100241,344.0,126.5,198.6,300,98,202
060710100242,776.3,244.7,489.4,736,276,460
060710100222,697.0,188.0,480.1,636,218,418
060710100211,776.5,221.6,517.7,728,266,462
060710100213,920.6,262.5,621.2,883,287,596
060710100221,873.3,273.7,564.0,843,332,511
060710100212,634.3,263.7,336.0,660,250,410
060710100203,611.9,254.4,324.1,376,181,195
060710100134,771.4,302.0,417.2,649,278,371
060710100113,407.0,209.0,176.5,290,128,162
060710100112,383.8,197.1,166.5,354,167,187
060710100111,385.2,197.8,167.1,310,148,162
060710100123,719.5,250.2,435.3,673,273,400
060710100121,371.8,139.1,212.5,338,156,182
060710100122,585.9,210.0,346.5,467,195,272
060710100131,765.3,289.5,434.5,648,249,399
060710100132,540.8,215.2,293.9,399,175,224
060710097072,1188.4,331.5,796.9,1039,321,718
060710097071,2686.0,919.0,1700.0,1924,663,1261
060710097091,861.7,317.7,502.3,762,338,424
060710097092,398.1,138.7,236.9,344,137,207
060710080011,484.2,273.1,178.5,433,257,176
060710084011,851.2,439.6,362.8,742,444,298
060710084012,642.1,328.4,280.2,610,342,268
060710084013,1110.7,555.5,502.4,921,477,444
060710079043,1627.7,669.7,882.7,1608,706,902
060710079031,871.4,382.8,444.3,826,371,455
060710079041,705.1,306.6,362.5,614,288,326
060710079042,939.9,393.9,497.5,847,425,422
060710079014,2021.0,907.1,1021.9,1928,897,1031
060710086021,744.7,327.4,369.9,714,306,408
060710086022,790.5,279.4,465.7,712,265,447
060710111014,380.5,121.4,239.1,426,144,282
060710111012,496.1,166.0,302.8,480,195,285
060710111011,443.1,144.7,271.9,500,214,286
060710111013,390.2,121.3,243.1,382,151,231
060710110011,317.2,123.4,178.7,278,129,149
060710110013,314.3,124.6,175.6,316,134,182
060710110022,363.9,142.7,205.8,399,146,253
060710109022,291.5,89.0,186.6,209,69,140
060710109025,222.9,82.7,127.4,191,87,104
060710109021,532.9,163.1,340.6,738,274,464
060710110021,407.1,181.2,208.7,440,175,265
060650438133,356.2,169.1,161.3,276,137,139
060650441041,903.4,421.6,435.3,967,471,496
060650442001,678.8,431.2,198.6,725,493,232
060650442002,548.2,332.9,174.6,314,258,56
060650438132,364.7,186.4,149.8,363,197,166
060650444052,747.4,371.4,321.0,617,340,277
060650444041,902.6,459.7,379.2,889,488,401
060650441031,916.8,386.3,490.3,1069,470,599
060650438092,1271.9,389.3,826.0,1243,474,769
060650438134,274.5,162.7,87.3,222,154,68
060650445211,315.8,164.5,140.7,263,157,106
060650446062,693.2,450.6,222.8,642,412,230
060659405002,687.7,477.8,196.7,503,311,192
060659405001,598.5,432.1,148.7,683,471,212
060650448071,646.5,467.4,161.4,676,415,261
060659408001,865.2,627.8,219.3,714,499,215
060659408002,848.6,616.8,216.0,726,512,214
060659407002,774.4,558.7,193.4,749,511,238
060659410002,326.8,214.2,104.2,229,143,86
060650448051,911.0,657.3,227.5,965,689,276
060659407001,478.8,349.8,113.4,500,349,151
060650450002,599.1,421.6,149.2,743,488,255
060650450003,427.5,294.1,115.1,280,192,88
060659410003,618.8,408.9,194.0,703,415,288
060659410001,501.4,328.6,160.2,476,308,168
060659410004,483.6,319.5,151.6,447,285,162
060650448041,951.8,693.3,225.7,827,512,315
060659411001,329.3,211.3,109.7,268,144,124
060650451032,433.6,217.9,205.4,352,160,192
060650450001,387.5,272.7,96.5,157,113,44
060659411002,665.0,412.5,236.1,709,431,278
060650449071,222.2,175.1,34.4,206,154,52
060650449152,398.7,314.3,61.8,439,292,147
060650449072,201.5,158.8,31.2,148,128,20
060650449151,463.3,365.2,71.8,253,192,61
060650449073,244.3,192.5,37.8,141,104,37
060650451033,380.6,193.6,177.5,433,245,188
060659409002,384.9,239.6,136.6,330,203,127
060650449172,893.4,462.9,408.0,940,418,522
060650449182,484.9,246.7,226.2,534,217,317
060650451031,509.6,259.3,237.7,346,199,147
060650449162,572.5,374.0,185.7,485,318,167
060659409001,648.0,423.3,210.2,715,424,291
060659406002,746.5,411.2,314.6,887,486,401
060650449163,582.2,336.0,223.4,247,148,99
060650449321,1008.2,622.6,346.4,1022,604,418
060659406001,771.2,436.7,317.5,712,348,364
060650449311,665.0,441.9,197.5,510,330,180
060650449161,720.3,384.5,321.2,651,379,272
060650445161,683.8,399.6,241.8,555,334,221
060650445162,927.0,627.9,242.7,607,390,217
060650445151,761.3,549.5,167.5,671,473,198
060650472011,530.3,260.2,256.1,511,268,243
060650445181,558.9,323.6,206.3,561,328,233
060650445182,1037.9,596.0,378.2,1023,604,419
060650445091,1024.5,597.5,362.1,610,369,241
060650445171,1087.7,499.7,548.3,959,446,513
060650445101,761.2,465.0,251.2,459,277,182
060710112052,310.4,98.1,196.0,267,102,165
060710112051,126.4,40.1,79.6,193,74,119
060710112032,223.2,70.3,141.1,299,87,212
060710112031,490.4,151.2,312.4,693,223,470
060710112042,213.4,81.8,121.7,214,90,124
060710112041,121.0,47.0,68.2,170,71,99
060710112043,266.3,83.2,168.7,320,121,199
060710114013,245.5,79.8,154.5,358,138,220
060710114014,436.0,142.0,269.2,339,167,172
060710114012,439.4,138.2,278.2,433,180,253
060710114011,614.3,188.2,395.6,597,231,366
060710114032,394.2,126.5,244.1,427,187,240
060710114041,790.1,200.3,544.7,704,233,471
060710114031,299.3,108.2,173.6,245,117,128
060710114034,279.2,103.3,159.7,275,127,148
060710114033,373.8,118.5,234.1,408,143,265
060710114042,855.7,256.5,543.7,753,261,492
060650449171,1319.3,723.4,560.7,1403,734,669
060650449181,1053.6,424.4,602.9,1064,398,666
060650449041,1661.9,1030.4,566.6,1356,825,531
060650446061,567.7,418.6,132.0,577,398,179
060650446022,476.4,344.3,117.0,605,398,207
060650446021,319.2,230.7,78.4,257,172,85
060659412002,722.4,478.8,219.1,521,361,160
060650446023,527.6,381.3,129.6,501,346,155
060650446052,1049.7,779.2,241.1,616,463,153
060659413002,820.9,585.5,213.8,807,550,257
060650447011,783.6,596.3,164.5,709,502,207
060659414001,356.1,273.4,73.0,319,245,74
060659414002,541.7,416.0,111.0,369,269,100
060650448061,849.0,641.9,181.2,890,681,209
060650447012,589.2,436.7,132.1,472,316,156
060650446041,953.1,695.1,230.1,782,472,310
060650446051,705.1,533.1,151.3,616,462,154
060659413001,859.9,610.8,224.0,756,546,210
060650445071,739.1,441.1,255.4,550,323,227
060710104172,326.0,114.4,190.2,268,123,145
060710104171,735.1,258.0,428.9,718,309,409
060659414003,394.9,291.3,89.6,342,251,91
060659412001,157.0,126.4,27.0,239,174,65
060650447021,620.2,450.4,141.5,384,299,85
060650446042,953.5,668.9,255.9,774,504,270
060650449251,242.4,176.0,55.3,324,203,121
060650449252,675.4,490.5,154.1,677,434,243
060659412003,329.5,203.4,113.8,271,126,145
060650449261,970.3,735.0,189.2,721,535,186
060650449262,316.7,240.0,61.8,238,170,68
060650449241,668.0,416.4,226.8,554,315,239
060650449242,569.0,354.6,193.2,607,343,264
060650449231,687.5,431.9,225.2,501,290,211
060650449232,505.1,317.3,165.4,518,278,240
060650445102,513.6,353.4,134.5,325,216,109
060650445072,708.1,487.2,185.4,456,288,168
060710071072,249.6,129.7,100.7,243,144,99
060710071071,443.1,286.8,123.3,430,331,99
060710071062,272.6,135.9,120.5,277,156,121
060710071064,415.3,202.1,187.7,449,227,222
060710071063,434.4,216.6,192.0,386,216,170
060710071061,352.7,162.7,166.9,415,207,208
060650423002,700.7,401.4,261.3,709,365,344
060650423003,683.2,415.0,216.0,574,380,194
060650423004,692.8,396.8,258.4,284,207,77
060650422142,897.7,535.1,302.0,1015,597,418
060650424123,887.4,485.2,357.9,923,488,435
060650422092,371.0,250.4,94.8,294,213,81
060650423001,7.7,1.2,4.4,3,2,1
060710071092,421.3,220.6,176.8,441,190,251
060710071091,827.7,433.4,347.2,531,313,218
060710066012,325.4,211.6,92.5,209,141,68
060710066032,787.6,556.4,184.4,737,513,224
060710066011,451.8,298.4,125.3,477,319,158
060710066013,400.9,272.8,105.4,283,202,81
060710125002,286.3,225.8,46.3,276,230,46
060710125001,234.5,182.5,41.3,207,177,30
060710125003,193.2,151.7,32.3,179,148,31
060710071081,470.2,311.4,123.0,496,366,130
060710124001,344.7,250.3,79.4,396,281,115
060710070003,559.7,429.0,98.1,470,380,90
060710125004,202.8,150.1,39.6,204,146,58
060710070001,385.0,283.6,78.0,288,225,63
060710067004,207.7,150.1,44.6,150,97,53
060650429041,685.2,538.8,110.9,559,408,151
060650420093,512.2,317.7,171.8,306,221,85
060650420101,620.4,440.2,140.8,561,409,152
060650420102,478.0,339.2,108.5,349,236,113
060650467001,408.0,144.0,245.0,634,195,439
060650426201,548.3,379.0,136.2,379,241,138
060650420131,2402.7,1057.5,1220.6,2244,1088,1156
060650425051,329.6,248.4,61.1,168,116,52
060650425061,925.0,699.0,170.9,737,560,177
060650425052,322.7,242.9,60.1,235,165,70
060650422121,1319.1,800.7,441.9,1009,657,352
060650467003,295.4,225.5,53.5,113,93,20
060650467002,384.6,293.7,69.7,315,225,90
060650425062,1191.7,870.8,243.7,1033,785,248
060650422122,913.8,545.4,312.4,1022,660,362
060650425161,493.4,365.9,102.1,417,301,116
060650425111,342.6,254.1,70.9,283,215,68
060650425122,364.6,270.4,75.5,283,214,69
060650425112,355.1,269.2,66.8,418,292,126
060650425162,331.9,253.8,60.0,258,198,60
060650425121,291.3,222.7,52.7,279,206,73
060650425132,331.8,228.3,85.4,339,232,107
060650425151,319.0,238.9,61.6,189,147,42
060650425131,355.5,244.6,91.5,335,242,93
060650425142,326.1,224.4,83.9,289,196,93
060650425133,211.1,145.3,54.3,212,133,79
060650425141,458.5,315.5,118.0,304,205,99
060650424051,635.0,523.0,74.0,406,323,83
060710124002,246.4,180.1,51.3,210,163,47
060710124003,218.2,159.5,45.4,197,156,41
060710057012,164.5,129.8,26.8,183,141,42
060710058003,157.6,124.1,25.7,191,154,37
060710058002,198.1,156.0,32.3,159,132,27
060710057011,231.9,181.8,37.7,231,177,54
060710065004,309.2,230.9,60.2,212,168,44
060710048001,285.2,245.3,25.7,220,176,44
060710047002,239.4,201.1,23.9,268,227,41
060710047004,160.2,137.8,14.4,144,117,27
060710056003,196.2,158.3,29.9,159,132,27
060710056001,169.5,136.2,25.5,163,129,34
060710056005,179.3,146.7,25.1,133,98,35
060710055004,274.8,219.5,40.4,183,148,35
060710055003,210.6,170.5,28.2,207,163,44
060710055005,106.6,85.2,15.7,65,49,16
060710055002,229.3,185.3,31.1,197,161,36
060710046041,303.8,208.8,75.8,265,182,83
060710054001,371.2,272.6,72.3,269,215,54
060710054002,249.8,183.4,48.7,183,144,39
060710053005,242.2,163.3,62.6,206,135,71
060710053004,330.7,208.0,104.4,289,180,109
060710053003,223.3,139.6,71.5,211,137,74
060710052003,219.0,143.4,61.6,276,152,124
060710058001,233.4,180.6,37.7,166,123,43
060710056002,227.6,176.2,36.8,140,104,36
060710056004,270.1,218.7,37.9,208,166,42
060710055001,368.6,301.1,46.2,255,219,36
060710063013,425.8,312.2,89.8,297,205,92
060710054003,372.8,286.9,65.4,303,220,83
060710054004,334.2,257.1,58.6,280,212,68
060710053001,348.6,239.4,83.3,245,169,76
060710053002,263.2,180.7,62.9,192,124,68
060710052002,360.2,228.6,107.8,341,202,139
060710072002,209.9,162.5,33.3,181,147,34
060710065002,153.8,118.9,27.0,225,167,58
060710065003,247.8,192.5,48.1,179,144,35
060710064012,296.3,231.6,41.0,227,174,53
060710065001,269.2,197.6,55.2,199,151,48
060710064022,393.9,285.1,81.4,328,222,106
060710064011,78.6,64.1,9.1,126,102,24
060710063025,184.2,130.8,40.2,167,117,50
060710063024,287.3,208.5,66.8,244,159,85
060710074032,458.5,249.7,184.5,360,213,147
060710074091,614.3,367.3,207.2,626,361,265
060710074101,315.0,192.1,106.4,285,170,115
060710074092,465.4,305.8,134.0,451,287,164
060710074042,262.3,125.4,121.1,529,264,265
060710074041,281.4,137.3,129.4,361,185,176
060710123001,440.9,210.8,203.6,56,30,26
060710074043,304.8,140.0,152.2,724,325,399
060710076043,675.5,379.6,263.6,646,378,268
060710076042,367.1,211.2,132.7,310,183,127
060710074093,708.8,362.9,302.0,789,456,333
060710074103,704.5,408.6,254.1,461,287,174
060710074102,704.2,351.5,318.3,813,381,432
060710074045,369.4,182.0,169.5,336,162,174
060710074044,472.0,201.0,255.0,190,76,114
060710079033,535.6,231.9,275.9,544,270,274
060710079012,713.2,301.0,380.0,809,358,451
060710079032,645.4,293.8,311.8,681,336,345
060710079011,350.4,153.0,180.5,330,143,187
060710079013,784.2,327.2,423.9,771,370,401
060710074031,583.6,287.9,271.3,640,332,308
060710074035,396.2,219.9,154.4,473,253,220
060710074033,479.2,305.9,144.3,243,149,94
060710074034,593.6,337.5,222.2,753,383,370
060710036091,263.0,200.6,49.0,224,169,55
060650312001,364.6,161.1,180.5,437,216,221
060650306033,383.4,175.7,183.1,390,163,227
060650306032,560.5,257.3,267.4,509,228,281
060650304002,329.7,263.6,46.2,417,331,86
060650304001,204.3,163.3,28.6,103,78,25
060650304005,374.4,299.3,52.4,235,213,22
060650304003,193.5,154.7,27.1,154,127,27
060650305013,287.9,230.9,44.1,242,211,31
060650305014,276.1,220.3,44.2,268,242,26
060650305011,457.6,365.2,73.3,345,248,97
060650305021,197.8,159.0,26.7,117,98,19
060650305022,179.5,149.1,18.6,173,153,20
060650305012,266.8,221.6,27.6,218,181,37
060650305031,124.1,103.1,12.8,69,56,13
060650305032,271.7,225.7,28.1,159,138,21
060650305033,191.4,158.9,19.8,66,54,12
060650301031,201.8,125.0,57.9,204,134,70
060650303004,211.0,130.7,60.6,235,170,65
060650303001,297.7,184.3,85.5,306,210,96
060650303003,85.6,53.0,24.6,117,77,40
060650303005,114.6,70.9,32.9,137,96,41
060650303002,364.3,225.6,104.6,85,59,26
060650301042,230.5,155.6,58.4,190,130,60
060650301043,981.2,642.5,263.5,766,494,272
060650301041,678.8,467.7,165.1,545,355,190
060650301011,310.3,213.7,76.1,197,146,51
060650422091,589.6,463.9,91.0,707,545,162
060650422064,757.7,454.2,257.1,598,399,199
060650422062,609.5,365.3,206.8,564,316,248
060650465001,564.7,488.6,42.1,729,638,91
060650465003,445.2,356.2,55.1,410,340,70
060650422063,274.0,167.7,86.1,327,220,107
060650465004,507.3,415.3,56.7,358,307,51
060650422061,824.7,504.9,259.2,614,430,184
060650422132,539.0,362.0,140.0,578,383,195
060650422101,319.9,235.8,61.6,283,213,70
060650422102,454.9,333.3,89.8,357,276,81
060650422103,322.5,258.0,39.9,311,246,65
060650465002,110.5,88.4,13.7,97,71,26
060650422131,707.5,461.6,189.0,701,509,192
060650422133,651.4,425.1,174.0,605,419,186
060710036122,380.9,263.5,97.0,299,212,87
060710036121,727.3,558.7,130.6,668,521,147
060650422141,1614.5,922.0,573.7,1595,925,670
060650424061,644.0,385.1,219.8,462,318,144
060650424091,462.6,286.1,147.7,537,303,234
060650424062,708.0,435.1,229.0,721,468,253
060650424092,514.3,357.6,121.6,357,249,108
060650424101,1205.4,743.9,398.5,1095,694,401
060650424102,834.4,506.1,284.5,686,425,261
060650424121,564.9,222.4,320.5,566,233,333
060710071044,325.9,146.1,157.6,366,178,188
060710071042,382.4,173.7,182.7,508,226,282
060710071052,684.7,354.4,283.9,579,270,309
060710071043,852.4,380.8,422.7,763,348,415
060710071041,474.9,216.4,231.3,563,250,313
060710073022,557.0,267.5,255.2,384,175,209
060710071051,355.0,211.9,119.8,390,210,180
060710071094,412.9,271.9,115.1,611,418,193
060710071093,194.9,143.0,40.4,112,90,22
060710070002,454.6,371.8,62.1,425,332,93
060710070004,310.2,238.0,55.3,254,194,60
060710071102,559.2,338.1,177.9,515,304,211
060710071101,515.8,311.9,164.1,476,268,208
060710071103,609.0,334.0,221.0,605,351,254
060710073021,719.7,334.0,335.7,759,330,429
060710073023,875.0,433.8,382.8,870,418,452
060710039001,447.6,332.1,90.3,370,279,91
060710038032,663.2,497.0,133.6,531,376,155
060710035092,616.2,472.8,114.6,474,341,133
060710038041,370.9,278.7,73.6,374,297,77
060710044013,401.2,312.8,67.7,329,247,82
060710044012,398.6,309.8,72.5,386,270,116
060710044031,563.0,409.0,133.0,505,381,124
060710044011,235.3,182.7,43.6,135,95,40
060710043011,375.0,297.5,63.3,439,366,73
060710043012,185.8,150.5,28.2,185,163,22
060710044041,318.2,245.9,59.1,200,143,57
060710044043,483.6,375.0,90.3,372,278,94
060710044042,215.1,160.7,46.3,279,212,67
060710038011,429.5,322.2,85.0,341,277,64
060710038043,669.3,504.2,131.6,564,423,141
060710038012,546.4,411.3,105.1,477,358,119
060710035051,414.1,330.3,68.0,310,246,64
060710038031,496.5,374.8,98.2,457,349,108
060710038013,584.1,439.4,111.8,490,402,88
060710035062,458.3,351.5,82.4,476,370,106
060710035052,349.6,264.4,63.7,225,186,39
060710027062,671.7,469.9,172.2,628,451,177
060710027063,830.9,558.5,233.9,810,534,276
060710043023,480.9,393.5,69.7,592,466,126
060710038042,493.0,370.0,97.3,438,345,93
060710043013,470.6,386.0,66.7,459,398,61
060710066041,610.9,455.1,122.5,492,354,138
060710044033,432.5,336.1,78.2,346,269,77
060710066031,706.0,492.9,177.8,737,515,222
060710066042,388.0,300.6,76.0,405,314,91
060710049001,285.9,231.3,35.7,225,190,35
060710049002,304.6,246.3,45.6,255,187,68
060710044032,218.7,169.9,39.5,244,187,57
060710067002,271.0,187.4,66.4,278,214,64
060710067003,238.9,167.1,56.8,241,158,83
060710067001,359.9,265.0,73.3,344,263,81
060710043022,248.2,207.7,28.9,208,174,34
060710043021,259.2,218.3,30.1,302,263,39
060710049003,363.8,284.2,62.0,266,199,67
060710049004,266.8,215.9,35.9,232,171,61
060710048002,232.4,191.0,27.5,186,157,29
060710042012,216.0,194.5,14.7,208,201,7
060710042011,235.6,211.8,16.3,276,259,17
060710041031,424.4,342.6,59.4,342,272,70
060710042022,320.5,265.2,34.0,381,330,51
060710036031,633.5,503.9,101.1,599,475,124
060710035091,508.3,398.4,90.1,373,274,99
060710037002,512.8,397.0,94.9,446,366,80
060710036071,613.3,471.8,116.1,561,395,166
060710035072,551.4,428.1,97.5,462,349,113
060710035053,452.8,361.4,74.1,324,267,57
060710034041,389.2,298.5,64.9,294,234,60
060710023061,261.5,201.0,43.2,381,280,101
060710034042,377.0,279.8,74.6,269,204,65
060710035033,396.7,301.7,75.5,467,362,105
060710035032,696.2,508.6,147.4,693,519,174
060710027054,392.7,282.7,93.5,422,308,114
060710035031,467.0,363.8,84.2,503,380,123
060710035063,588.7,447.4,115.3,529,394,135
060710027053,516.9,373.3,120.7,456,342,114
060710035061,300.4,235.7,52.7,137,115,22
060710027031,888.1,535.9,302.1,802,521,281
060710027032,719.4,431.4,250.7,690,456,234
060710027041,510.3,318.9,159.3,494,342,152
060710027043,536.5,339.1,165.6,539,361,178
060710027033,668.7,410.3,212.4,555,369,186
060710027052,593.5,395.3,171.0,609,422,187
060710027051,563.9,374.4,163.6,543,363,180
060710036092,343.1,237.1,87.7,298,199,99
060710036093,456.8,315.6,116.7,439,315,124
060710036111,613.5,482.1,100.9,544,437,107
060710036112,443.5,344.9,76.1,472,380,92
060710036072,743.9,547.8,157.3,507,366,141
060710039003,386.2,284.3,81.7,324,223,101
060710037001,338.4,267.7,57.9,269,204,65
060710039002,398.2,295.1,80.2,368,256,112
060650438091,406.3,116.2,269.5,1034,369,665
060710087032,804.4,226.0,539.7,839,261,578
060650438111,1335.5,361.4,904.6,1302,378,924
060710032002,540.0,361.8,150.5,461,276,185
060710032006,313.4,210.0,87.4,343,223,120
060710032005,258.6,173.2,72.1,190,128,62
060710030001,358.3,260.9,78.5,300,213,87
060710032003,469.0,330.5,114.2,483,309,174
060710032001,289.8,216.9,58.3,155,118,37
060710029013,253.4,184.9,55.1,221,142,79
060710029012,375.1,269.1,85.8,310,214,96
060710029011,240.7,172.6,55.1,226,162,64
060710032004,298.3,203.5,79.1,305,189,116
060710029023,374.5,262.5,91.8,267,196,71
060710034032,459.3,330.5,97.1,433,313,120
060710034033,297.0,203.3,77.0,197,111,86
060710034013,531.2,363.6,137.8,422,266,156
060710034014,503.5,364.1,107.3,328,221,107
060710034051,328.8,237.8,70.0,230,153,77
060710029022,376.8,275.2,80.4,321,228,93
060710029021,304.5,223.8,64.1,242,180,62
060710029025,235.4,171.9,50.2,121,89,32
060710029024,240.7,175.8,51.4,264,164,100
060710034012,382.9,290.7,65.0,278,197,81
060710034011,473.5,350.2,98.5,396,278,118
060710034052,166.9,128.7,27.3,102,78,24
060710034043,215.5,163.6,36.6,112,77,35
060710023014,410.2,290.1,100.8,344,245,99
060710023062,886.0,649.2,198.3,838,626,212
060710023011,490.9,359.7,109.9,436,318,118
060710023072,689.2,520.0,137.3,618,447,171
060710023071,601.9,436.9,131.5,546,394,152
060710034053,315.3,244.0,53.4,248,203,45
060710036032,627.0,452.0,142.0,639,465,174
060710035102,337.6,271.3,47.1,333,274,59
060710035101,508.4,408.7,70.9,397,314,83
060710035071,947.7,737.1,162.3,835,667,168
060710073025,738.2,370.2,312.2,713,339,374
060710073024,818.3,353.8,397.9,825,324,501
060710073033,456.6,271.2,145.5,447,242,205
060710073032,439.7,251.1,154.3,413,224,189
060710073031,347.0,259.0,66.0,237,165,72
060710073052,249.6,151.5,74.9,263,157,106
060710072001,395.2,253.4,117.5,429,256,173
060710073051,676.4,395.4,220.8,662,367,295
060710073061,710.5,408.0,240.7,709,403,306
060710073062,1076.9,632.0,349.5,924,511,413
060710072003,400.2,261.9,118.5,334,199,135
060710072004,425.1,278.1,125.9,415,245,170
060650424072,429.7,235.5,174.1,409,225,184
060650424071,515.3,282.5,208.9,512,298,214
060650424082,463.7,253.8,179.7,403,241,162
060650424081,519.3,284.2,201.3,482,278,204
060650424122,661.9,369.8,253.8,773,383,390
060650424112,687.2,379.8,266.9,657,404,253
060650424111,442.4,244.5,171.8,457,281,176
060650424031,882.6,503.6,326.5,818,455,363
060650424032,655.5,374.1,242.5,509,342,167
060650438221,837.9,301.2,485.0,873,348,525
060710085001,1735.6,683.0,955.5,1719,625,1094
060710085002,694.6,285.4,364.0,754,298,456
060710083023,863.1,369.5,440.7,891,375,516
060710073026,542.3,264.2,245.8,539,256,283
060710083015,546.1,264.9,243.6,737,344,393
060710078001,579.4,341.1,187.2,559,321,238
060710078002,787.0,446.2,282.1,641,371,270
060710083013,575.6,282.1,254.1,483,271,212
060710083014,847.0,395.8,391.4,819,364,455
060710083022,491.6,216.9,243.4,496,244,252
060710083021,541.8,254.2,250.4,528,237,291
060710078003,478.6,265.7,175.7,356,214,142
060710081002,669.1,389.7,228.3,643,388,255
060650433073,502.5,194.2,285.6,293,142,151
060650433161,379.1,136.4,226.4,474,164,310
060650433071,651.6,268.1,348.9,713,322,391
060650433072,1063.8,412.8,602.3,806,392,414
060650433061,863.7,341.8,477.5,776,368,408
060650435031,735.1,314.5,391.0,640,273,367
060650433062,747.8,296.4,413.5,787,340,447
060650435041,1298.4,582.1,645.3,1075,493,582
060650434041,442.2,198.8,218.0,706,301,405
060650434042,478.5,208.9,243.0,449,202,247
060650513001,1388.2,624.3,688.7,1392,620,772
060650435172,662.9,362.5,268.2,449,245,204
060650435171,1415.7,767.7,563.6,787,425,362
060650513002,1232.0,674.9,499.8,1070,550,520
060650434051,362.0,176.0,165.6,222,101,121
060650435052,668.2,305.0,337.5,695,383,312
060650435032,797.4,364.0,402.7,719,353,366
060650434053,480.2,248.0,210.3,462,202,260
060650435072,517.2,291.9,193.5,472,263,209
060650435062,779.4,400.4,344.8,544,288,256
060650435061,721.5,286.0,407.9,818,350,468
060650435063,803.0,318.2,453.9,746,290,456
060650435073,491.9,259.9,203.7,316,164,152
060650435051,590.1,233.9,333.6,644,264,380
060650434013,436.2,226.1,188.5,274,161,113
060650434012,432.7,206.3,201.2,377,200,177
060650434011,453.3,223.7,199.1,422,245,177
060650434032,363.1,185.5,157.4,310,162,148
060650434031,347.7,177.6,150.9,370,188,182
060650433121,476.9,239.3,211.3,389,196,193
060650433122,590.3,268.4,286.9,453,218,235
060650433081,298.2,142.6,129.2,303,148,155
060650433082,302.3,156.7,117.6,235,139,96
060650433131,424.6,197.5,195.0,342,158,184
060650433102,435.2,199.9,207.6,438,230,208
060650433141,600.3,218.8,342.2,688,296,392
060650433132,509.7,197.8,279.6,441,189,252
060650433142,650.6,225.3,384.6,641,218,423
060650433151,842.0,283.1,504.8,907,330,577
060650433101,427.6,178.0,227.8,333,140,193
060650433112,369.5,160.2,190.8,425,160,265
060650434052,309.3,163.9,130.8,379,205,174
060650435071,430.4,228.1,182.0,380,187,193
060650435083,674.3,305.1,336.0,735,313,422
060650435082,448.2,244.7,178.3,357,201,156
060650436021,336.7,203.6,112.3,250,176,74
060650433092,293.2,141.1,135.1,354,163,191
060650433091,331.4,159.5,152.7,210,107,103
060650437012,663.4,261.9,360.3,564,270,294
060650437032,334.5,132.6,179.1,310,132,178
060659415001,1316.6,518.5,713.4,1450,631,819
060650435131,802.4,375.5,384.1,754,350,404
060650437031,529.4,207.3,284.9,585,243,342
060650444051,530.3,287.5,207.1,573,353,220
060650438131,227.7,82.0,127.9,251,94,157
060650443001,548.1,284.1,220.0,359,178,181
060650438121,2650.1,976.4,1624.1,2606,950,1656
060650441032,1166.5,526.6,589.9,846,413,433
060650438122,1547.1,585.5,915.1,1640,653,987
060650441021,579.0,321.9,220.5,674,369,305
060650441012,197.5,112.6,72.4,115,73,42
060650441011,425.5,242.6,156.1,450,279,171
060650443002,488.2,269.1,187.9,590,293,297
060710084033,980.9,407.8,525.2,897,350,547
060710085003,1283.5,543.3,664.9,1023,391,632
060710084042,392.1,215.1,151.0,458,261,197
060710084041,254.0,146.6,89.8,221,130,91
060710084034,540.2,231.0,269.5,554,268,286
060710084031,488.0,230.4,222.4,731,362,369
060710084015,800.1,449.8,297.2,589,340,249
060710080024,363.5,228.8,109.3,297,188,109
060710080022,214.3,127.8,72.5,173,107,66
060710080023,207.7,130.7,62.5,136,93,43
060710084014,486.0,252.2,209.6,602,302,300
060710080021,248.2,131.7,102.9,261,159,102
060710084032,1026.7,412.0,556.0,1068,425,643
060710084024,760.4,319.0,391.9,709,322,387
060710084022,1283.8,620.6,578.1,981,462,519
060710084021,394.0,197.3,169.0,407,229,178
060710085005,391.9,138.3,231.9,362,146,216
060710087064,819.6,276.2,506.1,619,188,431
060710086012,400.8,162.9,215.2,411,196,215
060710084023,623.2,278.1,309.0,657,318,339
060710086013,641.6,278.4,315.3,550,282,268
060710086014,720.5,307.8,353.2,673,339,334
060710086011,318.7,134.2,157.2,301,150,151
060650438232,261.8,82.9,165.1,202,83,119
060650438231,2869.7,1242.3,1486.0,1072,555,517
060650424011,916.1,384.5,490.7,1006,461,545
060650438141,563.0,206.0,329.0,723,320,403
060650438112,425.1,141.5,257.8,406,139,267
060650438023,911.9,288.5,572.0,901,324,577
060650438022,340.8,112.9,210.0,250,103,147
060650438021,1015.0,298.0,661.6,939,360,579
060710087045,351.3,124.6,194.3,334,141,193
060710062011,247.7,137.8,94.5,240,135,105
060710061007,354.2,164.1,169.8,366,159,207
060710062032,355.0,259.8,74.8,361,235,126
060710061005,338.8,201.9,111.6,359,224,135
060710061006,606.1,330.1,238.9,567,339,228
060710061004,288.9,176.6,92.4,266,158,108
060710061002,354.1,164.5,170.5,312,121,191
060710061001,291.2,133.1,142.7,304,146,158
060710062031,472.1,325.6,112.1,362,229,133
060710061003,519.0,314.9,168.5,504,278,226
060710076013,246.9,194.4,38.1,188,141,47
060710076031,305.6,210.0,76.1,314,213,101
060710076041,351.9,228.8,103.2,268,184,84
060710076011,358.2,278.4,60.7,191,156,35
060710076033,500.6,343.0,129.9,423,271,152
060710074082,473.5,350.6,98.5,469,330,139
060710076012,277.9,206.4,55.5,268,178,90
060710076014,236.5,175.6,47.2,205,139,66
060710074081,293.7,217.1,63.3,336,241,95
060710074072,199.7,142.2,46.6,112,65,47
060710074073,180.8,141.1,31.3,199,146,53
060710074071,147.7,115.2,25.6,91,82,9
060710062041,332.9,222.9,83.1,372,254,118
060710076032,311.0,198.3,96.1,313,182,131
060650435122,1050.7,524.8,466.4,781,416,365
060650435121,930.0,479.3,402.2,865,428,437
060650436022,402.5,243.0,134.4,317,180,137
060650436012,486.7,283.7,170.4,317,189,128
060650435092,617.8,272.8,297.1,701,334,367
060650435091,807.0,411.3,334.3,699,359,340
060650435081,1154.7,458.3,632.6,1237,531,706
060650433111,392.2,140.0,230.5,297,118,179
060650436011,429.8,245.6,154.5,355,198,157
060650426231,1470.1,897.4,499.6,1439,883,556
060650490003,736.8,490.1,197.9,426,304,122
060650490002,1523.0,1136.9,312.3,1108,815,293
060650487001,1058.2,780.3,233.8,941,670,271
060650490001,446.6,272.6,151.8,291,190,101
060650426241,1318.0,759.2,497.9,926,554,372
060650426221,1398.5,900.0,439.5,985,610,375
060650424022,686.8,323.1,330.7,657,357,300
060710085004,1137.6,472.1,602.8,979,400,579
060650426182,821.6,589.5,180.3,409,277,132
060650488001,719.3,531.3,149.2,538,407,131
060650483002,1220.3,947.0,215.7,737,588,149
060650425071,1019.5,748.1,219.9,839,594,245
060650426191,3111.7,2350.1,596.0,1836,1316,520
060650483001,862.6,653.2,167.0,752,547,205
060650425081,360.1,274.1,64.0,249,203,46
060650425082,272.2,207.3,48.4,237,172,65
060650425083,465.6,338.3,105.2,348,265,83
060650425103,378.9,289.8,69.5,281,224,57
060650425091,402.9,300.3,80.2,354,251,103
060650425102,348.1,266.3,63.9,307,236,71
060650425101,450.1,344.3,82.6,421,300,121
060650489022,680.9,509.3,135.3,502,361,141
060650488002,486.3,360.5,100.0,414,305,109
060650511001,769.6,578.4,152.9,723,545,178
060650489021,870.2,646.8,176.1,581,401,180
060650425072,423.3,325.2,75.3,397,282,115
060650425181,394.5,278.9,92.9,351,243,108
060650425092,451.1,319.8,106.5,379,241,138
060650425182,534.0,374.8,124.9,418,310,108
060650489011,1094.6,739.9,291.4,950,622,328
060650425171,344.8,241.1,87.3,330,205,125
060650425172,530.7,371.1,134.4,435,298,137
060650425211,670.5,502.6,131.3,614,455,159
060650425201,1070.7,792.8,227.5,796,575,221
060650424052,440.3,316.9,98.1,335,257,78
060650424041,569.7,410.1,126.9,514,344,170
060650425191,369.6,273.7,78.4,296,214,82
060650425152,247.0,187.3,45.3,226,178,48
060650425212,472.2,351.6,95.8,363,250,113
060650468002,800.2,569.5,188.3,779,539,240
060650468003,489.8,346.5,116.2,430,305,125
060650511002,951.8,709.1,201.0,577,419,158
060650426211,1023.0,728.8,239.2,751,527,224
060650468001,540.5,373.8,131.8,509,360,149
060650424021,1120.7,721.4,332.6,952,559,393
060650426212,1049.4,766.4,236.5,713,516,197
060650487002,302.6,190.8,97.6,176,108,68
060710087051,383.8,141.2,209.1,418,172,246
060710087053,400.6,145.6,221.9,323,150,173
060710087054,467.6,160.6,278.2,374,156,218
060710087042,448.0,153.8,266.5,550,192,358
060710087052,403.9,138.7,240.3,394,165,229
060710087063,1484.2,514.4,890.1,1021,379,642
060710087041,537.9,172.2,340.4,548,223,325
060710087044,1054.8,366.8,629.6,1014,412,602
060710087043,587.0,211.0,343.0,488,209,279
060710087093,390.9,140.8,223.4,345,152,193
060710087091,185.6,63.5,109.4,190,69,121
060710087101,501.3,187.2,287.7,430,221,209
060710087102,511.9,191.1,293.8,387,181,206
060710087103,400.5,149.5,229.9,438,184,254
060710087062,2004.9,714.7,1180.4,2141,816,1325
060650438201,2666.6,1301.7,1263.1,977,536,441
060650439002,430.1,182.9,218.7,292,162,130
060650440001,419.4,205.4,185.7,278,155,123
060650440002,81.2,33.5,42.2,83,63,20
060650439001,720.1,287.0,385.2,730,328,402
060710087034,1094.2,288.0,744.6,1004,324,680
060710088002,678.9,224.5,402.1,517,239,278
060710087081,447.7,144.9,267.7,517,209,308
060710088003,751.3,272.5,429.5,710,282,428
060710088001,680.1,198.8,439.5,625,229,396
060710087033,1232.6,334.7,842.5,1258,404,854
060710088004,409.5,119.7,264.6,290,116,174
060710087065,636.4,197.2,406.6,554,229,325
060710087061,762.2,236.2,487.0,809,322,487
060710087083,722.4,206.2,481.8,563,198,365
060650438071,1302.6,456.4,774.0,516,218,298
060650438072,687.4,296.3,352.8,540,252,288
060650438181,1564.7,717.9,764.6,968,500,468
060650438211,1056.3,533.5,464.1,406,250,156
060650439003,840.4,353.0,431.4,632,300,332
060650438102,750.0,302.0,417.0,655,293,362
060710087094,522.6,161.7,328.0,215,90,125
060710087082,656.7,203.2,412.1,539,193,346
060650438103,1180.7,472.5,662.9,1047,482,565
060650438101,681.6,270.8,392.4,682,267,415
060710108031,319.3,124.7,176.7,309,139,170
060710108042,444.7,163.5,250.9,482,200,282
060710108033,525.2,199.7,298.7,462,207,255
060710108022,375.2,124.9,225.3,555,238,317
060710108041,546.1,177.4,337.7,592,243,349
060710108034,370.1,134.7,216.8,335,144,191
060710108032,395.4,144.6,231.1,243,107,136
060710110012,316.8,109.2,181.2,266,99,167
060710108043,287.5,97.1,174.7,300,137,163
060710109013,961.0,249.9,669.4,950,343,607
060710109015,482.4,146.8,309.0,557,190,367
060710109014,363.7,111.6,230.3,466,125,341
060710109024,427.1,129.9,273.8,394,143,251
060710109023,300.9,91.5,192.9,201,69,132
060710097093,645.2,217.0,390.2,607,251,356
060710100261,1885.5,847.9,926.8,1424,707,717
060710099132,862.0,407.0,394.0,708,371,337
060710099131,484.5,292.0,161.1,587,326,261
060710098001,198.8,128.8,57.5,113,57,56
060710098002,170.1,90.7,68.5,71,48,23
060710098003,242.2,156.9,70.0,289,166,123
060710098004,213.7,138.4,61.8,257,156,101
060710100044,1091.0,320.3,715.0,1174,405,769
060710100043,469.7,141.0,302.2,457,193,264
060710100041,635.2,187.9,419.2,581,210,371
060710100042,691.4,206.5,455.3,645,225,420
060710100045,645.8,167.3,438.3,779,242,537
060710097111,1229.0,403.0,786.0,1166,401,765
060710097172,1170.0,306.9,808.9,1098,330,768
060710097171,768.0,207.1,518.2,691,207,484
060710097151,578.1,189.4,355.5,577,233,344
060710097153,556.2,155.3,373.0,578,169,409
060710097152,695.3,205.4,451.9,670,219,451
060710121013,159.5,75.8,74.4,213,137,76
060710097112,1499.0,470.5,964.9,1482,559,923
060710097114,1257.5,418.9,770.6,1191,477,714
060710097113,484.5,147.7,308.4,468,171,297
060710097154,858.1,232.5,582.6,869,250,619
060710097155,1193.3,329.4,805.0,1051,375,676
060710097103,420.6,160.9,234.6,315,133,182
060710097102,486.4,186.1,271.4,361,168,193
060710097101,975.0,447.0,470.0,973,477,496
060710097121,308.6,114.5,180.2,216,102,114
060710097142,479.8,157.2,298.4,476,195,281
060710097141,470.4,157.9,286.4,467,188,279
060710097161,1173.1,400.8,711.2,1208,482,726
060710097163,467.7,204.8,233.6,348,185,163
060710097162,428.6,187.7,214.1,332,168,164
060710063014,189.3,144.2,32.8,164,105,59
060710063012,275.6,191.2,62.8,214,152,62
060710063011,220.4,152.8,50.2,235,154,81
060710062012,261.6,150.8,95.2,237,133,104
060710062013,609.8,372.1,200.0,550,313,237
060710064021,377.2,289.3,63.8,359,269,90
060710063023,341.3,247.7,79.4,249,167,82
060710063022,420.4,298.1,103.3,349,244,105
060710063021,588.1,387.7,166.3,554,342,212
060710062042,415.1,309.1,76.9,329,239,90
060710046031,416.7,234.4,155.1,267,154,113
060710045071,321.9,206.1,94.3,285,171,114
060710045091,622.6,341.8,245.0,526,272,254
060710045073,503.2,295.1,180.0,491,267,224
060710045052,318.7,179.8,121.6,361,200,161
060710045093,660.7,359.0,265.5,663,364,299
060710051003,327.0,179.1,126.7,394,205,189
060710052004,294.6,168.0,107.4,356,221,135
060710051004,337.5,187.3,128.3,328,179,149
060710052001,354.9,198.9,133.8,338,204,134
060710051005,395.9,223.3,148.9,353,199,154
060710051007,319.0,174.2,124.8,288,135,153
060710051002,332.4,170.5,142.7,356,183,173
060710045053,625.5,363.3,227.0,471,313,158
060710051006,300.2,183.3,101.2,366,244,122
060710045051,504.0,288.0,187.0,553,299,254
060710051001,583.1,285.0,269.8,639,293,346
060710107003,302.9,119.6,167.3,326,148,178
060139900000,0,0,0,0,0,0
060239901000,0,0,0,0,0,0
060290043021,0,0,0,0,0,0
060310016021,0,0,0,0,0,0
060319818001,0,0,0,0,0,0
060379902000,0,0,0,0,0,0
060659810001,0,0,0,0,0,0
060719801001,0,0,0,1,1,0
060710022072,0,0,0,23,18,5
060739901000,0,0,0,0,0,0
060819843001,0,0,0,0,0,0
060879901000,0,0,0,0,0,0
060952521031,0,0,0,303,229,74
060979901000,0,0,0,0,0,0
061030005005,0,0,0,22,8,14
061110081011,0,0,0,805,379,426
061119800001,0,0,0,0,0,0
061110036121,0,0,0,0,0,0